name;number of persons;number of locations;number of organisations;number of named entities;number of words;relative number of Persons;relative number of locations;relative number of organisations
1700_4.txt;5;0;0;5;171;0.03;0.0;0.0
9264_4.txt;60;0;1;61;319;0.19;0.0;0.0
4359_3.txt;4;2;1;7;751;0.01;0.0;0.0
7658_1.txt;12;3;3;18;404;0.03;0.01;0.01
1041_1.txt;6;3;0;9;191;0.03;0.02;0.0
3609_1.txt;3;0;0;3;190;0.02;0.0;0.0
721_1.txt;0;0;0;0;129;0.0;0.0;0.0
2874_1.txt;0;0;1;1;328;0.0;0.0;0.0
1472_1.txt;5;0;0;5;158;0.03;0.0;0.0
5508_2.txt;23;1;4;28;305;0.08;0.0;0.01
370_1.txt;0;0;2;2;94;0.0;0.0;0.02
8579_2.txt;20;1;0;21;416;0.05;0.0;0.0
7152_1.txt;16;1;0;17;181;0.09;0.01;0.0
424_4.txt;11;1;13;25;387;0.03;0.0;0.03
9746_1.txt;4;2;0;6;175;0.02;0.01;0.0
12188_4.txt;9;2;3;14;412;0.02;0.0;0.01
1880_4.txt;8;0;2;10;130;0.06;0.0;0.02
11114_1.txt;0;0;0;0;51;0.0;0.0;0.0
9899_4.txt;22;0;2;24;147;0.15;0.0;0.01
8514_1.txt;0;0;0;0;150;0.0;0.0;0.0
2839_2.txt;2;0;0;2;107;0.02;0.0;0.0
9897_4.txt;6;1;0;7;204;0.03;0.0;0.0
3525_2.txt;0;0;0;0;64;0.0;0.0;0.0
2142_4.txt;0;0;0;0;145;0.0;0.0;0.0
1863_1.txt;0;0;0;0;58;0.0;0.0;0.0
4747_1.txt;2;0;1;3;139;0.01;0.0;0.01
5014_1.txt;3;0;0;3;239;0.01;0.0;0.0
10551_1.txt;2;0;0;2;199;0.01;0.0;0.0
1349_3.txt;0;0;0;0;322;0.0;0.0;0.0
1703_4.txt;14;4;0;18;174;0.08;0.02;0.0
6536_3.txt;0;2;0;2;75;0.0;0.03;0.0
7560_1.txt;4;0;0;4;141;0.03;0.0;0.0
2781_2.txt;0;1;0;1;239;0.0;0.0;0.0
5512_1.txt;7;0;0;7;369;0.02;0.0;0.0
5955_3.txt;9;0;0;9;484;0.02;0.0;0.0
6684_1.txt;9;0;2;11;121;0.07;0.0;0.02
2480_2.txt;6;0;0;6;499;0.01;0.0;0.0
6754_1.txt;2;0;0;2;129;0.02;0.0;0.0
4983_2.txt;2;0;0;2;132;0.02;0.0;0.0
5117_2.txt;2;0;1;3;270;0.01;0.0;0.0
3479_1.txt;2;0;0;2;155;0.01;0.0;0.0
3802_2.txt;13;0;0;13;168;0.08;0.0;0.0
6492_3.txt;1;0;0;1;235;0.0;0.0;0.0
9649_1.txt;21;4;0;25;364;0.06;0.01;0.0
8097_4.txt;23;0;0;23;351;0.07;0.0;0.0
7126_1.txt;0;0;0;0;165;0.0;0.0;0.0
1659_2.txt;0;0;0;0;57;0.0;0.0;0.0
4518_2.txt;6;1;1;8;399;0.02;0.0;0.0
531_2.txt;2;0;0;2;216;0.01;0.0;0.0
12271_1.txt;2;0;0;2;180;0.01;0.0;0.0
3589_4.txt;12;0;0;12;166;0.07;0.0;0.0
9188_1.txt;4;0;0;4;242;0.02;0.0;0.0
1506_1.txt;13;0;9;22;433;0.03;0.0;0.02
443_3.txt;10;5;1;16;233;0.04;0.02;0.0
482_1.txt;14;0;2;16;609;0.02;0.0;0.0
5786_2.txt;16;0;0;16;206;0.08;0.0;0.0
718_2.txt;24;7;2;33;653;0.04;0.01;0.0
1769_4.txt;6;0;1;7;339;0.02;0.0;0.0
3574_1.txt;2;0;0;2;119;0.02;0.0;0.0
825_1.txt;0;0;0;0;33;0.0;0.0;0.0
7895_1.txt;0;0;0;0;134;0.0;0.0;0.0
1687_1.txt;5;0;0;5;145;0.03;0.0;0.0
11429_1.txt;0;0;0;0;131;0.0;0.0;0.0
9319_2.txt;1;0;1;2;202;0.0;0.0;0.0
8912_4.txt;0;0;0;0;153;0.0;0.0;0.0
9494_1.txt;4;0;0;4;135;0.03;0.0;0.0
7211_1.txt;4;0;2;6;367;0.01;0.0;0.01
9184_1.txt;0;0;0;0;147;0.0;0.0;0.0
6212_1.txt;0;0;0;0;177;0.0;0.0;0.0
12314_3.txt;22;0;11;33;534;0.04;0.0;0.02
1062_4.txt;11;0;0;11;146;0.08;0.0;0.0
5805_1.txt;17;0;0;17;167;0.1;0.0;0.0
5762_4.txt;26;0;0;26;454;0.06;0.0;0.0
3542_1.txt;2;0;0;2;242;0.01;0.0;0.0
6410_1.txt;20;3;5;28;745;0.03;0.0;0.01
758_2.txt;1;0;0;1;203;0.0;0.0;0.0
10211_2.txt;2;0;0;2;175;0.01;0.0;0.0
704_1.txt;21;0;3;24;208;0.1;0.0;0.01
8876_4.txt;2;0;0;2;81;0.02;0.0;0.0
2075_1.txt;21;0;0;21;523;0.04;0.0;0.0
1480_1.txt;2;0;0;2;300;0.01;0.0;0.0
8462_3.txt;10;0;0;10;150;0.07;0.0;0.0
11258_3.txt;6;3;1;10;376;0.02;0.01;0.0
2780_4.txt;37;4;0;41;410;0.09;0.01;0.0
5850_4.txt;13;0;2;15;278;0.05;0.0;0.01
9230_1.txt;1;0;0;1;336;0.0;0.0;0.0
8900_4.txt;3;0;0;3;114;0.03;0.0;0.0
5487_4.txt;10;4;5;19;465;0.02;0.01;0.01
10003_1.txt;11;0;1;12;455;0.02;0.0;0.0
7473_4.txt;0;0;1;1;201;0.0;0.0;0.0
4685_4.txt;6;2;0;8;216;0.03;0.01;0.0
11271_3.txt;0;0;0;0;50;0.0;0.0;0.0
164_3.txt;0;0;3;3;125;0.0;0.0;0.02
12300_4.txt;34;5;8;47;743;0.05;0.01;0.01
4909_1.txt;12;0;0;12;124;0.1;0.0;0.0
4364_1.txt;0;2;0;2;125;0.0;0.02;0.0
7219_1.txt;0;1;0;1;140;0.0;0.01;0.0
8953_1.txt;10;0;5;15;690;0.01;0.0;0.01
8781_4.txt;4;0;0;4;494;0.01;0.0;0.0
2778_3.txt;4;0;0;4;320;0.01;0.0;0.0
9772_1.txt;0;0;0;0;143;0.0;0.0;0.0
9366_3.txt;0;0;0;0;195;0.0;0.0;0.0
10487_2.txt;4;0;0;4;166;0.02;0.0;0.0
4554_1.txt;2;3;3;8;186;0.01;0.02;0.02
7319_4.txt;11;0;0;11;427;0.03;0.0;0.0
4835_1.txt;7;3;3;13;118;0.06;0.03;0.03
8141_1.txt;7;0;0;7;162;0.04;0.0;0.0
2994_4.txt;7;1;1;9;913;0.01;0.0;0.0
11353_1.txt;0;4;1;5;186;0.0;0.02;0.01
257_2.txt;7;0;0;7;265;0.03;0.0;0.0
5404_1.txt;4;4;0;8;362;0.01;0.01;0.0
5045_1.txt;2;1;0;3;237;0.01;0.0;0.0
5763_1.txt;0;0;0;0;126;0.0;0.0;0.0
5164_4.txt;8;0;0;8;178;0.04;0.0;0.0
7262_4.txt;16;0;0;16;223;0.07;0.0;0.0
4123_3.txt;0;0;2;2;111;0.0;0.0;0.02
1194_1.txt;0;0;0;0;148;0.0;0.0;0.0
6272_1.txt;9;0;1;10;313;0.03;0.0;0.0
10727_4.txt;0;1;0;1;227;0.0;0.0;0.0
11331_3.txt;7;2;0;9;187;0.04;0.01;0.0
6573_3.txt;1;0;1;2;230;0.0;0.0;0.0
12428_2.txt;4;0;0;4;96;0.04;0.0;0.0
7396_1.txt;4;0;0;4;379;0.01;0.0;0.0
5766_1.txt;0;0;1;1;311;0.0;0.0;0.0
6383_3.txt;0;3;0;3;195;0.0;0.02;0.0
1377_4.txt;9;0;1;10;159;0.06;0.0;0.01
10862_3.txt;6;0;0;6;253;0.02;0.0;0.0
4121_2.txt;0;0;0;0;72;0.0;0.0;0.0
1061_4.txt;10;1;2;13;448;0.02;0.0;0.0
6371_4.txt;20;0;0;20;655;0.03;0.0;0.0
2073_1.txt;2;0;0;2;305;0.01;0.0;0.0
2902_1.txt;0;0;0;0;274;0.0;0.0;0.0
4216_3.txt;6;1;1;8;473;0.01;0.0;0.0
5261_3.txt;0;0;0;0;151;0.0;0.0;0.0
6195_1.txt;0;1;0;1;147;0.0;0.01;0.0
1596_4.txt;6;0;0;6;128;0.05;0.0;0.0
870_4.txt;15;0;0;15;227;0.07;0.0;0.0
840_1.txt;2;0;0;2;95;0.02;0.0;0.0
6261_2.txt;1;0;0;1;193;0.01;0.0;0.0
7551_4.txt;0;2;4;6;171;0.0;0.01;0.02
2720_3.txt;68;1;2;71;1023;0.07;0.0;0.0
4159_1.txt;0;0;3;3;170;0.0;0.0;0.02
6534_4.txt;8;1;0;9;113;0.07;0.01;0.0
7147_1.txt;1;0;0;1;111;0.01;0.0;0.0
1786_4.txt;42;2;0;44;678;0.06;0.0;0.0
3920_3.txt;0;0;0;0;61;0.0;0.0;0.0
5431_3.txt;10;10;0;20;182;0.05;0.05;0.0
11027_4.txt;15;4;0;19;608;0.02;0.01;0.0
9348_1.txt;4;0;0;4;268;0.01;0.0;0.0
12427_1.txt;0;0;0;0;172;0.0;0.0;0.0
10614_1.txt;2;0;0;2;94;0.02;0.0;0.0
1676_4.txt;9;2;0;11;170;0.05;0.01;0.0
8039_1.txt;0;0;0;0;149;0.0;0.0;0.0
9282_1.txt;2;0;0;2;76;0.03;0.0;0.0
10882_2.txt;0;0;0;0;211;0.0;0.0;0.0
5519_4.txt;6;0;0;6;196;0.03;0.0;0.0
3365_1.txt;16;0;0;16;248;0.06;0.0;0.0
2872_1.txt;0;0;0;0;133;0.0;0.0;0.0
11783_1.txt;0;0;0;0;132;0.0;0.0;0.0
5533_1.txt;2;1;2;5;222;0.01;0.0;0.01
11640_4.txt;14;0;5;19;1183;0.01;0.0;0.0
6183_4.txt;20;8;0;28;348;0.06;0.02;0.0
699_4.txt;8;0;0;8;195;0.04;0.0;0.0
3782_4.txt;0;0;1;1;245;0.0;0.0;0.0
12266_4.txt;0;1;0;1;271;0.0;0.0;0.0
10615_2.txt;6;0;0;6;130;0.05;0.0;0.0
7904_3.txt;3;0;0;3;255;0.01;0.0;0.0
8661_1.txt;0;0;0;0;169;0.0;0.0;0.0
896_1.txt;6;0;0;6;171;0.04;0.0;0.0
5553_4.txt;3;0;0;3;87;0.03;0.0;0.0
3868_1.txt;1;1;0;2;100;0.01;0.01;0.0
4072_1.txt;0;0;0;0;131;0.0;0.0;0.0
7021_1.txt;6;2;0;8;453;0.01;0.0;0.0
2552_3.txt;0;2;0;2;184;0.0;0.01;0.0
10631_1.txt;4;1;4;9;379;0.01;0.0;0.01
5457_1.txt;10;0;7;17;430;0.02;0.0;0.02
1719_1.txt;1;1;1;3;324;0.0;0.0;0.0
3816_1.txt;0;0;16;16;162;0.0;0.0;0.1
4466_2.txt;0;0;0;0;48;0.0;0.0;0.0
9465_1.txt;2;0;1;3;195;0.01;0.0;0.01
9850_1.txt;4;0;0;4;146;0.03;0.0;0.0
8444_1.txt;1;2;0;3;657;0.0;0.0;0.0
6993_1.txt;6;1;0;7;169;0.04;0.01;0.0
7512_1.txt;5;2;0;7;246;0.02;0.01;0.0
1580_1.txt;0;1;0;1;113;0.0;0.01;0.0
12058_4.txt;1;0;0;1;43;0.02;0.0;0.0
4883_1.txt;5;0;0;5;209;0.02;0.0;0.0
9265_1.txt;4;2;0;6;138;0.03;0.01;0.0
10105_1.txt;0;0;3;3;485;0.0;0.0;0.01
4067_1.txt;0;0;0;0;191;0.0;0.0;0.0
8805_3.txt;0;0;0;0;63;0.0;0.0;0.0
3454_4.txt;2;0;4;6;391;0.01;0.0;0.01
4427_1.txt;15;0;3;18;736;0.02;0.0;0.0
12133_3.txt;31;2;1;34;1118;0.03;0.0;0.0
3132_4.txt;9;0;3;12;264;0.03;0.0;0.01
3011_2.txt;0;0;0;0;171;0.0;0.0;0.0
8334_1.txt;6;0;0;6;122;0.05;0.0;0.0
12187_3.txt;12;0;0;12;150;0.08;0.0;0.0
5118_1.txt;3;1;0;4;418;0.01;0.0;0.0
3638_1.txt;0;6;0;6;268;0.0;0.02;0.0
3902_4.txt;26;1;0;27;357;0.07;0.0;0.0
7623_4.txt;3;0;0;3;190;0.02;0.0;0.0
5434_1.txt;2;2;0;4;175;0.01;0.01;0.0
5003_4.txt;0;0;0;0;110;0.0;0.0;0.0
1758_1.txt;3;1;1;5;166;0.02;0.01;0.01
11202_3.txt;24;1;2;27;760;0.03;0.0;0.0
5875_1.txt;14;4;0;18;168;0.08;0.02;0.0
4436_1.txt;4;0;0;4;91;0.04;0.0;0.0
8716_1.txt;0;1;0;1;124;0.0;0.01;0.0
1752_1.txt;12;0;2;14;454;0.03;0.0;0.0
3887_1.txt;0;0;0;0;211;0.0;0.0;0.0
7866_2.txt;17;2;0;19;954;0.02;0.0;0.0
5737_4.txt;32;3;0;35;596;0.05;0.01;0.0
3698_3.txt;1;0;0;1;126;0.01;0.0;0.0
2627_1.txt;5;1;0;6;154;0.03;0.01;0.0
2472_1.txt;1;0;3;4;340;0.0;0.0;0.01
6497_1.txt;2;0;0;2;194;0.01;0.0;0.0
1875_2.txt;11;0;1;12;302;0.04;0.0;0.0
10024_3.txt;8;3;0;11;223;0.04;0.01;0.0
475_1.txt;0;2;0;2;182;0.0;0.01;0.0
4942_4.txt;0;0;1;1;260;0.0;0.0;0.0
10881_2.txt;0;0;0;0;189;0.0;0.0;0.0
4243_2.txt;0;0;0;0;227;0.0;0.0;0.0
7974_3.txt;4;0;0;4;166;0.02;0.0;0.0
8761_3.txt;2;0;1;3;562;0.0;0.0;0.0
6724_1.txt;2;0;0;2;201;0.01;0.0;0.0
5499_1.txt;6;1;2;9;259;0.02;0.0;0.01
9910_1.txt;2;0;0;2;137;0.01;0.0;0.0
5211_4.txt;4;0;0;4;519;0.01;0.0;0.0
4733_1.txt;3;1;0;4;339;0.01;0.0;0.0
3200_1.txt;27;7;4;38;694;0.04;0.01;0.01
6399_1.txt;8;0;4;12;195;0.04;0.0;0.02
12324_3.txt;9;1;0;10;135;0.07;0.01;0.0
7977_1.txt;1;1;0;2;96;0.01;0.01;0.0
7820_1.txt;8;0;5;13;852;0.01;0.0;0.01
6931_3.txt;2;0;0;2;424;0.0;0.0;0.0
8271_1.txt;13;12;3;28;727;0.02;0.02;0.0
4769_2.txt;1;1;1;3;141;0.01;0.01;0.01
8221_1.txt;0;0;0;0;222;0.0;0.0;0.0
12056_4.txt;0;2;1;3;133;0.0;0.02;0.01
11427_1.txt;4;0;0;4;203;0.02;0.0;0.0
10695_1.txt;0;0;0;0;151;0.0;0.0;0.0
2201_3.txt;15;0;0;15;162;0.09;0.0;0.0
5064_1.txt;2;0;0;2;205;0.01;0.0;0.0
2633_1.txt;16;0;0;16;350;0.05;0.0;0.0
3523_1.txt;8;0;0;8;170;0.05;0.0;0.0
10814_2.txt;4;1;0;5;145;0.03;0.01;0.0
6043_1.txt;5;0;0;5;239;0.02;0.0;0.0
11080_1.txt;2;0;0;2;155;0.01;0.0;0.0
7612_3.txt;29;13;1;43;946;0.03;0.01;0.0
11155_2.txt;2;0;0;2;260;0.01;0.0;0.0
11692_1.txt;2;0;0;2;47;0.04;0.0;0.0
5772_1.txt;2;0;0;2;399;0.01;0.0;0.0
6646_1.txt;8;0;0;8;153;0.05;0.0;0.0
2810_4.txt;1;0;0;1;115;0.01;0.0;0.0
235_1.txt;0;1;0;1;163;0.0;0.01;0.0
4389_2.txt;2;0;0;2;70;0.03;0.0;0.0
144_2.txt;0;0;0;0;298;0.0;0.0;0.0
12410_1.txt;0;0;0;0;143;0.0;0.0;0.0
1614_4.txt;28;9;2;39;358;0.08;0.03;0.01
10997_1.txt;0;0;0;0;154;0.0;0.0;0.0
4763_2.txt;6;0;0;6;297;0.02;0.0;0.0
2314_3.txt;7;0;2;9;180;0.04;0.0;0.01
4475_1.txt;0;0;0;0;144;0.0;0.0;0.0
11088_4.txt;1;1;0;2;161;0.01;0.01;0.0
10945_1.txt;5;0;0;5;137;0.04;0.0;0.0
10905_3.txt;7;0;0;7;154;0.05;0.0;0.0
6846_1.txt;2;0;0;2;79;0.03;0.0;0.0
11946_4.txt;9;6;0;15;474;0.02;0.01;0.0
6182_1.txt;7;0;0;7;269;0.03;0.0;0.0
7484_1.txt;14;0;0;14;131;0.11;0.0;0.0
6933_1.txt;1;0;0;1;121;0.01;0.0;0.0
10402_1.txt;0;0;0;0;218;0.0;0.0;0.0
2221_1.txt;6;0;0;6;214;0.03;0.0;0.0
9781_1.txt;0;0;0;0;159;0.0;0.0;0.0
6518_4.txt;0;1;0;1;111;0.0;0.01;0.0
6060_3.txt;0;0;0;0;191;0.0;0.0;0.0
5424_1.txt;0;0;0;0;200;0.0;0.0;0.0
9181_2.txt;2;0;0;2;344;0.01;0.0;0.0
12071_1.txt;0;0;0;0;87;0.0;0.0;0.0
9798_4.txt;0;1;4;5;341;0.0;0.0;0.01
2933_3.txt;2;0;0;2;146;0.01;0.0;0.0
161_2.txt;10;4;0;14;171;0.06;0.02;0.0
341_4.txt;17;1;0;18;482;0.04;0.0;0.0
3964_4.txt;1;0;0;1;172;0.01;0.0;0.0
7570_2.txt;33;13;1;47;467;0.07;0.03;0.0
3403_3.txt;12;1;0;13;302;0.04;0.0;0.0
7357_1.txt;2;0;0;2;48;0.04;0.0;0.0
4712_2.txt;2;0;0;2;265;0.01;0.0;0.0
11235_4.txt;9;5;3;17;507;0.02;0.01;0.01
7490_4.txt;6;1;2;9;147;0.04;0.01;0.01
11914_2.txt;11;0;0;11;266;0.04;0.0;0.0
8634_3.txt;2;0;0;2;115;0.02;0.0;0.0
2598_1.txt;1;0;1;2;150;0.01;0.0;0.01
8633_4.txt;10;0;0;10;463;0.02;0.0;0.0
7614_1.txt;0;1;0;1;159;0.0;0.01;0.0
3324_3.txt;2;1;2;5;239;0.01;0.0;0.01
11886_1.txt;5;0;0;5;117;0.04;0.0;0.0
3635_3.txt;0;1;0;1;56;0.0;0.02;0.0
9672_3.txt;0;0;2;2;138;0.0;0.0;0.01
7234_4.txt;9;1;0;10;301;0.03;0.0;0.0
2969_3.txt;5;0;0;5;156;0.03;0.0;0.0
9059_3.txt;0;0;1;1;123;0.0;0.0;0.01
8293_4.txt;29;0;2;31;785;0.04;0.0;0.0
10107_1.txt;0;0;0;0;207;0.0;0.0;0.0
3860_4.txt;2;0;0;2;114;0.02;0.0;0.0
6040_1.txt;0;0;0;0;148;0.0;0.0;0.0
3556_1.txt;5;0;0;5;146;0.03;0.0;0.0
1379_4.txt;18;0;0;18;152;0.12;0.0;0.0
7465_1.txt;2;0;0;2;56;0.04;0.0;0.0
12288_4.txt;0;0;0;0;172;0.0;0.0;0.0
9738_4.txt;21;0;0;21;274;0.08;0.0;0.0
153_1.txt;32;3;7;42;1138;0.03;0.0;0.01
3041_1.txt;7;0;0;7;254;0.03;0.0;0.0
2233_2.txt;0;0;0;0;207;0.0;0.0;0.0
12256_4.txt;0;4;0;4;294;0.0;0.01;0.0
594_4.txt;0;0;0;0;138;0.0;0.0;0.0
2975_4.txt;3;0;3;6;429;0.01;0.0;0.01
1094_4.txt;9;0;0;9;160;0.06;0.0;0.0
3636_1.txt;0;4;0;4;166;0.0;0.02;0.0
5026_3.txt;5;2;6;13;414;0.01;0.0;0.01
5315_4.txt;3;1;1;5;145;0.02;0.01;0.01
3489_2.txt;4;0;0;4;326;0.01;0.0;0.0
10301_4.txt;2;2;0;4;254;0.01;0.01;0.0
5060_4.txt;6;1;0;7;193;0.03;0.01;0.0
3711_4.txt;2;0;0;2;232;0.01;0.0;0.0
8512_3.txt;1;0;0;1;92;0.01;0.0;0.0
7082_1.txt;3;0;0;3;160;0.02;0.0;0.0
4087_2.txt;7;0;4;11;153;0.05;0.0;0.03
6740_2.txt;21;1;0;22;504;0.04;0.0;0.0
4019_3.txt;4;1;2;7;138;0.03;0.01;0.01
4922_4.txt;1;7;3;11;431;0.0;0.02;0.01
1296_3.txt;12;3;0;15;532;0.02;0.01;0.0
4676_3.txt;16;0;0;16;728;0.02;0.0;0.0
6986_1.txt;13;0;4;17;361;0.04;0.0;0.01
4821_4.txt;0;2;0;2;142;0.0;0.01;0.0
4133_1.txt;0;0;0;0;150;0.0;0.0;0.0
706_4.txt;10;0;2;12;190;0.05;0.0;0.01
8911_4.txt;27;0;5;32;680;0.04;0.0;0.01
5317_2.txt;1;1;0;2;276;0.0;0.0;0.0
3597_2.txt;14;2;0;16;412;0.03;0.0;0.0
8448_3.txt;23;1;3;27;1000;0.02;0.0;0.0
10173_1.txt;12;0;2;14;268;0.04;0.0;0.01
8464_1.txt;0;0;2;2;326;0.0;0.0;0.01
12202_3.txt;15;6;0;21;916;0.02;0.01;0.0
10257_1.txt;12;0;2;14;259;0.05;0.0;0.01
10662_1.txt;2;0;0;2;57;0.04;0.0;0.0
8335_1.txt;7;0;0;7;151;0.05;0.0;0.0
11193_2.txt;3;4;1;8;328;0.01;0.01;0.0
9590_1.txt;5;3;0;8;136;0.04;0.02;0.0
1252_4.txt;2;0;0;2;54;0.04;0.0;0.0
9043_3.txt;0;0;1;1;179;0.0;0.0;0.01
1202_2.txt;2;0;0;2;159;0.01;0.0;0.0
4684_1.txt;2;2;2;6;155;0.01;0.01;0.01
12344_3.txt;12;2;0;14;121;0.1;0.02;0.0
4914_1.txt;7;0;0;7;144;0.05;0.0;0.0
11265_1.txt;0;0;0;0;223;0.0;0.0;0.0
12465_2.txt;3;1;0;4;183;0.02;0.01;0.0
4786_1.txt;5;0;0;5;124;0.04;0.0;0.0
1083_1.txt;3;4;0;7;162;0.02;0.02;0.0
11313_3.txt;2;0;0;2;339;0.01;0.0;0.0
11912_2.txt;2;0;0;2;380;0.01;0.0;0.0
6732_4.txt;6;0;2;8;158;0.04;0.0;0.01
12462_2.txt;0;0;0;0;166;0.0;0.0;0.0
1158_4.txt;4;0;0;4;218;0.02;0.0;0.0
1631_1.txt;8;0;0;8;672;0.01;0.0;0.0
9154_1.txt;0;0;0;0;176;0.0;0.0;0.0
11673_3.txt;5;0;0;5;118;0.04;0.0;0.0
9285_3.txt;12;0;0;12;129;0.09;0.0;0.0
7888_1.txt;0;0;0;0;130;0.0;0.0;0.0
7523_1.txt;2;0;0;2;155;0.01;0.0;0.0
9749_4.txt;9;0;0;9;459;0.02;0.0;0.0
254_1.txt;14;1;3;18;369;0.04;0.0;0.01
2053_1.txt;3;0;0;3;91;0.03;0.0;0.0
2199_2.txt;0;0;0;0;148;0.0;0.0;0.0
1463_1.txt;6;1;1;8;197;0.03;0.01;0.01
2122_4.txt;7;0;2;9;121;0.06;0.0;0.02
1851_1.txt;3;0;0;3;195;0.02;0.0;0.0
2380_1.txt;0;0;0;0;64;0.0;0.0;0.0
9084_1.txt;4;0;0;4;143;0.03;0.0;0.0
7065_2.txt;0;0;0;0;244;0.0;0.0;0.0
1520_1.txt;0;0;2;2;77;0.0;0.0;0.03
3116_2.txt;0;0;0;0;95;0.0;0.0;0.0
4060_4.txt;23;1;0;24;364;0.06;0.0;0.0
3954_1.txt;4;0;0;4;158;0.03;0.0;0.0
1464_4.txt;22;3;1;26;355;0.06;0.01;0.0
4115_1.txt;2;1;0;3;166;0.01;0.01;0.0
162_4.txt;0;0;0;0;151;0.0;0.0;0.0
9792_2.txt;3;0;0;3;148;0.02;0.0;0.0
7174_1.txt;0;0;0;0;188;0.0;0.0;0.0
10868_3.txt;0;0;0;0;347;0.0;0.0;0.0
8863_2.txt;9;2;0;11;274;0.03;0.01;0.0
3926_2.txt;4;0;0;4;154;0.03;0.0;0.0
5666_4.txt;24;4;8;36;787;0.03;0.01;0.01
2330_4.txt;8;0;0;8;250;0.03;0.0;0.0
10158_4.txt;0;0;0;0;201;0.0;0.0;0.0
7593_2.txt;3;2;0;5;145;0.02;0.01;0.0
9949_2.txt;8;1;0;9;162;0.05;0.01;0.0
7042_1.txt;4;0;0;4;103;0.04;0.0;0.0
5865_1.txt;0;0;1;1;111;0.0;0.0;0.01
11547_4.txt;2;0;0;2;148;0.01;0.0;0.0
12352_1.txt;6;0;0;6;92;0.07;0.0;0.0
3665_1.txt;4;0;0;4;262;0.02;0.0;0.0
7698_1.txt;2;0;0;2;151;0.01;0.0;0.0
10220_3.txt;7;1;1;9;197;0.04;0.01;0.01
1067_3.txt;6;5;5;16;288;0.02;0.02;0.02
2579_1.txt;0;0;2;2;190;0.0;0.0;0.01
1766_1.txt;6;0;11;17;416;0.01;0.0;0.03
11472_1.txt;0;0;0;0;86;0.0;0.0;0.0
10088_1.txt;1;0;0;1;201;0.0;0.0;0.0
12279_1.txt;2;0;2;4;594;0.0;0.0;0.0
9934_3.txt;0;0;0;0;200;0.0;0.0;0.0
1392_2.txt;8;0;1;9;244;0.03;0.0;0.0
4331_2.txt;3;1;0;4;190;0.02;0.01;0.0
3572_1.txt;22;2;0;24;301;0.07;0.01;0.0
8478_1.txt;3;0;0;3;176;0.02;0.0;0.0
4238_1.txt;4;0;0;4;190;0.02;0.0;0.0
11818_2.txt;0;0;0;0;267;0.0;0.0;0.0
7679_4.txt;3;5;0;8;451;0.01;0.01;0.0
5683_2.txt;1;0;0;1;146;0.01;0.0;0.0
9216_3.txt;28;0;1;29;438;0.06;0.0;0.0
11474_1.txt;0;0;0;0;148;0.0;0.0;0.0
4634_2.txt;2;0;0;2;222;0.01;0.0;0.0
2320_1.txt;9;4;0;13;255;0.04;0.02;0.0
12489_1.txt;0;3;0;3;503;0.0;0.01;0.0
2550_1.txt;0;0;0;0;231;0.0;0.0;0.0
12488_1.txt;0;0;0;0;156;0.0;0.0;0.0
11857_1.txt;0;1;0;1;190;0.0;0.01;0.0
8226_1.txt;1;1;3;5;356;0.0;0.0;0.01
11978_4.txt;35;3;4;42;601;0.06;0.0;0.01
5686_2.txt;0;0;0;0;294;0.0;0.0;0.0
7100_3.txt;2;0;0;2;66;0.03;0.0;0.0
6858_2.txt;17;1;3;21;349;0.05;0.0;0.01
9066_4.txt;3;0;0;3;144;0.02;0.0;0.0
405_3.txt;0;0;0;0;168;0.0;0.0;0.0
4157_3.txt;2;3;0;5;473;0.0;0.01;0.0
7468_4.txt;25;3;3;31;295;0.08;0.01;0.01
7420_2.txt;3;4;0;7;276;0.01;0.01;0.0
5814_3.txt;0;0;0;0;91;0.0;0.0;0.0
11437_1.txt;30;0;0;30;514;0.06;0.0;0.0
1565_1.txt;0;0;0;0;138;0.0;0.0;0.0
3181_4.txt;9;0;1;10;269;0.03;0.0;0.0
727_3.txt;10;0;0;10;290;0.03;0.0;0.0
6616_1.txt;1;0;0;1;404;0.0;0.0;0.0
4812_2.txt;1;2;0;3;160;0.01;0.01;0.0
5949_3.txt;2;2;0;4;93;0.02;0.02;0.0
9952_3.txt;2;0;0;2;343;0.01;0.0;0.0
1770_1.txt;1;0;0;1;158;0.01;0.0;0.0
7817_1.txt;9;0;0;9;138;0.07;0.0;0.0
1760_1.txt;0;1;1;2;145;0.0;0.01;0.01
12477_1.txt;0;0;0;0;233;0.0;0.0;0.0
8877_4.txt;3;0;0;3;135;0.02;0.0;0.0
4527_2.txt;18;10;0;28;638;0.03;0.02;0.0
6624_1.txt;18;1;1;20;305;0.06;0.0;0.0
3956_1.txt;0;0;0;0;132;0.0;0.0;0.0
9939_1.txt;2;0;0;2;259;0.01;0.0;0.0
7688_1.txt;0;0;0;0;156;0.0;0.0;0.0
9999_3.txt;4;1;3;8;184;0.02;0.01;0.02
819_1.txt;4;0;0;4;81;0.05;0.0;0.0
5103_4.txt;3;0;0;3;92;0.03;0.0;0.0
11699_1.txt;5;0;0;5;133;0.04;0.0;0.0
4007_4.txt;4;0;0;4;423;0.01;0.0;0.0
6588_2.txt;0;1;0;1;197;0.0;0.01;0.0
9562_4.txt;0;0;0;0;147;0.0;0.0;0.0
4670_4.txt;16;2;0;18;433;0.04;0.0;0.0
1211_2.txt;5;0;0;5;237;0.02;0.0;0.0
1878_4.txt;24;2;1;27;579;0.04;0.0;0.0
10867_1.txt;0;0;0;0;130;0.0;0.0;0.0
5609_1.txt;19;3;1;23;589;0.03;0.01;0.0
10197_1.txt;10;2;0;12;428;0.02;0.0;0.0
9368_3.txt;5;0;3;8;380;0.01;0.0;0.01
4954_2.txt;7;0;2;9;247;0.03;0.0;0.01
10178_3.txt;2;0;0;2;115;0.02;0.0;0.0
2944_1.txt;0;0;0;0;102;0.0;0.0;0.0
362_3.txt;1;0;0;1;108;0.01;0.0;0.0
2919_1.txt;0;2;0;2;177;0.0;0.01;0.0
11009_1.txt;0;0;0;0;183;0.0;0.0;0.0
1059_2.txt;0;0;0;0;265;0.0;0.0;0.0
6359_4.txt;9;0;1;10;390;0.02;0.0;0.0
5749_1.txt;2;0;0;2;68;0.03;0.0;0.0
7425_3.txt;2;4;0;6;136;0.01;0.03;0.0
11267_1.txt;5;2;2;9;241;0.02;0.01;0.01
1292_4.txt;5;0;0;5;498;0.01;0.0;0.0
7076_3.txt;7;11;0;18;308;0.02;0.04;0.0
6717_3.txt;2;0;0;2;297;0.01;0.0;0.0
5280_4.txt;12;0;2;14;224;0.05;0.0;0.01
10628_1.txt;0;1;0;1;388;0.0;0.0;0.0
1198_4.txt;41;2;3;46;752;0.05;0.0;0.0
7283_1.txt;11;1;18;30;966;0.01;0.0;0.02
5345_4.txt;1;0;0;1;108;0.01;0.0;0.0
12123_1.txt;10;4;0;14;667;0.01;0.01;0.0
6055_1.txt;11;0;0;11;467;0.02;0.0;0.0
10563_1.txt;0;0;0;0;223;0.0;0.0;0.0
8838_4.txt;11;2;0;13;255;0.04;0.01;0.0
5470_3.txt;0;0;3;3;149;0.0;0.0;0.02
1087_1.txt;0;0;0;0;86;0.0;0.0;0.0
10350_1.txt;37;1;8;46;1122;0.03;0.0;0.01
1179_2.txt;2;0;0;2;240;0.01;0.0;0.0
3561_4.txt;13;1;0;14;215;0.06;0.0;0.0
3778_3.txt;0;0;1;1;72;0.0;0.0;0.01
7320_4.txt;2;0;1;3;119;0.02;0.0;0.01
8745_2.txt;0;0;0;0;127;0.0;0.0;0.0
2628_3.txt;6;0;0;6;111;0.05;0.0;0.0
3862_4.txt;13;0;0;13;165;0.08;0.0;0.0
8528_3.txt;3;2;0;5;333;0.01;0.01;0.0
9015_4.txt;4;0;0;4;194;0.02;0.0;0.0
4451_1.txt;3;0;1;4;174;0.02;0.0;0.01
4467_1.txt;0;1;0;1;183;0.0;0.01;0.0
3801_1.txt;0;0;1;1;179;0.0;0.0;0.01
1981_2.txt;7;0;1;8;209;0.03;0.0;0.0
5075_3.txt;1;0;0;1;145;0.01;0.0;0.0
9795_1.txt;8;3;4;15;181;0.04;0.02;0.02
4454_2.txt;10;12;2;24;430;0.02;0.03;0.0
4354_2.txt;1;1;1;3;233;0.0;0.0;0.0
1046_2.txt;2;0;0;2;62;0.03;0.0;0.0
654_3.txt;14;1;0;15;842;0.02;0.0;0.0
1838_2.txt;12;0;0;12;331;0.04;0.0;0.0
5739_4.txt;0;0;2;2;247;0.0;0.0;0.01
2416_2.txt;0;1;0;1;223;0.0;0.0;0.0
3352_2.txt;6;0;0;6;159;0.04;0.0;0.0
7250_2.txt;0;0;0;0;133;0.0;0.0;0.0
1159_1.txt;0;0;0;0;62;0.0;0.0;0.0
9445_1.txt;2;0;0;2;180;0.01;0.0;0.0
178_3.txt;0;0;0;0;225;0.0;0.0;0.0
4759_2.txt;10;0;0;10;229;0.04;0.0;0.0
1918_3.txt;12;0;1;13;261;0.05;0.0;0.0
4555_1.txt;0;0;0;0;254;0.0;0.0;0.0
9739_4.txt;13;0;0;13;260;0.05;0.0;0.0
6159_1.txt;0;0;2;2;330;0.0;0.0;0.01
11322_2.txt;1;1;0;2;101;0.01;0.01;0.0
11406_1.txt;3;0;0;3;77;0.04;0.0;0.0
9646_1.txt;12;0;1;13;147;0.08;0.0;0.01
12431_1.txt;3;1;3;7;413;0.01;0.0;0.01
4381_2.txt;0;0;0;0;298;0.0;0.0;0.0
2686_1.txt;7;3;0;10;503;0.01;0.01;0.0
7986_4.txt;45;1;0;46;778;0.06;0.0;0.0
726_3.txt;13;18;8;39;1066;0.01;0.02;0.01
3329_3.txt;2;0;0;2;231;0.01;0.0;0.0
8743_4.txt;18;2;0;20;480;0.04;0.0;0.0
3632_4.txt;25;0;9;34;1182;0.02;0.0;0.01
11491_3.txt;10;1;3;14;499;0.02;0.0;0.01
2086_3.txt;9;0;0;9;225;0.04;0.0;0.0
10993_1.txt;2;0;0;2;158;0.01;0.0;0.0
909_1.txt;0;0;0;0;101;0.0;0.0;0.0
11922_1.txt;1;1;0;2;120;0.01;0.01;0.0
3281_2.txt;10;0;0;10;156;0.06;0.0;0.0
7702_1.txt;17;2;1;20;813;0.02;0.0;0.0
11436_1.txt;13;0;0;13;455;0.03;0.0;0.0
3452_3.txt;5;1;0;6;166;0.03;0.01;0.0
11770_3.txt;2;2;1;5;389;0.01;0.01;0.0
9823_2.txt;14;0;0;14;915;0.02;0.0;0.0
7892_1.txt;0;0;0;0;200;0.0;0.0;0.0
2597_3.txt;21;1;2;24;459;0.05;0.0;0.0
5562_2.txt;2;0;0;2;102;0.02;0.0;0.0
9816_4.txt;4;0;0;4;163;0.02;0.0;0.0
2212_2.txt;2;0;1;3;392;0.01;0.0;0.0
2753_1.txt;10;0;0;10;139;0.07;0.0;0.0
1772_2.txt;3;0;6;9;223;0.01;0.0;0.03
1313_1.txt;0;0;0;0;94;0.0;0.0;0.0
1576_1.txt;0;0;0;0;175;0.0;0.0;0.0
3304_3.txt;4;2;5;11;166;0.02;0.01;0.03
4591_1.txt;16;2;0;18;671;0.02;0.0;0.0
2209_4.txt;4;0;2;6;274;0.01;0.0;0.01
836_4.txt;0;0;2;2;100;0.0;0.0;0.02
11505_3.txt;5;1;2;8;267;0.02;0.0;0.01
5006_1.txt;6;0;0;6;278;0.02;0.0;0.0
3152_2.txt;5;1;0;6;159;0.03;0.01;0.0
9000_2.txt;0;0;0;0;87;0.0;0.0;0.0
10121_3.txt;27;0;0;27;154;0.18;0.0;0.0
11338_3.txt;32;0;2;34;497;0.06;0.0;0.0
2596_1.txt;0;0;0;0;206;0.0;0.0;0.0
3745_2.txt;0;4;0;4;200;0.0;0.02;0.0
1354_1.txt;4;1;1;6;136;0.03;0.01;0.01
1941_1.txt;6;0;0;6;156;0.04;0.0;0.0
10879_1.txt;1;0;0;1;160;0.01;0.0;0.0
7578_4.txt;10;4;2;16;356;0.03;0.01;0.01
9527_3.txt;0;0;0;0;158;0.0;0.0;0.0
2913_4.txt;5;4;0;9;397;0.01;0.01;0.0
10940_1.txt;4;1;0;5;295;0.01;0.0;0.0
8846_2.txt;2;0;0;2;93;0.02;0.0;0.0
9998_4.txt;7;1;1;9;324;0.02;0.0;0.0
1610_2.txt;19;2;4;25;343;0.06;0.01;0.01
1490_1.txt;3;0;0;3;157;0.02;0.0;0.0
7587_4.txt;18;0;0;18;542;0.03;0.0;0.0
8499_2.txt;7;0;0;7;148;0.05;0.0;0.0
7546_1.txt;2;0;0;2;159;0.01;0.0;0.0
9035_4.txt;8;0;0;8;206;0.04;0.0;0.0
4958_1.txt;6;0;0;6;186;0.03;0.0;0.0
2796_2.txt;2;0;0;2;295;0.01;0.0;0.0
12239_1.txt;6;1;2;9;295;0.02;0.0;0.01
2291_4.txt;20;5;2;27;723;0.03;0.01;0.0
3977_2.txt;31;3;1;35;269;0.12;0.01;0.0
3442_2.txt;0;0;0;0;239;0.0;0.0;0.0
9474_1.txt;2;1;0;3;272;0.01;0.0;0.0
9947_1.txt;1;0;0;1;218;0.0;0.0;0.0
5421_4.txt;11;3;1;15;353;0.03;0.01;0.0
9652_3.txt;14;2;2;18;229;0.06;0.01;0.01
6323_1.txt;0;0;0;0;174;0.0;0.0;0.0
6215_1.txt;0;0;0;0;150;0.0;0.0;0.0
10235_2.txt;0;1;0;1;138;0.0;0.01;0.0
8645_1.txt;3;1;0;4;300;0.01;0.0;0.0
4598_4.txt;11;3;0;14;298;0.04;0.01;0.0
1630_4.txt;10;0;0;10;138;0.07;0.0;0.0
5944_1.txt;4;0;0;4;314;0.01;0.0;0.0
8047_2.txt;15;3;1;19;509;0.03;0.01;0.0
10390_2.txt;9;0;0;9;449;0.02;0.0;0.0
8896_1.txt;1;0;0;1;143;0.01;0.0;0.0
3673_3.txt;2;1;0;3;147;0.01;0.01;0.0
902_4.txt;9;1;6;16;428;0.02;0.0;0.01
7642_1.txt;0;0;0;0;126;0.0;0.0;0.0
6693_1.txt;1;0;0;1;195;0.01;0.0;0.0
7562_1.txt;0;0;1;1;229;0.0;0.0;0.0
8403_4.txt;4;0;1;5;144;0.03;0.0;0.01
4320_1.txt;10;0;0;10;231;0.04;0.0;0.0
9555_4.txt;6;0;1;7;853;0.01;0.0;0.0
7277_1.txt;6;0;0;6;313;0.02;0.0;0.0
8938_2.txt;0;0;0;0;118;0.0;0.0;0.0
6262_1.txt;0;0;0;0;238;0.0;0.0;0.0
8836_1.txt;1;0;3;4;448;0.0;0.0;0.01
12106_1.txt;4;1;2;7;181;0.02;0.01;0.01
8643_1.txt;1;1;2;4;172;0.01;0.01;0.01
233_1.txt;5;0;0;5;188;0.03;0.0;0.0
1121_4.txt;3;0;0;3;133;0.02;0.0;0.0
2251_1.txt;0;0;0;0;144;0.0;0.0;0.0
9075_1.txt;18;0;0;18;240;0.07;0.0;0.0
585_1.txt;0;2;0;2;192;0.0;0.01;0.0
2973_2.txt;0;0;0;0;156;0.0;0.0;0.0
10999_1.txt;0;0;1;1;156;0.0;0.0;0.01
7004_4.txt;51;2;3;56;827;0.06;0.0;0.0
11854_1.txt;5;0;0;5;156;0.03;0.0;0.0
1333_1.txt;2;0;0;2;133;0.02;0.0;0.0
4953_1.txt;1;0;5;6;138;0.01;0.0;0.04
8595_1.txt;11;0;0;11;264;0.04;0.0;0.0
10735_4.txt;0;1;2;3;404;0.0;0.0;0.0
1618_3.txt;3;0;0;3;450;0.01;0.0;0.0
10531_3.txt;31;1;1;33;467;0.07;0.0;0.0
9751_3.txt;0;0;0;0;186;0.0;0.0;0.0
10918_1.txt;15;0;4;19;167;0.09;0.0;0.02
11276_1.txt;3;3;0;6;337;0.01;0.01;0.0
11094_1.txt;2;1;4;7;222;0.01;0.0;0.02
4127_1.txt;0;0;0;0;197;0.0;0.0;0.0
311_1.txt;3;1;0;4;166;0.02;0.01;0.0
3748_1.txt;2;0;0;2;134;0.01;0.0;0.0
9670_4.txt;4;0;3;7;627;0.01;0.0;0.0
5337_1.txt;4;0;0;4;292;0.01;0.0;0.0
2433_4.txt;0;0;0;0;33;0.0;0.0;0.0
277_4.txt;12;5;2;19;368;0.03;0.01;0.01
1128_1.txt;0;0;0;0;184;0.0;0.0;0.0
11766_1.txt;22;5;10;37;554;0.04;0.01;0.02
3192_1.txt;6;0;0;6;186;0.03;0.0;0.0
1098_2.txt;0;1;0;1;241;0.0;0.0;0.0
8286_1.txt;5;2;0;7;371;0.01;0.01;0.0
8256_4.txt;5;0;0;5;132;0.04;0.0;0.0
1505_3.txt;14;0;0;14;232;0.06;0.0;0.0
7279_1.txt;1;2;0;3;212;0.0;0.01;0.0
2276_4.txt;15;3;0;18;152;0.1;0.02;0.0
8227_1.txt;0;0;0;0;153;0.0;0.0;0.0
2691_4.txt;3;0;0;3;66;0.05;0.0;0.0
12246_1.txt;0;2;0;2;509;0.0;0.0;0.0
3016_1.txt;8;0;0;8;139;0.06;0.0;0.0
4813_3.txt;14;0;0;14;424;0.03;0.0;0.0
9080_3.txt;4;2;0;6;173;0.02;0.01;0.0
3820_2.txt;12;0;4;16;342;0.04;0.0;0.01
7556_1.txt;12;1;0;13;911;0.01;0.0;0.0
1044_4.txt;6;6;2;14;497;0.01;0.01;0.0
11671_2.txt;4;0;0;4;369;0.01;0.0;0.0
2692_1.txt;7;4;0;11;125;0.06;0.03;0.0
5731_1.txt;0;0;0;0;212;0.0;0.0;0.0
10215_2.txt;11;0;1;12;233;0.05;0.0;0.0
4814_3.txt;14;0;2;16;488;0.03;0.0;0.0
9023_4.txt;2;0;0;2;403;0.0;0.0;0.0
2129_4.txt;15;1;0;16;167;0.09;0.01;0.0
8083_3.txt;9;1;0;10;195;0.05;0.01;0.0
4429_1.txt;4;0;2;6;114;0.04;0.0;0.02
2763_1.txt;6;1;2;9;388;0.02;0.0;0.01
220_4.txt;7;0;5;12;289;0.02;0.0;0.02
6970_3.txt;0;0;0;0;232;0.0;0.0;0.0
5661_2.txt;10;0;3;13;170;0.06;0.0;0.02
11703_1.txt;8;1;0;9;581;0.01;0.0;0.0
6635_1.txt;16;2;0;18;160;0.1;0.01;0.0
2127_3.txt;6;0;0;6;175;0.03;0.0;0.0
6939_4.txt;18;2;5;25;293;0.06;0.01;0.02
7001_1.txt;0;0;0;0;55;0.0;0.0;0.0
5041_2.txt;18;4;0;22;322;0.06;0.01;0.0
9865_2.txt;0;0;0;0;207;0.0;0.0;0.0
3424_1.txt;9;0;0;9;227;0.04;0.0;0.0
1971_1.txt;4;0;0;4;143;0.03;0.0;0.0
7511_1.txt;9;0;0;9;269;0.03;0.0;0.0
10085_3.txt;0;0;0;0;124;0.0;0.0;0.0
9969_1.txt;8;0;0;8;134;0.06;0.0;0.0
4025_1.txt;0;0;0;0;53;0.0;0.0;0.0
7497_4.txt;6;2;0;8;111;0.05;0.02;0.0
7012_1.txt;0;1;0;1;145;0.0;0.01;0.0
1210_1.txt;0;0;0;0;172;0.0;0.0;0.0
9030_1.txt;2;0;0;2;145;0.01;0.0;0.0
11003_1.txt;0;0;0;0;143;0.0;0.0;0.0
3904_4.txt;20;4;0;24;356;0.06;0.01;0.0
11205_2.txt;8;1;0;9;355;0.02;0.0;0.0
1644_1.txt;0;0;0;0;111;0.0;0.0;0.0
7929_4.txt;0;2;0;2;160;0.0;0.01;0.0
6575_4.txt;0;1;0;1;123;0.0;0.01;0.0
3684_1.txt;5;0;0;5;205;0.02;0.0;0.0
3918_3.txt;8;1;2;11;344;0.02;0.0;0.01
1517_2.txt;4;0;0;4;379;0.01;0.0;0.0
8441_1.txt;6;2;0;8;140;0.04;0.01;0.0
11655_3.txt;14;0;0;14;414;0.03;0.0;0.0
8974_4.txt;2;0;0;2;120;0.02;0.0;0.0
5513_1.txt;38;0;0;38;746;0.05;0.0;0.0
11901_1.txt;4;0;0;4;131;0.03;0.0;0.0
8979_2.txt;6;6;0;12;325;0.02;0.02;0.0
6715_4.txt;1;1;0;2;146;0.01;0.01;0.0
7879_4.txt;1;0;0;1;193;0.01;0.0;0.0
6603_3.txt;20;0;0;20;155;0.13;0.0;0.0
9016_1.txt;0;0;0;0;175;0.0;0.0;0.0
10130_2.txt;9;3;6;18;354;0.03;0.01;0.02
7515_1.txt;0;0;0;0;100;0.0;0.0;0.0
8365_4.txt;0;0;1;1;120;0.0;0.0;0.01
8116_1.txt;0;0;0;0;58;0.0;0.0;0.0
159_4.txt;2;7;5;14;163;0.01;0.04;0.03
3439_3.txt;0;0;0;0;312;0.0;0.0;0.0
1588_1.txt;8;0;0;8;184;0.04;0.0;0.0
347_1.txt;8;0;0;8;110;0.07;0.0;0.0
11898_4.txt;6;0;0;6;248;0.02;0.0;0.0
7424_3.txt;10;10;0;20;370;0.03;0.03;0.0
7383_1.txt;5;0;0;5;180;0.03;0.0;0.0
10816_2.txt;7;2;0;9;165;0.04;0.01;0.0
9961_4.txt;4;0;0;4;230;0.02;0.0;0.0
11390_1.txt;3;0;1;4;167;0.02;0.0;0.01
3018_2.txt;0;0;0;0;512;0.0;0.0;0.0
5488_2.txt;3;1;0;4;206;0.01;0.0;0.0
8350_3.txt;3;2;0;5;142;0.02;0.01;0.0
9801_1.txt;0;0;2;2;327;0.0;0.0;0.01
4565_3.txt;10;1;1;12;458;0.02;0.0;0.0
3420_1.txt;2;1;2;5;271;0.01;0.0;0.01
56_3.txt;0;0;0;0;60;0.0;0.0;0.0
7236_3.txt;6;3;0;9;281;0.02;0.01;0.0
1139_1.txt;7;0;1;8;187;0.04;0.0;0.01
2403_1.txt;5;1;0;6;154;0.03;0.01;0.0
936_1.txt;10;0;2;12;530;0.02;0.0;0.0
6056_2.txt;5;0;0;5;131;0.04;0.0;0.0
6219_3.txt;9;0;0;9;160;0.06;0.0;0.0
12062_4.txt;25;1;1;27;381;0.07;0.0;0.0
988_1.txt;2;0;0;2;132;0.02;0.0;0.0
2744_3.txt;1;0;0;1;160;0.01;0.0;0.0
1389_2.txt;0;0;0;0;187;0.0;0.0;0.0
4135_1.txt;2;0;0;2;174;0.01;0.0;0.0
11536_3.txt;39;7;1;47;1088;0.04;0.01;0.0
11795_1.txt;0;0;0;0;69;0.0;0.0;0.0
7081_2.txt;0;0;0;0;82;0.0;0.0;0.0
5845_3.txt;1;0;0;1;229;0.0;0.0;0.0
1622_4.txt;9;1;0;10;219;0.04;0.0;0.0
9119_1.txt;4;0;0;4;134;0.03;0.0;0.0
5675_2.txt;9;0;0;9;195;0.05;0.0;0.0
3133_1.txt;1;1;0;2;155;0.01;0.01;0.0
2215_1.txt;0;0;0;0;214;0.0;0.0;0.0
1132_4.txt;4;1;1;6;176;0.02;0.01;0.01
1142_3.txt;2;1;2;5;222;0.01;0.0;0.01
11569_3.txt;1;0;0;1;185;0.01;0.0;0.0
5282_4.txt;7;0;2;9;275;0.03;0.0;0.01
8563_2.txt;4;0;0;4;107;0.04;0.0;0.0
5429_1.txt;18;2;1;21;273;0.07;0.01;0.0
9242_3.txt;12;7;1;20;292;0.04;0.02;0.0
1538_3.txt;14;0;0;14;250;0.06;0.0;0.0
2746_4.txt;0;0;0;0;147;0.0;0.0;0.0
9928_3.txt;45;0;6;51;1089;0.04;0.0;0.01
11365_1.txt;1;5;0;6;146;0.01;0.03;0.0
3793_3.txt;7;0;2;9;274;0.03;0.0;0.01
4935_1.txt;4;1;0;5;289;0.01;0.0;0.0
5605_1.txt;5;0;0;5;166;0.03;0.0;0.0
8435_1.txt;2;0;0;2;69;0.03;0.0;0.0
8301_1.txt;2;0;0;2;154;0.01;0.0;0.0
887_3.txt;2;6;0;8;403;0.0;0.01;0.0
5888_4.txt;2;0;0;2;224;0.01;0.0;0.0
3405_1.txt;0;0;0;0;133;0.0;0.0;0.0
3566_4.txt;4;0;0;4;303;0.01;0.0;0.0
6204_1.txt;10;1;0;11;444;0.02;0.0;0.0
8824_1.txt;0;0;0;0;168;0.0;0.0;0.0
218_4.txt;14;0;0;14;440;0.03;0.0;0.0
11213_3.txt;0;0;0;0;401;0.0;0.0;0.0
8891_3.txt;25;3;1;29;382;0.07;0.01;0.0
9213_3.txt;6;0;4;10;275;0.02;0.0;0.01
9959_1.txt;0;0;0;0;139;0.0;0.0;0.0
4818_1.txt;0;1;0;1;174;0.0;0.01;0.0
7171_1.txt;7;1;0;8;191;0.04;0.01;0.0
11343_4.txt;4;0;2;6;139;0.03;0.0;0.01
4746_4.txt;24;1;1;26;1042;0.02;0.0;0.0
850_1.txt;2;0;0;2;283;0.01;0.0;0.0
3492_1.txt;0;0;0;0;93;0.0;0.0;0.0
2372_1.txt;15;2;0;17;358;0.04;0.01;0.0
3242_1.txt;2;0;0;2;249;0.01;0.0;0.0
9180_1.txt;4;0;1;5;538;0.01;0.0;0.0
11224_3.txt;9;0;4;13;444;0.02;0.0;0.01
1491_2.txt;33;4;8;45;612;0.05;0.01;0.01
2398_2.txt;16;0;0;16;434;0.04;0.0;0.0
5649_2.txt;9;0;0;9;426;0.02;0.0;0.0
10255_1.txt;6;0;0;6;411;0.01;0.0;0.0
6144_2.txt;7;0;0;7;262;0.03;0.0;0.0
11725_4.txt;13;3;1;17;416;0.03;0.01;0.0
5889_1.txt;4;0;2;6;356;0.01;0.0;0.01
3850_2.txt;3;1;1;5;188;0.02;0.01;0.01
5854_1.txt;5;0;0;5;211;0.02;0.0;0.0
9362_1.txt;0;0;0;0;210;0.0;0.0;0.0
7883_1.txt;0;0;6;6;174;0.0;0.0;0.03
763_1.txt;5;0;0;5;185;0.03;0.0;0.0
9535_2.txt;0;0;0;0;140;0.0;0.0;0.0
9322_1.txt;0;1;2;3;361;0.0;0.0;0.01
3032_3.txt;1;0;0;1;88;0.01;0.0;0.0
11581_2.txt;3;0;0;3;109;0.03;0.0;0.0
2313_4.txt;6;1;0;7;260;0.02;0.0;0.0
6037_1.txt;0;0;0;0;355;0.0;0.0;0.0
51_1.txt;0;0;0;0;167;0.0;0.0;0.0
5677_4.txt;6;0;0;6;646;0.01;0.0;0.0
11348_4.txt;38;8;0;46;1007;0.04;0.01;0.0
7306_3.txt;0;0;0;0;209;0.0;0.0;0.0
1327_4.txt;6;1;0;7;68;0.09;0.01;0.0
6303_1.txt;6;0;0;6;145;0.04;0.0;0.0
3718_1.txt;95;9;10;114;1160;0.08;0.01;0.01
8003_3.txt;1;0;1;2;271;0.0;0.0;0.0
12497_4.txt;15;3;2;20;254;0.06;0.01;0.01
7130_3.txt;2;0;2;4;169;0.01;0.0;0.01
4400_4.txt;12;0;0;12;85;0.14;0.0;0.0
76_3.txt;6;1;0;7;218;0.03;0.0;0.0
6430_1.txt;0;0;0;0;51;0.0;0.0;0.0
10767_1.txt;2;0;0;2;183;0.01;0.0;0.0
9674_3.txt;0;0;0;0;75;0.0;0.0;0.0
11266_1.txt;0;0;0;0;112;0.0;0.0;0.0
3805_2.txt;9;0;0;9;174;0.05;0.0;0.0
5602_3.txt;0;0;0;0;172;0.0;0.0;0.0
2458_2.txt;0;1;0;1;145;0.0;0.01;0.0
5785_4.txt;17;3;0;20;392;0.04;0.01;0.0
9853_1.txt;0;0;0;0;162;0.0;0.0;0.0
1807_2.txt;0;1;0;1;265;0.0;0.0;0.0
4556_2.txt;0;0;0;0;180;0.0;0.0;0.0
3626_4.txt;10;1;0;11;266;0.04;0.0;0.0
2503_1.txt;0;12;2;14;322;0.0;0.04;0.01
1399_3.txt;2;0;0;2;397;0.01;0.0;0.0
6656_2.txt;1;0;0;1;152;0.01;0.0;0.0
12382_1.txt;10;2;0;12;144;0.07;0.01;0.0
4840_4.txt;0;0;0;0;136;0.0;0.0;0.0
1286_2.txt;11;2;5;18;178;0.06;0.01;0.03
5175_2.txt;18;2;9;29;662;0.03;0.0;0.01
10309_3.txt;15;0;4;19;288;0.05;0.0;0.01
1604_4.txt;1;0;2;3;448;0.0;0.0;0.0
3547_1.txt;14;4;1;19;697;0.02;0.01;0.0
6481_4.txt;10;0;5;15;390;0.03;0.0;0.01
4033_1.txt;0;1;0;1;161;0.0;0.01;0.0
10793_4.txt;5;2;0;7;204;0.02;0.01;0.0
11409_1.txt;6;0;0;6;426;0.01;0.0;0.0
10007_1.txt;6;0;0;6;75;0.08;0.0;0.0
3149_3.txt;14;0;0;14;261;0.05;0.0;0.0
3044_1.txt;6;2;0;8;103;0.06;0.02;0.0
12216_4.txt;9;0;0;9;192;0.05;0.0;0.0
6736_3.txt;4;0;0;4;264;0.02;0.0;0.0
1500_3.txt;3;1;0;4;244;0.01;0.0;0.0
1813_1.txt;0;0;0;0;123;0.0;0.0;0.0
11728_2.txt;4;0;0;4;142;0.03;0.0;0.0
11646_4.txt;2;0;0;2;182;0.01;0.0;0.0
11032_2.txt;8;2;2;12;419;0.02;0.0;0.0
9055_2.txt;11;0;0;11;373;0.03;0.0;0.0
5219_3.txt;15;0;1;16;440;0.03;0.0;0.0
686_3.txt;23;1;3;27;426;0.05;0.0;0.01
10212_1.txt;2;3;0;5;500;0.0;0.01;0.0
7123_2.txt;10;0;1;11;181;0.06;0.0;0.01
10617_1.txt;2;1;0;3;141;0.01;0.01;0.0
11310_1.txt;1;0;0;1;470;0.0;0.0;0.0
10310_2.txt;17;0;2;19;207;0.08;0.0;0.01
498_3.txt;0;0;0;0;78;0.0;0.0;0.0
8831_4.txt;0;0;0;0;315;0.0;0.0;0.0
4465_2.txt;4;0;0;4;105;0.04;0.0;0.0
7390_2.txt;6;0;0;6;209;0.03;0.0;0.0
2853_4.txt;21;1;0;22;111;0.19;0.01;0.0
7432_4.txt;25;1;2;28;539;0.05;0.0;0.0
8731_1.txt;0;0;0;0;148;0.0;0.0;0.0
2344_3.txt;13;3;0;16;259;0.05;0.01;0.0
3491_1.txt;2;0;0;2;161;0.01;0.0;0.0
856_1.txt;0;0;0;0;234;0.0;0.0;0.0
7932_4.txt;1;0;0;1;174;0.01;0.0;0.0
10252_3.txt;17;0;2;19;200;0.09;0.0;0.01
5509_3.txt;0;0;2;2;127;0.0;0.0;0.02
9834_3.txt;30;3;2;35;425;0.07;0.01;0.0
8397_3.txt;43;7;1;51;1171;0.04;0.01;0.0
12243_2.txt;25;0;0;25;146;0.17;0.0;0.0
7180_4.txt;17;1;2;20;410;0.04;0.0;0.0
260_4.txt;0;0;0;0;90;0.0;0.0;0.0
4393_2.txt;0;0;0;0;339;0.0;0.0;0.0
10782_1.txt;0;0;0;0;115;0.0;0.0;0.0
4234_4.txt;0;0;0;0;166;0.0;0.0;0.0
3660_1.txt;6;2;0;8;939;0.01;0.0;0.0
1320_1.txt;5;0;0;5;198;0.03;0.0;0.0
12396_3.txt;14;0;1;15;301;0.05;0.0;0.0
2341_4.txt;7;3;1;11;830;0.01;0.0;0.0
3155_1.txt;2;0;0;2;27;0.07;0.0;0.0
3620_1.txt;0;0;1;1;368;0.0;0.0;0.0
5988_3.txt;7;0;4;11;555;0.01;0.0;0.01
10098_1.txt;1;0;0;1;147;0.01;0.0;0.0
10835_4.txt;2;0;0;2;151;0.01;0.0;0.0
731_3.txt;20;0;0;20;149;0.13;0.0;0.0
12449_3.txt;7;0;0;7;170;0.04;0.0;0.0
3121_4.txt;11;0;0;11;186;0.06;0.0;0.0
10150_3.txt;18;0;2;20;168;0.11;0.0;0.01
2419_3.txt;2;0;0;2;148;0.01;0.0;0.0
6755_4.txt;13;0;0;13;245;0.05;0.0;0.0
2730_3.txt;24;0;0;24;825;0.03;0.0;0.0
4839_2.txt;0;0;0;0;181;0.0;0.0;0.0
11941_4.txt;6;0;1;7;151;0.04;0.0;0.01
2254_1.txt;1;0;0;1;156;0.01;0.0;0.0
2050_2.txt;0;1;1;2;291;0.0;0.0;0.0
1930_4.txt;56;9;6;71;1761;0.03;0.01;0.0
4864_4.txt;0;0;1;1;46;0.0;0.0;0.02
652_2.txt;4;0;0;4;170;0.02;0.0;0.0
1077_3.txt;4;0;0;4;120;0.03;0.0;0.0
11917_4.txt;9;2;0;11;657;0.01;0.0;0.0
113_4.txt;34;3;2;39;429;0.08;0.01;0.0
5684_1.txt;0;0;0;0;162;0.0;0.0;0.0
567_3.txt;7;0;0;7;159;0.04;0.0;0.0
4220_2.txt;4;1;0;5;118;0.03;0.01;0.0
3658_1.txt;5;0;0;5;203;0.02;0.0;0.0
7141_3.txt;0;0;0;0;137;0.0;0.0;0.0
1119_1.txt;20;0;0;20;448;0.04;0.0;0.0
11302_4.txt;42;5;5;52;545;0.08;0.01;0.01
7548_1.txt;14;7;0;21;571;0.02;0.01;0.0
11730_4.txt;30;0;0;30;158;0.19;0.0;0.0
4080_3.txt;1;0;0;1;117;0.01;0.0;0.0
4005_3.txt;25;2;7;34;837;0.03;0.0;0.01
6044_4.txt;14;0;0;14;153;0.09;0.0;0.0
2841_3.txt;2;0;0;2;222;0.01;0.0;0.0
3271_1.txt;3;0;0;3;65;0.05;0.0;0.0
155_3.txt;4;0;0;4;150;0.03;0.0;0.0
10886_4.txt;6;0;0;6;343;0.02;0.0;0.0
11761_1.txt;4;2;0;6;143;0.03;0.01;0.0
10334_3.txt;4;0;0;4;121;0.03;0.0;0.0
11603_1.txt;0;0;0;0;271;0.0;0.0;0.0
10388_4.txt;4;4;0;8;351;0.01;0.01;0.0
11246_2.txt;5;3;3;11;473;0.01;0.01;0.01
12476_3.txt;6;1;0;7;497;0.01;0.0;0.0
3569_1.txt;5;2;0;7;272;0.02;0.01;0.0
7797_3.txt;0;0;0;0;318;0.0;0.0;0.0
11440_1.txt;2;0;0;2;169;0.01;0.0;0.0
4700_1.txt;3;0;1;4;296;0.01;0.0;0.0
3449_2.txt;0;0;0;0;167;0.0;0.0;0.0
9443_4.txt;13;3;0;16;1036;0.01;0.0;0.0
2722_2.txt;4;2;0;6;158;0.03;0.01;0.0
10981_2.txt;4;0;0;4;254;0.02;0.0;0.0
6917_2.txt;7;1;0;8;193;0.04;0.01;0.0
12163_2.txt;6;0;0;6;162;0.04;0.0;0.0
9041_1.txt;1;10;2;13;138;0.01;0.07;0.01
5360_3.txt;13;0;5;18;193;0.07;0.0;0.03
7504_4.txt;15;0;0;15;196;0.08;0.0;0.0
6445_1.txt;0;17;7;24;339;0.0;0.05;0.02
11263_1.txt;2;0;0;2;126;0.02;0.0;0.0
7805_1.txt;2;1;0;3;278;0.01;0.0;0.0
9441_4.txt;0;0;0;0;229;0.0;0.0;0.0
4395_1.txt;2;0;0;2;316;0.01;0.0;0.0
194_1.txt;0;1;0;1;70;0.0;0.01;0.0
4547_1.txt;0;0;0;0;259;0.0;0.0;0.0
4468_1.txt;1;0;4;5;311;0.0;0.0;0.01
6465_4.txt;9;0;0;9;66;0.14;0.0;0.0
5148_2.txt;12;0;0;12;165;0.07;0.0;0.0
7223_3.txt;4;1;0;5;285;0.01;0.0;0.0
10154_1.txt;1;0;0;1;138;0.01;0.0;0.0
2366_4.txt;0;0;0;0;84;0.0;0.0;0.0
9684_1.txt;0;0;0;0;64;0.0;0.0;0.0
4534_2.txt;1;0;0;1;157;0.01;0.0;0.0
1208_4.txt;0;0;0;0;108;0.0;0.0;0.0
434_4.txt;35;2;2;39;1174;0.03;0.0;0.0
4244_1.txt;5;1;0;6;608;0.01;0.0;0.0
243_3.txt;8;1;0;9;168;0.05;0.01;0.0
6121_2.txt;16;0;2;18;538;0.03;0.0;0.0
8219_1.txt;0;0;0;0;160;0.0;0.0;0.0
7427_3.txt;25;0;2;27;848;0.03;0.0;0.0
1825_2.txt;4;0;0;4;162;0.02;0.0;0.0
6971_1.txt;15;2;2;19;243;0.06;0.01;0.01
1951_1.txt;24;0;2;26;775;0.03;0.0;0.0
10289_1.txt;5;1;0;6;174;0.03;0.01;0.0
7576_2.txt;0;0;0;0;43;0.0;0.0;0.0
2219_1.txt;8;0;0;8;159;0.05;0.0;0.0
6955_1.txt;1;0;1;2;187;0.01;0.0;0.01
10071_1.txt;6;0;0;6;375;0.02;0.0;0.0
2891_2.txt;11;0;0;11;297;0.04;0.0;0.0
3415_2.txt;2;0;0;2;104;0.02;0.0;0.0
2765_4.txt;0;1;1;2;188;0.0;0.01;0.01
520_1.txt;0;0;0;0;150;0.0;0.0;0.0
7543_1.txt;0;0;0;0;410;0.0;0.0;0.0
846_2.txt;2;0;0;2;89;0.02;0.0;0.0
3521_1.txt;2;2;0;4;283;0.01;0.01;0.0
18_3.txt;0;0;5;5;177;0.0;0.0;0.03
10967_4.txt;0;1;0;1;336;0.0;0.0;0.0
12283_2.txt;21;3;0;24;261;0.08;0.01;0.0
3558_3.txt;5;0;0;5;148;0.03;0.0;0.0
7842_1.txt;2;0;0;2;189;0.01;0.0;0.0
12125_1.txt;2;2;0;4;205;0.01;0.01;0.0
318_1.txt;3;0;0;3;150;0.02;0.0;0.0
5068_4.txt;14;1;0;15;349;0.04;0.0;0.0
3259_1.txt;0;0;0;0;67;0.0;0.0;0.0
8492_1.txt;3;0;0;3;124;0.02;0.0;0.0
1235_1.txt;2;0;0;2;135;0.01;0.0;0.0
1753_1.txt;3;2;0;5;304;0.01;0.01;0.0
2136_1.txt;4;2;0;6;102;0.04;0.02;0.0
7388_1.txt;2;0;0;2;152;0.01;0.0;0.0
1049_3.txt;10;3;0;13;149;0.07;0.02;0.0
9283_3.txt;5;0;1;6;147;0.03;0.0;0.01
4851_3.txt;0;1;0;1;248;0.0;0.0;0.0
9483_1.txt;0;0;0;0;60;0.0;0.0;0.0
10337_3.txt;6;1;0;7;178;0.03;0.01;0.0
9844_1.txt;2;0;0;2;208;0.01;0.0;0.0
1862_1.txt;0;0;0;0;156;0.0;0.0;0.0
10785_1.txt;11;1;0;12;171;0.06;0.01;0.0
9878_4.txt;8;3;0;11;268;0.03;0.01;0.0
1571_1.txt;0;0;0;0;103;0.0;0.0;0.0
10976_1.txt;0;0;0;0;189;0.0;0.0;0.0
11118_4.txt;7;0;0;7;193;0.04;0.0;0.0
9489_3.txt;17;6;0;23;530;0.03;0.01;0.0
8349_1.txt;0;0;0;0;131;0.0;0.0;0.0
3612_1.txt;0;0;4;4;174;0.0;0.0;0.02
5358_1.txt;8;0;0;8;230;0.03;0.0;0.0
10455_1.txt;5;0;0;5;216;0.02;0.0;0.0
1263_3.txt;0;0;0;0;138;0.0;0.0;0.0
4247_4.txt;30;0;0;30;468;0.06;0.0;0.0
7337_1.txt;1;0;0;1;128;0.01;0.0;0.0
1689_1.txt;2;0;0;2;162;0.01;0.0;0.0
2198_1.txt;0;0;0;0;325;0.0;0.0;0.0
9812_2.txt;0;0;0;0;131;0.0;0.0;0.0
1427_2.txt;1;3;2;6;289;0.0;0.01;0.01
6701_3.txt;3;0;0;3;157;0.02;0.0;0.0
2081_4.txt;3;0;0;3;139;0.02;0.0;0.0
4314_4.txt;37;3;2;42;682;0.05;0.0;0.0
9730_1.txt;6;0;0;6;143;0.04;0.0;0.0
11667_1.txt;0;1;0;1;215;0.0;0.0;0.0
9237_4.txt;7;0;0;7;231;0.03;0.0;0.0
6385_2.txt;0;2;0;2;260;0.0;0.01;0.0
10740_4.txt;4;0;0;4;136;0.03;0.0;0.0
11885_1.txt;9;0;0;9;625;0.01;0.0;0.0
1174_4.txt;2;0;1;3;134;0.01;0.0;0.01
8203_3.txt;0;0;0;0;46;0.0;0.0;0.0
2578_1.txt;1;0;0;1;161;0.01;0.0;0.0
11965_4.txt;4;5;0;9;193;0.02;0.03;0.0
298_4.txt;9;0;0;9;215;0.04;0.0;0.0
6795_4.txt;0;0;0;0;139;0.0;0.0;0.0
8977_1.txt;2;1;0;3;126;0.02;0.01;0.0
5482_1.txt;0;2;0;2;444;0.0;0.0;0.0
853_1.txt;7;0;0;7;161;0.04;0.0;0.0
9356_3.txt;4;0;0;4;160;0.03;0.0;0.0
11664_3.txt;3;0;0;3;186;0.02;0.0;0.0
11247_2.txt;0;1;0;1;289;0.0;0.0;0.0
4224_4.txt;3;0;3;6;260;0.01;0.0;0.01
12226_1.txt;5;0;0;5;254;0.02;0.0;0.0
4654_2.txt;0;0;1;1;236;0.0;0.0;0.0
5207_3.txt;8;0;0;8;134;0.06;0.0;0.0
7799_1.txt;8;0;1;9;433;0.02;0.0;0.0
5415_1.txt;6;0;0;6;123;0.05;0.0;0.0
1827_1.txt;27;0;0;27;371;0.07;0.0;0.0
781_1.txt;1;0;1;2;130;0.01;0.0;0.01
5917_4.txt;21;2;1;24;389;0.05;0.01;0.0
2185_1.txt;0;0;3;3;357;0.0;0.0;0.01
2047_1.txt;0;0;1;1;160;0.0;0.0;0.01
669_2.txt;0;0;0;0;346;0.0;0.0;0.0
11891_1.txt;1;0;0;1;61;0.02;0.0;0.0
3997_2.txt;4;1;0;5;435;0.01;0.0;0.0
1033_4.txt;15;1;3;19;208;0.07;0.0;0.01
8257_2.txt;2;0;0;2;246;0.01;0.0;0.0
41_1.txt;2;4;0;6;310;0.01;0.01;0.0
8022_1.txt;0;2;1;3;370;0.0;0.01;0.0
8229_1.txt;2;0;3;5;509;0.0;0.0;0.01
8619_1.txt;0;0;0;0;58;0.0;0.0;0.0
7945_1.txt;3;0;0;3;323;0.01;0.0;0.0
3473_1.txt;5;0;0;5;137;0.04;0.0;0.0
6186_1.txt;11;1;0;12;147;0.07;0.01;0.0
4632_4.txt;4;0;0;4;151;0.03;0.0;0.0
40_3.txt;13;5;1;19;630;0.02;0.01;0.0
9734_4.txt;5;0;0;5;140;0.04;0.0;0.0
9457_1.txt;12;0;0;12;228;0.05;0.0;0.0
12298_4.txt;6;1;0;7;319;0.02;0.0;0.0
8_4.txt;0;0;0;0;166;0.0;0.0;0.0
9574_1.txt;0;0;0;0;84;0.0;0.0;0.0
11154_2.txt;0;0;0;0;232;0.0;0.0;0.0
9170_1.txt;8;0;1;9;427;0.02;0.0;0.0
1257_3.txt;26;3;6;35;1036;0.03;0.0;0.01
8472_1.txt;5;0;0;5;145;0.03;0.0;0.0
9505_4.txt;2;0;0;2;224;0.01;0.0;0.0
3987_1.txt;2;0;0;2;140;0.01;0.0;0.0
10985_1.txt;8;0;0;8;173;0.05;0.0;0.0
10996_1.txt;5;0;0;5;149;0.03;0.0;0.0
10008_2.txt;8;1;0;9;334;0.02;0.0;0.0
3908_4.txt;8;0;0;8;277;0.03;0.0;0.0
11144_2.txt;3;1;2;6;341;0.01;0.0;0.01
6070_4.txt;16;0;7;23;171;0.09;0.0;0.04
11813_1.txt;24;1;5;30;652;0.04;0.0;0.01
5623_2.txt;17;5;1;23;155;0.11;0.03;0.01
11237_1.txt;0;1;0;1;175;0.0;0.01;0.0
3367_1.txt;29;2;9;40;688;0.04;0.0;0.01
7226_3.txt;0;1;0;1;124;0.0;0.01;0.0
2535_2.txt;27;3;4;34;539;0.05;0.01;0.01
517_4.txt;15;2;5;22;266;0.06;0.01;0.02
5252_1.txt;2;1;0;3;140;0.01;0.01;0.0
2725_2.txt;36;1;0;37;183;0.2;0.01;0.0
3263_4.txt;0;0;0;0;120;0.0;0.0;0.0
4104_4.txt;15;1;2;18;624;0.02;0.0;0.0
6109_1.txt;3;0;0;3;74;0.04;0.0;0.0
867_1.txt;4;0;0;4;208;0.02;0.0;0.0
3885_1.txt;0;0;0;0;141;0.0;0.0;0.0
3830_1.txt;5;2;0;7;249;0.02;0.01;0.0
2076_1.txt;6;1;0;7;177;0.03;0.01;0.0
5761_4.txt;0;0;0;0;92;0.0;0.0;0.0
1802_2.txt;0;0;0;0;164;0.0;0.0;0.0
6998_4.txt;5;3;0;8;252;0.02;0.01;0.0
7430_4.txt;12;0;0;12;133;0.09;0.0;0.0
8621_1.txt;1;0;1;2;164;0.01;0.0;0.01
6784_1.txt;0;0;0;0;261;0.0;0.0;0.0
6629_1.txt;12;0;3;15;229;0.05;0.0;0.01
3846_2.txt;21;0;0;21;326;0.06;0.0;0.0
3381_1.txt;1;0;0;1;154;0.01;0.0;0.0
4428_1.txt;0;1;0;1;112;0.0;0.01;0.0
9104_2.txt;9;2;2;13;301;0.03;0.01;0.01
12128_4.txt;5;1;0;6;318;0.02;0.0;0.0
5734_1.txt;1;0;0;1;171;0.01;0.0;0.0
7350_3.txt;12;0;2;14;172;0.07;0.0;0.01
966_2.txt;2;0;0;2;454;0.0;0.0;0.0
3710_1.txt;0;3;3;6;127;0.0;0.02;0.02
9369_4.txt;2;0;0;2;131;0.02;0.0;0.0
9435_2.txt;0;1;0;1;314;0.0;0.0;0.0
8081_4.txt;21;6;0;27;394;0.05;0.02;0.0
10343_3.txt;4;2;3;9;152;0.03;0.01;0.02
3137_1.txt;1;0;0;1;208;0.0;0.0;0.0
8339_2.txt;0;0;0;0;147;0.0;0.0;0.0
1081_4.txt;2;0;0;2;151;0.01;0.0;0.0
12230_4.txt;15;2;2;19;526;0.03;0.0;0.0
7263_4.txt;20;5;0;25;320;0.06;0.02;0.0
12020_1.txt;2;0;0;2;164;0.01;0.0;0.0
5170_2.txt;2;0;0;2;194;0.01;0.0;0.0
1975_1.txt;0;1;0;1;167;0.0;0.01;0.0
5163_3.txt;40;1;3;44;829;0.05;0.0;0.0
8114_3.txt;0;0;0;0;232;0.0;0.0;0.0
3072_4.txt;11;0;1;12;395;0.03;0.0;0.0
2736_4.txt;7;0;0;7;140;0.05;0.0;0.0
11122_3.txt;0;0;0;0;164;0.0;0.0;0.0
2248_1.txt;3;0;0;3;119;0.03;0.0;0.0
2680_1.txt;4;8;0;12;148;0.03;0.05;0.0
8100_3.txt;6;0;0;6;324;0.02;0.0;0.0
8652_1.txt;0;4;0;4;145;0.0;0.03;0.0
8558_1.txt;0;0;0;0;289;0.0;0.0;0.0
4878_4.txt;3;1;0;4;153;0.02;0.01;0.0
526_2.txt;13;0;0;13;126;0.1;0.0;0.0
6774_1.txt;9;3;1;13;291;0.03;0.01;0.0
7244_1.txt;0;1;0;1;75;0.0;0.01;0.0
4107_4.txt;34;7;2;43;713;0.05;0.01;0.0
7595_1.txt;0;0;0;0;139;0.0;0.0;0.0
10913_3.txt;5;0;0;5;267;0.02;0.0;0.0
9185_1.txt;0;0;0;0;214;0.0;0.0;0.0
6643_4.txt;2;1;0;3;115;0.02;0.01;0.0
9879_3.txt;21;0;0;21;558;0.04;0.0;0.0
3287_1.txt;1;1;2;4;182;0.01;0.01;0.01
1411_4.txt;8;4;1;13;344;0.02;0.01;0.0
7673_1.txt;8;0;0;8;142;0.06;0.0;0.0
6358_1.txt;5;1;0;6;218;0.02;0.0;0.0
11424_1.txt;6;0;0;6;237;0.03;0.0;0.0
7856_3.txt;0;0;2;2;148;0.0;0.0;0.01
1611_1.txt;7;0;0;7;164;0.04;0.0;0.0
9017_3.txt;2;0;0;2;165;0.01;0.0;0.0
8703_3.txt;4;0;0;4;253;0.02;0.0;0.0
1734_2.txt;5;1;2;8;126;0.04;0.01;0.02
10190_1.txt;5;2;0;7;115;0.04;0.02;0.0
4627_1.txt;0;0;0;0;34;0.0;0.0;0.0
1425_4.txt;8;2;1;11;266;0.03;0.01;0.0
5628_2.txt;0;0;1;1;190;0.0;0.0;0.01
3419_1.txt;10;4;5;19;234;0.04;0.02;0.02
2327_3.txt;12;0;0;12;398;0.03;0.0;0.0
9128_2.txt;17;1;1;19;325;0.05;0.0;0.0
9053_2.txt;21;0;0;21;302;0.07;0.0;0.0
4151_1.txt;2;0;0;2;244;0.01;0.0;0.0
10194_3.txt;4;3;0;7;227;0.02;0.01;0.0
9026_1.txt;8;3;0;11;250;0.03;0.01;0.0
10635_1.txt;0;1;5;6;192;0.0;0.01;0.03
8657_1.txt;4;0;2;6;457;0.01;0.0;0.0
7351_2.txt;19;0;2;21;479;0.04;0.0;0.0
2826_3.txt;17;0;0;17;483;0.04;0.0;0.0
5299_2.txt;2;0;0;2;137;0.01;0.0;0.0
10057_1.txt;30;2;1;33;1075;0.03;0.0;0.0
9845_3.txt;4;0;0;4;157;0.03;0.0;0.0
10561_1.txt;2;0;0;2;226;0.01;0.0;0.0
2382_1.txt;2;1;0;3;215;0.01;0.0;0.0
5010_1.txt;0;0;0;0;81;0.0;0.0;0.0
1865_3.txt;5;0;0;5;177;0.03;0.0;0.0
641_4.txt;11;4;0;15;198;0.06;0.02;0.0
3709_1.txt;4;0;1;5;211;0.02;0.0;0.0
2573_4.txt;7;0;0;7;131;0.05;0.0;0.0
4189_1.txt;5;3;4;12;184;0.03;0.02;0.02
502_1.txt;5;0;0;5;181;0.03;0.0;0.0
9517_2.txt;6;2;0;8;267;0.02;0.01;0.0
6403_3.txt;0;2;0;2;221;0.0;0.01;0.0
11835_1.txt;9;0;3;12;471;0.02;0.0;0.01
8239_1.txt;0;0;1;1;119;0.0;0.0;0.01
6837_3.txt;4;2;0;6;272;0.01;0.01;0.0
6828_2.txt;5;0;0;5;168;0.03;0.0;0.0
4723_1.txt;0;16;5;21;597;0.0;0.03;0.01
3565_2.txt;27;1;0;28;569;0.05;0.0;0.0
2971_3.txt;4;2;0;6;185;0.02;0.01;0.0
7274_1.txt;8;0;0;8;307;0.03;0.0;0.0
5767_3.txt;4;0;0;4;320;0.01;0.0;0.0
3307_3.txt;4;2;2;8;198;0.02;0.01;0.01
10609_3.txt;30;0;2;32;542;0.06;0.0;0.0
8382_1.txt;2;0;0;2;139;0.01;0.0;0.0
12403_4.txt;22;0;0;22;293;0.08;0.0;0.0
5336_4.txt;6;0;0;6;68;0.09;0.0;0.0
6392_3.txt;6;0;0;6;131;0.05;0.0;0.0
5790_1.txt;2;1;2;5;202;0.01;0.0;0.01
3233_1.txt;0;0;0;0;143;0.0;0.0;0.0
2294_2.txt;5;0;0;5;77;0.06;0.0;0.0
1501_2.txt;2;0;0;2;31;0.06;0.0;0.0
9427_1.txt;2;0;0;2;245;0.01;0.0;0.0
10578_1.txt;11;0;1;12;409;0.03;0.0;0.0
5291_4.txt;18;0;0;18;455;0.04;0.0;0.0
8184_4.txt;5;0;1;6;227;0.02;0.0;0.0
9538_2.txt;0;0;0;0;142;0.0;0.0;0.0
3120_4.txt;2;0;0;2;209;0.01;0.0;0.0
428_1.txt;2;0;0;2;70;0.03;0.0;0.0
8811_1.txt;0;0;0;0;277;0.0;0.0;0.0
7520_1.txt;3;0;0;3;195;0.02;0.0;0.0
2775_1.txt;6;2;0;8;272;0.02;0.01;0.0
5410_1.txt;0;0;0;0;53;0.0;0.0;0.0
7991_4.txt;0;0;0;0;336;0.0;0.0;0.0
8709_2.txt;0;0;0;0;285;0.0;0.0;0.0
5453_2.txt;0;0;2;2;131;0.0;0.0;0.02
11806_4.txt;31;0;0;31;356;0.09;0.0;0.0
11558_1.txt;0;0;0;0;180;0.0;0.0;0.0
10394_3.txt;2;0;0;2;124;0.02;0.0;0.0
6777_4.txt;10;0;0;10;172;0.06;0.0;0.0
8278_1.txt;25;2;0;27;494;0.05;0.0;0.0
1586_1.txt;5;0;0;5;182;0.03;0.0;0.0
1672_1.txt;0;0;0;0;194;0.0;0.0;0.0
2685_2.txt;0;0;0;0;154;0.0;0.0;0.0
5030_3.txt;7;1;0;8;332;0.02;0.0;0.0
253_3.txt;10;5;0;15;345;0.03;0.01;0.0
1577_2.txt;3;0;0;3;438;0.01;0.0;0.0
872_2.txt;0;1;0;1;210;0.0;0.0;0.0
9575_1.txt;7;1;0;8;210;0.03;0.0;0.0
9063_2.txt;13;1;0;14;250;0.05;0.0;0.0
11004_1.txt;0;0;0;0;174;0.0;0.0;0.0
9629_1.txt;13;0;0;13;242;0.05;0.0;0.0
6249_2.txt;6;0;6;12;397;0.02;0.0;0.02
2576_3.txt;17;3;3;23;625;0.03;0.0;0.0
8311_1.txt;0;1;0;1;115;0.0;0.01;0.0
5664_2.txt;4;0;0;4;223;0.02;0.0;0.0
4237_3.txt;14;0;0;14;182;0.08;0.0;0.0
8394_1.txt;0;0;0;0;165;0.0;0.0;0.0
6806_1.txt;4;0;0;4;248;0.02;0.0;0.0
6354_1.txt;16;1;0;17;199;0.08;0.01;0.0
12363_1.txt;6;0;0;6;130;0.05;0.0;0.0
4261_4.txt;0;2;0;2;233;0.0;0.01;0.0
6799_3.txt;8;0;0;8;177;0.05;0.0;0.0
8775_3.txt;3;3;0;6;199;0.02;0.02;0.0
10983_4.txt;4;0;1;5;321;0.01;0.0;0.0
1020_2.txt;13;0;1;14;536;0.02;0.0;0.0
10511_1.txt;6;0;0;6;360;0.02;0.0;0.0
3818_1.txt;2;0;2;4;482;0.0;0.0;0.0
717_1.txt;2;0;2;4;215;0.01;0.0;0.01
4356_4.txt;2;0;0;2;262;0.01;0.0;0.0
2571_4.txt;10;0;2;12;263;0.04;0.0;0.01
612_2.txt;0;0;0;0;160;0.0;0.0;0.0
1656_4.txt;8;2;0;10;439;0.02;0.0;0.0
128_4.txt;0;1;0;1;170;0.0;0.01;0.0
5759_3.txt;0;0;0;0;131;0.0;0.0;0.0
10722_4.txt;45;6;24;75;587;0.08;0.01;0.04
9640_2.txt;3;0;1;4;279;0.01;0.0;0.0
7440_1.txt;3;0;0;3;173;0.02;0.0;0.0
1011_2.txt;22;0;2;24;239;0.09;0.0;0.01
4595_2.txt;2;0;2;4;54;0.04;0.0;0.04
4186_1.txt;7;2;0;9;198;0.04;0.01;0.0
2244_1.txt;9;1;0;10;424;0.02;0.0;0.0
4583_1.txt;0;0;0;0;158;0.0;0.0;0.0
5192_3.txt;14;1;2;17;354;0.04;0.0;0.01
9081_1.txt;18;0;0;18;622;0.03;0.0;0.0
3387_1.txt;3;2;0;5;506;0.01;0.0;0.0
8124_3.txt;4;0;0;4;143;0.03;0.0;0.0
1035_1.txt;0;0;0;0;137;0.0;0.0;0.0
3202_1.txt;11;5;0;16;323;0.03;0.02;0.0
8015_4.txt;13;2;1;16;618;0.02;0.0;0.0
6168_2.txt;2;0;0;2;151;0.01;0.0;0.0
5829_3.txt;4;0;1;5;241;0.02;0.0;0.0
5532_2.txt;0;1;0;1;183;0.0;0.01;0.0
709_2.txt;14;0;0;14;298;0.05;0.0;0.0
441_2.txt;4;2;1;7;325;0.01;0.01;0.0
3102_1.txt;0;0;0;0;285;0.0;0.0;0.0
7325_1.txt;0;1;3;4;127;0.0;0.01;0.02
3587_3.txt;20;0;0;20;156;0.13;0.0;0.0
5091_1.txt;4;3;3;10;196;0.02;0.02;0.02
7451_3.txt;10;0;0;10;328;0.03;0.0;0.0
10557_3.txt;0;0;1;1;125;0.0;0.0;0.01
8386_1.txt;11;2;0;13;324;0.03;0.01;0.0
9771_3.txt;11;10;2;23;779;0.01;0.01;0.0
6320_1.txt;0;0;0;0;51;0.0;0.0;0.0
12005_1.txt;5;0;3;8;324;0.02;0.0;0.01
2532_4.txt;9;0;4;13;332;0.03;0.0;0.01
3228_1.txt;0;2;0;2;233;0.0;0.01;0.0
10446_2.txt;2;0;0;2;127;0.02;0.0;0.0
7644_2.txt;5;0;0;5;217;0.02;0.0;0.0
10560_3.txt;9;0;0;9;277;0.03;0.0;0.0
3654_1.txt;27;5;1;33;282;0.1;0.02;0.0
5613_3.txt;0;0;0;0;173;0.0;0.0;0.0
8413_4.txt;31;3;0;34;898;0.03;0.0;0.0
6494_1.txt;4;0;0;4;163;0.02;0.0;0.0
2914_3.txt;3;0;0;3;417;0.01;0.0;0.0
3674_1.txt;1;1;2;4;219;0.0;0.0;0.01
415_3.txt;5;0;0;5;187;0.03;0.0;0.0
11330_4.txt;8;6;0;14;129;0.06;0.05;0.0
12236_2.txt;0;0;0;0;199;0.0;0.0;0.0
7266_1.txt;0;0;2;2;208;0.0;0.0;0.01
1607_1.txt;4;2;5;11;450;0.01;0.0;0.01
6783_2.txt;0;0;0;0;235;0.0;0.0;0.0
3704_3.txt;10;0;1;11;183;0.05;0.0;0.01
6513_4.txt;4;0;0;4;127;0.03;0.0;0.0
4796_1.txt;11;0;9;20;221;0.05;0.0;0.04
11551_1.txt;8;0;0;8;132;0.06;0.0;0.0
10481_2.txt;9;1;0;10;112;0.08;0.01;0.0
7680_4.txt;5;2;0;7;200;0.03;0.01;0.0
8750_3.txt;15;0;1;16;256;0.06;0.0;0.0
2667_1.txt;0;1;0;1;77;0.0;0.01;0.0
11787_2.txt;0;0;0;0;47;0.0;0.0;0.0
8343_1.txt;2;0;0;2;183;0.01;0.0;0.0
1133_4.txt;8;0;0;8;298;0.03;0.0;0.0
6538_4.txt;0;0;0;0;432;0.0;0.0;0.0
5701_1.txt;5;4;0;9;135;0.04;0.03;0.0
11136_1.txt;1;0;0;1;142;0.01;0.0;0.0
4564_4.txt;11;2;8;21;770;0.01;0.0;0.01
4981_1.txt;9;1;2;12;431;0.02;0.0;0.0
10665_2.txt;2;0;1;3;166;0.01;0.0;0.01
8346_1.txt;0;0;0;0;144;0.0;0.0;0.0
6591_3.txt;24;3;0;27;680;0.04;0.0;0.0
4892_1.txt;0;1;0;1;157;0.0;0.01;0.0
5231_4.txt;0;0;0;0;65;0.0;0.0;0.0
7183_1.txt;1;0;0;1;114;0.01;0.0;0.0
1738_1.txt;13;1;0;14;271;0.05;0.0;0.0
12126_2.txt;2;0;0;2;171;0.01;0.0;0.0
1141_3.txt;7;0;0;7;149;0.05;0.0;0.0
11657_4.txt;0;0;0;0;144;0.0;0.0;0.0
3167_2.txt;22;2;1;25;401;0.05;0.0;0.0
4036_1.txt;4;0;0;4;245;0.02;0.0;0.0
509_3.txt;0;1;0;1;170;0.0;0.01;0.0
8539_4.txt;13;1;1;15;348;0.04;0.0;0.0
8690_3.txt;8;0;0;8;151;0.05;0.0;0.0
10437_4.txt;17;2;0;19;190;0.09;0.01;0.0
6343_2.txt;2;0;0;2;127;0.02;0.0;0.0
3248_4.txt;17;1;0;18;424;0.04;0.0;0.0
10783_2.txt;0;0;0;0;67;0.0;0.0;0.0
741_1.txt;9;10;4;23;511;0.02;0.02;0.01
8945_1.txt;1;0;0;1;189;0.01;0.0;0.0
2139_4.txt;0;5;0;5;250;0.0;0.02;0.0
2603_1.txt;10;0;0;10;179;0.06;0.0;0.0
544_4.txt;9;0;2;11;418;0.02;0.0;0.0
7431_4.txt;0;0;1;1;191;0.0;0.0;0.01
11005_1.txt;0;0;0;0;237;0.0;0.0;0.0
9782_4.txt;0;0;0;0;92;0.0;0.0;0.0
10471_2.txt;13;0;0;13;494;0.03;0.0;0.0
1864_1.txt;0;0;0;0;89;0.0;0.0;0.0
9732_3.txt;10;0;0;10;150;0.07;0.0;0.0
10995_1.txt;0;0;2;2;215;0.0;0.0;0.01
10379_2.txt;11;2;0;13;304;0.04;0.01;0.0
10852_1.txt;3;0;0;3;238;0.01;0.0;0.0
780_2.txt;6;0;0;6;237;0.03;0.0;0.0
10144_2.txt;7;1;3;11;217;0.03;0.0;0.01
11063_3.txt;5;0;0;5;143;0.03;0.0;0.0
3169_2.txt;5;2;0;7;194;0.03;0.01;0.0
12070_2.txt;9;0;3;12;403;0.02;0.0;0.01
1756_1.txt;12;2;0;14;310;0.04;0.01;0.0
11600_3.txt;3;0;0;3;82;0.04;0.0;0.0
5141_4.txt;24;0;4;28;324;0.07;0.0;0.01
7530_3.txt;0;0;0;0;204;0.0;0.0;0.0
1564_3.txt;4;0;0;4;288;0.01;0.0;0.0
6713_2.txt;5;0;0;5;136;0.04;0.0;0.0
6466_1.txt;6;1;0;7;214;0.03;0.0;0.0
2865_1.txt;7;0;0;7;292;0.02;0.0;0.0
2474_1.txt;0;0;0;0;139;0.0;0.0;0.0
8855_2.txt;2;3;0;5;267;0.01;0.01;0.0
10641_2.txt;0;0;0;0;53;0.0;0.0;0.0
5558_4.txt;1;1;4;6;167;0.01;0.01;0.02
3734_3.txt;1;0;0;1;88;0.01;0.0;0.0
1279_3.txt;12;0;0;12;218;0.06;0.0;0.0
336_1.txt;15;1;0;16;285;0.05;0.0;0.0
9929_2.txt;0;0;0;0;157;0.0;0.0;0.0
8969_1.txt;0;0;0;0;134;0.0;0.0;0.0
7305_2.txt;4;0;0;4;540;0.01;0.0;0.0
5205_2.txt;1;0;0;1;131;0.01;0.0;0.0
3138_1.txt;1;2;0;3;244;0.0;0.01;0.0
5705_3.txt;34;4;6;44;717;0.05;0.01;0.01
2569_3.txt;7;0;1;8;140;0.05;0.0;0.01
7654_1.txt;16;0;0;16;638;0.03;0.0;0.0
10145_1.txt;6;0;0;6;125;0.05;0.0;0.0
8939_1.txt;2;0;0;2;262;0.01;0.0;0.0
3943_4.txt;13;1;0;14;452;0.03;0.0;0.0
6615_1.txt;4;0;0;4;244;0.02;0.0;0.0
4297_1.txt;0;0;1;1;179;0.0;0.0;0.01
9702_2.txt;0;0;0;0;126;0.0;0.0;0.0
2665_1.txt;0;0;0;0;111;0.0;0.0;0.0
3917_4.txt;2;2;0;4;167;0.01;0.01;0.0
5485_1.txt;2;1;0;3;305;0.01;0.0;0.0
5246_3.txt;1;1;2;4;373;0.0;0.0;0.01
5874_1.txt;2;0;0;2;118;0.02;0.0;0.0
4806_1.txt;25;2;0;27;424;0.06;0.0;0.0
7869_2.txt;2;0;0;2;132;0.02;0.0;0.0
1946_2.txt;4;0;0;4;205;0.02;0.0;0.0
6879_2.txt;9;7;3;19;403;0.02;0.02;0.01
1172_3.txt;3;2;0;5;300;0.01;0.01;0.0
8685_3.txt;10;0;1;11;182;0.05;0.0;0.01
9191_1.txt;0;0;0;0;204;0.0;0.0;0.0
6570_3.txt;24;1;1;26;357;0.07;0.0;0.0
7416_3.txt;4;1;0;5;619;0.01;0.0;0.0
5652_4.txt;0;0;0;0;147;0.0;0.0;0.0
7540_4.txt;8;0;1;9;586;0.01;0.0;0.0
11450_1.txt;29;0;0;29;435;0.07;0.0;0.0
10682_1.txt;2;0;3;5;246;0.01;0.0;0.01
1621_4.txt;7;1;1;9;279;0.03;0.0;0.0
1418_4.txt;0;0;0;0;111;0.0;0.0;0.0
9135_2.txt;7;1;7;15;316;0.02;0.0;0.02
4771_2.txt;0;0;0;0;195;0.0;0.0;0.0
11509_1.txt;5;0;0;5;260;0.02;0.0;0.0
12114_4.txt;0;0;2;2;188;0.0;0.0;0.01
5131_4.txt;12;1;0;13;166;0.07;0.01;0.0
11103_2.txt;9;1;0;10;385;0.02;0.0;0.0
364_1.txt;14;1;1;16;338;0.04;0.0;0.0
5991_1.txt;0;0;0;0;185;0.0;0.0;0.0
3772_2.txt;9;0;2;11;103;0.09;0.0;0.02
8664_1.txt;0;0;0;0;184;0.0;0.0;0.0
5694_4.txt;12;0;0;12;269;0.04;0.0;0.0
11208_4.txt;16;0;0;16;273;0.06;0.0;0.0
6626_1.txt;2;0;0;2;131;0.02;0.0;0.0
5322_4.txt;11;0;0;11;152;0.07;0.0;0.0
8172_1.txt;2;0;0;2;121;0.02;0.0;0.0
4136_1.txt;0;0;0;0;162;0.0;0.0;0.0
4599_2.txt;15;0;1;16;295;0.05;0.0;0.0
3733_1.txt;0;0;0;0;97;0.0;0.0;0.0
2972_1.txt;5;0;2;7;198;0.03;0.0;0.01
4248_1.txt;0;0;0;0;175;0.0;0.0;0.0
12269_2.txt;0;1;0;1;153;0.0;0.01;0.0
6737_2.txt;8;2;1;11;228;0.04;0.01;0.0
2581_1.txt;8;0;4;12;855;0.01;0.0;0.0
8739_1.txt;0;0;0;0;66;0.0;0.0;0.0
7011_3.txt;4;0;0;4;123;0.03;0.0;0.0
1153_2.txt;6;0;0;6;131;0.05;0.0;0.0
6671_1.txt;1;0;0;1;185;0.01;0.0;0.0
5260_1.txt;0;0;4;4;166;0.0;0.0;0.02
10153_4.txt;0;0;0;0;234;0.0;0.0;0.0
4291_4.txt;0;0;0;0;42;0.0;0.0;0.0
9069_1.txt;11;1;2;14;826;0.01;0.0;0.0
3839_1.txt;4;0;0;4;248;0.02;0.0;0.0
9894_2.txt;12;1;0;13;320;0.04;0.0;0.0
8308_1.txt;2;0;2;4;184;0.01;0.0;0.01
11576_1.txt;2;0;1;3;164;0.01;0.0;0.01
6124_1.txt;67;11;0;78;780;0.09;0.01;0.0
9727_3.txt;0;0;0;0;191;0.0;0.0;0.0
2158_3.txt;6;1;2;9;158;0.04;0.01;0.01
1777_3.txt;8;0;0;8;179;0.04;0.0;0.0
2764_1.txt;0;0;0;0;292;0.0;0.0;0.0
4345_1.txt;5;0;0;5;164;0.03;0.0;0.0
10477_1.txt;0;0;0;0;47;0.0;0.0;0.0
9641_1.txt;8;1;2;11;277;0.03;0.0;0.01
2739_2.txt;0;0;0;0;68;0.0;0.0;0.0
5650_2.txt;6;0;0;6;137;0.04;0.0;0.0
4050_4.txt;2;0;0;2;131;0.02;0.0;0.0
9864_1.txt;2;0;0;2;397;0.01;0.0;0.0
5830_2.txt;20;0;0;20;927;0.02;0.0;0.0
9399_4.txt;6;2;4;12;133;0.05;0.02;0.03
6610_1.txt;16;0;0;16;241;0.07;0.0;0.0
4601_4.txt;23;0;0;23;912;0.03;0.0;0.0
5001_1.txt;3;0;0;3;234;0.01;0.0;0.0
7046_2.txt;3;0;1;4;184;0.02;0.0;0.01
7590_3.txt;10;1;2;13;163;0.06;0.01;0.01
413_3.txt;3;0;2;5;352;0.01;0.0;0.01
4446_3.txt;0;0;0;0;504;0.0;0.0;0.0
7002_1.txt;4;0;0;4;161;0.02;0.0;0.0
2612_2.txt;5;0;0;5;172;0.03;0.0;0.0
2359_1.txt;5;0;0;5;217;0.02;0.0;0.0
9626_2.txt;10;1;0;11;314;0.03;0.0;0.0
10269_1.txt;0;0;0;0;137;0.0;0.0;0.0
8143_1.txt;3;0;0;3;179;0.02;0.0;0.0
4568_2.txt;3;1;4;8;190;0.02;0.01;0.02
4131_1.txt;2;0;0;2;146;0.01;0.0;0.0
2745_4.txt;33;0;1;34;185;0.18;0.0;0.01
571_1.txt;3;2;0;5;120;0.03;0.02;0.0
11201_1.txt;2;0;0;2;58;0.03;0.0;0.0
6309_3.txt;3;0;2;5;194;0.02;0.0;0.01
8155_1.txt;7;1;0;8;166;0.04;0.01;0.0
8198_4.txt;13;6;0;19;397;0.03;0.02;0.0
4793_4.txt;18;0;0;18;542;0.03;0.0;0.0
9964_4.txt;8;5;5;18;207;0.04;0.02;0.02
4861_1.txt;12;0;0;12;243;0.05;0.0;0.0
8562_4.txt;25;1;1;27;291;0.09;0.0;0.0
1601_1.txt;7;0;0;7;122;0.06;0.0;0.0
10896_1.txt;0;0;0;0;617;0.0;0.0;0.0
1315_4.txt;6;0;0;6;235;0.03;0.0;0.0
8473_3.txt;2;0;0;2;60;0.03;0.0;0.0
6120_1.txt;6;1;0;7;478;0.01;0.0;0.0
564_1.txt;10;0;0;10;155;0.06;0.0;0.0
1323_1.txt;8;3;0;11;490;0.02;0.01;0.0
11100_4.txt;7;0;2;9;363;0.02;0.0;0.01
1385_3.txt;0;0;0;0;102;0.0;0.0;0.0
5958_4.txt;49;1;4;54;693;0.07;0.0;0.01
132_3.txt;3;3;0;6;150;0.02;0.02;0.0
10276_1.txt;2;1;0;3;209;0.01;0.0;0.0
6873_1.txt;8;1;0;9;408;0.02;0.0;0.0
4432_2.txt;4;1;0;5;193;0.02;0.01;0.0
4969_3.txt;9;0;0;9;417;0.02;0.0;0.0
4819_1.txt;1;2;0;3;256;0.0;0.01;0.0
12402_2.txt;10;3;0;13;292;0.03;0.01;0.0
7635_1.txt;2;8;0;10;222;0.01;0.04;0.0
10271_1.txt;0;0;0;0;203;0.0;0.0;0.0
8026_2.txt;0;0;0;0;232;0.0;0.0;0.0
6454_2.txt;3;0;0;3;130;0.02;0.0;0.0
2348_3.txt;5;0;1;6;108;0.05;0.0;0.01
1485_2.txt;12;4;0;16;677;0.02;0.01;0.0
12469_1.txt;1;0;0;1;144;0.01;0.0;0.0
7438_1.txt;0;0;0;0;172;0.0;0.0;0.0
783_1.txt;0;0;2;2;119;0.0;0.0;0.02
151_1.txt;0;0;0;0;193;0.0;0.0;0.0
10203_2.txt;2;0;0;2;313;0.01;0.0;0.0
6294_2.txt;10;0;1;11;471;0.02;0.0;0.0
579_1.txt;5;0;0;5;399;0.01;0.0;0.0
11170_2.txt;5;0;0;5;81;0.06;0.0;0.0
6758_4.txt;17;1;0;18;373;0.05;0.0;0.0
12018_3.txt;3;1;0;4;254;0.01;0.0;0.0
2565_3.txt;14;0;0;14;419;0.03;0.0;0.0
11824_1.txt;2;0;0;2;47;0.04;0.0;0.0
6411_1.txt;3;0;9;12;176;0.02;0.0;0.05
4754_4.txt;5;0;0;5;218;0.02;0.0;0.0
3979_1.txt;4;0;0;4;288;0.01;0.0;0.0
4803_3.txt;1;0;0;1;173;0.01;0.0;0.0
12349_4.txt;15;0;4;19;308;0.05;0.0;0.01
5918_1.txt;16;5;0;21;261;0.06;0.02;0.0
10201_3.txt;0;0;0;0;119;0.0;0.0;0.0
2614_1.txt;16;0;2;18;501;0.03;0.0;0.0
8476_1.txt;3;0;0;3;241;0.01;0.0;0.0
6809_1.txt;0;0;0;0;194;0.0;0.0;0.0
5980_3.txt;3;2;6;11;426;0.01;0.0;0.01
9787_3.txt;8;0;0;8;231;0.03;0.0;0.0
4232_1.txt;2;0;0;2;189;0.01;0.0;0.0
10538_3.txt;7;1;0;8;212;0.03;0.0;0.0
3177_4.txt;18;2;0;20;415;0.04;0.0;0.0
5237_1.txt;8;1;0;9;138;0.06;0.01;0.0
2138_4.txt;20;0;5;25;408;0.05;0.0;0.01
8995_3.txt;0;0;2;2;162;0.0;0.0;0.01
2682_3.txt;3;0;1;4;181;0.02;0.0;0.01
6328_4.txt;9;5;2;16;281;0.03;0.02;0.01
2484_1.txt;4;0;0;4;94;0.04;0.0;0.0
10037_1.txt;5;0;0;5;129;0.04;0.0;0.0
142_3.txt;2;0;0;2;179;0.01;0.0;0.0
9344_1.txt;0;1;1;2;167;0.0;0.01;0.01
11464_1.txt;2;0;0;2;118;0.02;0.0;0.0
4260_2.txt;2;0;0;2;193;0.01;0.0;0.0
2704_1.txt;0;0;0;0;476;0.0;0.0;0.0
10053_4.txt;2;0;0;2;190;0.01;0.0;0.0
929_1.txt;0;0;0;0;147;0.0;0.0;0.0
557_2.txt;10;0;2;12;305;0.03;0.0;0.01
4766_1.txt;0;0;0;0;171;0.0;0.0;0.0
11530_1.txt;0;0;0;0;222;0.0;0.0;0.0
12447_4.txt;7;0;0;7;170;0.04;0.0;0.0
2387_2.txt;4;1;0;5;195;0.02;0.01;0.0
9582_4.txt;6;1;0;7;334;0.02;0.0;0.0
8885_3.txt;14;2;0;16;464;0.03;0.0;0.0
3567_1.txt;20;1;1;22;464;0.04;0.0;0.0
4621_3.txt;5;0;0;5;258;0.02;0.0;0.0
6854_1.txt;2;0;0;2;36;0.06;0.0;0.0
12015_4.txt;10;0;0;10;122;0.08;0.0;0.0
6269_1.txt;0;0;0;0;64;0.0;0.0;0.0
6699_3.txt;3;0;0;3;131;0.02;0.0;0.0
10841_2.txt;16;0;0;16;317;0.05;0.0;0.0
9700_1.txt;3;0;3;6;181;0.02;0.0;0.02
12289_1.txt;13;0;1;14;446;0.03;0.0;0.0
2883_1.txt;2;0;0;2;174;0.01;0.0;0.0
4561_3.txt;0;0;0;0;75;0.0;0.0;0.0
10696_3.txt;6;0;0;6;515;0.01;0.0;0.0
3884_1.txt;0;0;0;0;279;0.0;0.0;0.0
11928_4.txt;6;1;1;8;394;0.02;0.0;0.0
11816_2.txt;2;1;0;3;263;0.01;0.0;0.0
5108_1.txt;0;0;0;0;197;0.0;0.0;0.0
3622_2.txt;3;0;2;5;161;0.02;0.0;0.01
11855_1.txt;9;4;0;13;238;0.04;0.02;0.0
6712_2.txt;4;1;0;5;110;0.04;0.01;0.0
8753_3.txt;8;0;0;8;134;0.06;0.0;0.0
3515_4.txt;7;1;2;10;304;0.02;0.0;0.01
3457_4.txt;5;0;0;5;417;0.01;0.0;0.0
8941_3.txt;9;3;0;12;130;0.07;0.02;0.0
6800_1.txt;0;0;0;0;298;0.0;0.0;0.0
11680_3.txt;5;0;0;5;162;0.03;0.0;0.0
10425_3.txt;3;0;0;3;205;0.01;0.0;0.0
2267_1.txt;0;0;0;0;38;0.0;0.0;0.0
5624_3.txt;10;8;2;20;291;0.03;0.03;0.01
6207_1.txt;0;1;0;1;178;0.0;0.01;0.0
2509_4.txt;32;2;1;35;553;0.06;0.0;0.0
1012_2.txt;2;0;0;2;146;0.01;0.0;0.0
6143_3.txt;1;0;0;1;225;0.0;0.0;0.0
7730_1.txt;0;0;0;0;146;0.0;0.0;0.0
6951_3.txt;3;15;7;25;1006;0.0;0.01;0.01
5082_1.txt;4;1;0;5;89;0.04;0.01;0.0
8637_4.txt;3;0;0;3;220;0.01;0.0;0.0
4901_4.txt;18;1;11;30;627;0.03;0.0;0.02
430_1.txt;0;0;0;0;56;0.0;0.0;0.0
4541_1.txt;27;20;3;50;926;0.03;0.02;0.0
12484_4.txt;4;0;3;7;908;0.0;0.0;0.0
7913_3.txt;3;0;0;3;426;0.01;0.0;0.0
9065_2.txt;10;2;0;12;397;0.03;0.01;0.0
5964_3.txt;12;0;0;12;461;0.03;0.0;0.0
11078_1.txt;0;2;0;2;192;0.0;0.01;0.0
4377_3.txt;6;0;0;6;721;0.01;0.0;0.0
10032_4.txt;11;0;0;11;263;0.04;0.0;0.0
11768_4.txt;26;0;1;27;602;0.04;0.0;0.0
1705_1.txt;2;0;0;2;146;0.01;0.0;0.0
713_1.txt;2;2;0;4;275;0.01;0.01;0.0
9062_3.txt;0;0;0;0;144;0.0;0.0;0.0
7143_2.txt;0;1;0;1;396;0.0;0.0;0.0
3798_2.txt;6;1;0;7;436;0.01;0.0;0.0
8423_4.txt;17;1;1;19;447;0.04;0.0;0.0
6119_1.txt;12;1;0;13;174;0.07;0.01;0.0
10295_1.txt;0;1;0;1;132;0.0;0.01;0.0
7304_4.txt;7;0;3;10;643;0.01;0.0;0.0
11394_1.txt;6;1;1;8;352;0.02;0.0;0.0
3232_1.txt;0;0;1;1;307;0.0;0.0;0.0
5642_1.txt;1;0;0;1;188;0.01;0.0;0.0
9258_3.txt;0;0;0;0;114;0.0;0.0;0.0
3206_4.txt;17;6;0;23;626;0.03;0.01;0.0
551_1.txt;4;0;4;8;154;0.03;0.0;0.03
2174_1.txt;3;0;0;3;149;0.02;0.0;0.0
996_3.txt;5;0;0;5;300;0.02;0.0;0.0
1008_1.txt;5;0;0;5;145;0.03;0.0;0.0
1409_4.txt;17;8;0;25;371;0.05;0.02;0.0
6420_4.txt;3;0;0;3;185;0.02;0.0;0.0
1795_2.txt;0;0;4;4;177;0.0;0.0;0.02
10459_2.txt;2;0;3;5;134;0.01;0.0;0.02
367_2.txt;0;0;0;0;104;0.0;0.0;0.0
2648_4.txt;9;0;4;13;324;0.03;0.0;0.01
296_2.txt;2;0;0;2;46;0.04;0.0;0.0
6036_1.txt;0;0;0;0;284;0.0;0.0;0.0
1803_4.txt;0;0;3;3;171;0.0;0.0;0.02
10061_4.txt;11;0;0;11;158;0.07;0.0;0.0
8599_2.txt;0;7;0;7;217;0.0;0.03;0.0
3145_3.txt;0;0;0;0;183;0.0;0.0;0.0
9192_3.txt;1;0;0;1;271;0.0;0.0;0.0
5718_1.txt;0;0;0;0;126;0.0;0.0;0.0
3201_2.txt;17;6;0;23;239;0.07;0.03;0.0
4605_2.txt;10;0;0;10;374;0.03;0.0;0.0
9874_1.txt;4;0;0;4;160;0.03;0.0;0.0
4807_4.txt;0;0;0;0;131;0.0;0.0;0.0
6224_2.txt;26;4;2;32;843;0.03;0.0;0.0
8092_3.txt;13;4;0;17;153;0.08;0.03;0.0
3606_2.txt;0;0;0;0;149;0.0;0.0;0.0
8878_4.txt;8;0;0;8;174;0.05;0.0;0.0
11113_3.txt;9;0;0;9;165;0.05;0.0;0.0
5882_1.txt;12;0;0;12;192;0.06;0.0;0.0
11179_3.txt;10;0;0;10;158;0.06;0.0;0.0
8835_1.txt;0;0;0;0;188;0.0;0.0;0.0
4927_3.txt;5;0;1;6;149;0.03;0.0;0.01
4463_1.txt;6;1;0;7;474;0.01;0.0;0.0
5076_4.txt;43;2;1;46;661;0.07;0.0;0.0
8820_4.txt;3;1;0;4;195;0.02;0.01;0.0
5802_3.txt;2;4;2;8;339;0.01;0.01;0.01
1376_1.txt;2;0;0;2;161;0.01;0.0;0.0
5898_4.txt;6;3;0;9;708;0.01;0.0;0.0
10891_1.txt;0;0;0;0;144;0.0;0.0;0.0
4493_1.txt;10;0;3;13;1163;0.01;0.0;0.0
12342_1.txt;7;2;0;9;273;0.03;0.01;0.0
10516_4.txt;36;3;3;42;695;0.05;0.0;0.0
8683_1.txt;8;2;4;14;371;0.02;0.01;0.01
1265_2.txt;7;1;0;8;212;0.03;0.0;0.0
3290_1.txt;6;0;0;6;163;0.04;0.0;0.0
10914_3.txt;7;0;0;7;310;0.02;0.0;0.0
12030_1.txt;11;1;0;12;619;0.02;0.0;0.0
314_1.txt;3;0;0;3;162;0.02;0.0;0.0
10856_2.txt;5;0;0;5;305;0.02;0.0;0.0
5504_1.txt;3;1;0;4;326;0.01;0.0;0.0
9777_1.txt;16;0;1;17;640;0.03;0.0;0.0
681_1.txt;32;5;0;37;836;0.04;0.01;0.0
382_1.txt;0;2;0;2;421;0.0;0.0;0.0
1229_3.txt;2;0;0;2;147;0.01;0.0;0.0
5171_4.txt;0;0;0;0;182;0.0;0.0;0.0
4932_4.txt;22;2;0;24;542;0.04;0.0;0.0
4044_1.txt;0;0;0;0;166;0.0;0.0;0.0
10854_4.txt;4;1;2;7;528;0.01;0.0;0.0
7624_4.txt;4;4;0;8;123;0.03;0.03;0.0
2957_1.txt;5;0;0;5;75;0.07;0.0;0.0
3809_1.txt;3;0;0;3;188;0.02;0.0;0.0
2442_1.txt;2;3;2;7;290;0.01;0.01;0.01
8006_2.txt;0;1;0;1;1060;0.0;0.0;0.0
5438_3.txt;37;5;2;44;801;0.05;0.01;0.0
5443_1.txt;4;0;1;5;100;0.04;0.0;0.01
8623_3.txt;7;2;0;9;156;0.04;0.01;0.0
6367_4.txt;0;0;0;0;71;0.0;0.0;0.0
7486_4.txt;6;0;0;6;55;0.11;0.0;0.0
4071_4.txt;3;0;1;4;670;0.0;0.0;0.0
5608_1.txt;10;0;0;10;308;0.03;0.0;0.0
1541_4.txt;1;6;1;8;238;0.0;0.03;0.0
5224_1.txt;0;0;0;0;43;0.0;0.0;0.0
11637_4.txt;4;2;1;7;333;0.01;0.01;0.0
6106_1.txt;0;0;0;0;150;0.0;0.0;0.0
1625_1.txt;0;0;0;0;267;0.0;0.0;0.0
8218_1.txt;0;0;0;0;142;0.0;0.0;0.0
1572_1.txt;1;0;0;1;156;0.01;0.0;0.0
9408_3.txt;18;1;2;21;709;0.03;0.0;0.0
2289_3.txt;18;0;0;18;277;0.06;0.0;0.0
7756_2.txt;2;1;0;3;146;0.01;0.01;0.0
8548_3.txt;29;1;5;35;823;0.04;0.0;0.01
11830_4.txt;1;0;0;1;187;0.01;0.0;0.0
4442_4.txt;1;0;0;1;179;0.01;0.0;0.0
2670_2.txt;3;0;0;3;201;0.01;0.0;0.0
2779_1.txt;2;0;0;2;133;0.02;0.0;0.0
9002_4.txt;6;0;0;6;163;0.04;0.0;0.0
6145_4.txt;13;5;0;18;327;0.04;0.02;0.0
4287_1.txt;2;0;0;2;160;0.01;0.0;0.0
3455_2.txt;2;0;0;2;151;0.01;0.0;0.0
6515_1.txt;6;1;0;7;203;0.03;0.0;0.0
10986_1.txt;43;4;0;47;1087;0.04;0.0;0.0
5837_3.txt;0;0;0;0;176;0.0;0.0;0.0
4799_2.txt;0;0;0;0;155;0.0;0.0;0.0
5948_4.txt;13;0;1;14;161;0.08;0.0;0.01
7786_1.txt;0;0;0;0;136;0.0;0.0;0.0
6559_1.txt;4;0;0;4;85;0.05;0.0;0.0
3644_4.txt;0;0;0;0;203;0.0;0.0;0.0
4729_3.txt;9;0;0;9;157;0.06;0.0;0.0
7407_2.txt;2;0;0;2;299;0.01;0.0;0.0
10362_1.txt;2;0;0;2;147;0.01;0.0;0.0
10179_1.txt;0;2;5;7;136;0.0;0.01;0.04
1189_4.txt;0;3;2;5;137;0.0;0.02;0.01
6198_1.txt;9;2;0;11;249;0.04;0.01;0.0
7997_3.txt;10;0;0;10;307;0.03;0.0;0.0
7806_1.txt;3;1;0;4;136;0.02;0.01;0.0
5032_4.txt;0;6;0;6;182;0.0;0.03;0.0
7959_4.txt;7;0;0;7;227;0.03;0.0;0.0
9849_1.txt;0;0;0;0;211;0.0;0.0;0.0
4108_2.txt;17;0;0;17;139;0.12;0.0;0.0
7703_3.txt;4;0;1;5;205;0.02;0.0;0.0
4491_1.txt;2;0;1;3;230;0.01;0.0;0.0
10051_4.txt;0;0;0;0;215;0.0;0.0;0.0
11248_2.txt;0;0;0;0;165;0.0;0.0;0.0
11014_1.txt;3;0;3;6;173;0.02;0.0;0.02
10381_4.txt;0;1;4;5;286;0.0;0.0;0.01
7962_4.txt;2;0;0;2;162;0.01;0.0;0.0
12482_4.txt;10;0;1;11;385;0.03;0.0;0.0
7965_4.txt;0;0;0;0;62;0.0;0.0;0.0
1274_4.txt;19;0;1;20;223;0.09;0.0;0.0
8926_1.txt;10;0;0;10;241;0.04;0.0;0.0
4871_2.txt;1;0;0;1;71;0.01;0.0;0.0
4984_1.txt;0;0;0;0;99;0.0;0.0;0.0
12305_2.txt;8;0;1;9;150;0.05;0.0;0.01
1746_1.txt;0;0;0;0;122;0.0;0.0;0.0
3553_4.txt;2;0;0;2;87;0.02;0.0;0.0
4977_3.txt;3;1;0;4;174;0.02;0.01;0.0
1228_2.txt;9;0;0;9;453;0.02;0.0;0.0
4604_3.txt;4;0;0;4;154;0.03;0.0;0.0
9918_1.txt;1;1;0;2;176;0.01;0.01;0.0
5502_3.txt;12;0;0;12;227;0.05;0.0;0.0
3848_4.txt;15;3;0;18;213;0.07;0.01;0.0
2021_3.txt;14;0;0;14;136;0.1;0.0;0.0
11150_3.txt;2;0;0;2;253;0.01;0.0;0.0
12411_4.txt;0;0;0;0;244;0.0;0.0;0.0
3318_3.txt;2;0;0;2;115;0.02;0.0;0.0
5809_4.txt;10;1;0;11;141;0.07;0.01;0.0
3325_1.txt;2;4;0;6;236;0.01;0.02;0.0
7906_3.txt;6;0;0;6;295;0.02;0.0;0.0
9737_4.txt;42;0;0;42;476;0.09;0.0;0.0
5881_1.txt;3;0;0;3;173;0.02;0.0;0.0
1165_3.txt;2;0;0;2;218;0.01;0.0;0.0
1985_1.txt;3;0;0;3;193;0.02;0.0;0.0
7456_2.txt;4;0;0;4;146;0.03;0.0;0.0
10584_1.txt;2;0;0;2;284;0.01;0.0;0.0
9740_1.txt;2;0;0;2;189;0.01;0.0;0.0
12148_1.txt;0;0;0;0;264;0.0;0.0;0.0
5542_4.txt;13;2;2;17;584;0.02;0.0;0.0
9872_2.txt;2;2;0;4;308;0.01;0.01;0.0
1822_3.txt;14;0;0;14;270;0.05;0.0;0.0
4737_3.txt;13;0;0;13;221;0.06;0.0;0.0
4259_1.txt;0;2;0;2;269;0.0;0.01;0.0
1010_4.txt;21;0;0;21;233;0.09;0.0;0.0
1557_3.txt;0;0;0;0;121;0.0;0.0;0.0
3322_3.txt;4;1;2;7;186;0.02;0.01;0.01
9635_3.txt;30;2;0;32;282;0.11;0.01;0.0
7835_4.txt;5;0;3;8;340;0.01;0.0;0.01
3047_4.txt;1;1;0;2;328;0.0;0.0;0.0
8459_3.txt;2;0;0;2;294;0.01;0.0;0.0
9914_4.txt;4;1;2;7;449;0.01;0.0;0.0
9070_1.txt;21;0;2;23;423;0.05;0.0;0.0
12459_1.txt;0;0;2;2;196;0.0;0.0;0.01
11435_3.txt;8;0;0;8;236;0.03;0.0;0.0
4695_4.txt;8;0;0;8;310;0.03;0.0;0.0
8412_4.txt;12;0;0;12;428;0.03;0.0;0.0
8046_1.txt;5;2;1;8;397;0.01;0.01;0.0
4904_3.txt;4;0;0;4;242;0.02;0.0;0.0
7240_1.txt;0;0;0;0;50;0.0;0.0;0.0
7216_1.txt;0;0;3;3;229;0.0;0.0;0.01
4967_1.txt;9;2;0;11;384;0.02;0.01;0.0
7992_4.txt;12;2;0;14;361;0.03;0.01;0.0
2264_1.txt;3;0;0;3;395;0.01;0.0;0.0
8132_3.txt;4;0;0;4;680;0.01;0.0;0.0
7181_3.txt;2;0;0;2;124;0.02;0.0;0.0
12248_4.txt;0;2;0;2;171;0.0;0.01;0.0
1988_1.txt;6;0;3;9;163;0.04;0.0;0.02
8592_1.txt;4;0;0;4;140;0.03;0.0;0.0
340_3.txt;8;0;0;8;240;0.03;0.0;0.0
11359_2.txt;2;0;0;2;218;0.01;0.0;0.0
746_1.txt;8;2;1;11;478;0.02;0.0;0.0
7058_4.txt;11;5;1;17;194;0.06;0.03;0.01
1605_4.txt;9;2;4;15;299;0.03;0.01;0.01
6087_3.txt;0;0;0;0;259;0.0;0.0;0.0
363_1.txt;0;0;0;0;234;0.0;0.0;0.0
3895_1.txt;4;0;2;6;304;0.01;0.0;0.01
5342_1.txt;7;0;0;7;194;0.04;0.0;0.0
10577_2.txt;0;1;0;1;157;0.0;0.01;0.0
4772_3.txt;0;0;1;1;175;0.0;0.0;0.01
4141_4.txt;0;0;0;0;188;0.0;0.0;0.0
12309_3.txt;6;0;0;6;78;0.08;0.0;0.0
8517_2.txt;11;0;7;18;262;0.04;0.0;0.03
8519_1.txt;2;0;3;5;68;0.03;0.0;0.04
44_2.txt;1;1;0;2;188;0.01;0.01;0.0
3247_3.txt;17;0;0;17;640;0.03;0.0;0.0
8261_1.txt;2;1;0;3;137;0.01;0.01;0.0
6943_1.txt;0;0;0;0;189;0.0;0.0;0.0
64_1.txt;12;0;0;12;374;0.03;0.0;0.0
10507_1.txt;7;0;0;7;347;0.02;0.0;0.0
714_2.txt;4;0;0;4;123;0.03;0.0;0.0
4536_1.txt;1;1;2;4;161;0.01;0.01;0.01
7734_1.txt;0;0;0;0;81;0.0;0.0;0.0
7327_1.txt;29;1;2;32;1396;0.02;0.0;0.0
10591_3.txt;16;2;2;20;484;0.03;0.0;0.0
7436_1.txt;0;0;0;0;202;0.0;0.0;0.0
5395_1.txt;15;0;0;15;211;0.07;0.0;0.0
6281_3.txt;2;0;0;2;728;0.0;0.0;0.0
9458_1.txt;10;0;2;12;294;0.03;0.0;0.01
604_1.txt;0;0;0;0;336;0.0;0.0;0.0
7521_2.txt;2;0;0;2;680;0.0;0.0;0.0
6668_2.txt;0;2;0;2;326;0.0;0.01;0.0
3166_3.txt;10;0;0;10;214;0.05;0.0;0.0
2067_1.txt;8;0;1;9;558;0.01;0.0;0.0
10288_1.txt;0;0;0;0;125;0.0;0.0;0.0
1457_1.txt;6;3;0;9;125;0.05;0.02;0.0
10562_2.txt;3;0;0;3;126;0.02;0.0;0.0
4841_2.txt;4;0;0;4;163;0.02;0.0;0.0
6835_2.txt;12;4;0;16;342;0.04;0.01;0.0
2004_3.txt;0;0;0;0;199;0.0;0.0;0.0
2835_1.txt;4;2;0;6;160;0.03;0.01;0.0
784_3.txt;3;1;0;4;418;0.01;0.0;0.0
8044_4.txt;5;1;1;7;367;0.01;0.0;0.0
6136_2.txt;5;0;0;5;114;0.04;0.0;0.0
6090_2.txt;22;2;0;24;647;0.03;0.0;0.0
10508_1.txt;3;1;0;4;172;0.02;0.01;0.0
7613_2.txt;6;2;0;8;143;0.04;0.01;0.0
11902_4.txt;0;7;0;7;318;0.0;0.02;0.0
2721_3.txt;3;0;0;3;155;0.02;0.0;0.0
4200_1.txt;0;0;0;0;47;0.0;0.0;0.0
12412_3.txt;13;0;0;13;639;0.02;0.0;0.0
1488_1.txt;2;0;0;2;231;0.01;0.0;0.0
9131_3.txt;34;2;4;40;681;0.05;0.0;0.01
6352_2.txt;6;0;0;6;136;0.04;0.0;0.0
2193_1.txt;0;0;0;0;136;0.0;0.0;0.0
11275_1.txt;0;1;0;1;169;0.0;0.01;0.0
10966_1.txt;17;2;0;19;502;0.03;0.0;0.0
12162_4.txt;5;1;0;6;235;0.02;0.0;0.0
7524_1.txt;12;0;0;12;512;0.02;0.0;0.0
5798_4.txt;13;0;0;13;528;0.02;0.0;0.0
2750_1.txt;7;4;0;11;194;0.04;0.02;0.0
3189_1.txt;3;1;0;4;153;0.02;0.01;0.0
9858_2.txt;6;0;1;7;172;0.03;0.0;0.01
4722_1.txt;0;11;1;12;222;0.0;0.05;0.0
6524_4.txt;0;6;0;6;427;0.0;0.01;0.0
3256_4.txt;38;4;2;44;902;0.04;0.0;0.0
11880_1.txt;63;0;0;63;1231;0.05;0.0;0.0
946_1.txt;2;0;0;2;206;0.01;0.0;0.0
12023_4.txt;5;1;6;12;232;0.02;0.0;0.03
10424_2.txt;4;0;0;4;133;0.03;0.0;0.0
9434_2.txt;0;1;0;1;288;0.0;0.0;0.0
8552_3.txt;4;0;1;5;300;0.01;0.0;0.0
7601_4.txt;2;2;0;4;184;0.01;0.01;0.0
3126_1.txt;1;0;0;1;137;0.01;0.0;0.0
6718_2.txt;0;0;0;0;132;0.0;0.0;0.0
1781_4.txt;16;1;0;17;106;0.15;0.01;0.0
755_1.txt;2;1;3;6;577;0.0;0.0;0.01
3652_4.txt;3;0;0;3;177;0.02;0.0;0.0
6506_1.txt;5;0;0;5;236;0.02;0.0;0.0
1304_3.txt;6;8;1;15;262;0.02;0.03;0.0
8407_4.txt;2;0;0;2;68;0.03;0.0;0.0
107_2.txt;2;0;0;2;215;0.01;0.0;0.0
7031_2.txt;0;0;0;0;138;0.0;0.0;0.0
12301_4.txt;13;1;1;15;417;0.03;0.0;0.0
11448_2.txt;15;0;1;16;235;0.06;0.0;0.0
9098_1.txt;6;0;0;6;208;0.03;0.0;0.0
9308_1.txt;0;0;0;0;171;0.0;0.0;0.0
3482_1.txt;8;0;0;8;141;0.06;0.0;0.0
9567_1.txt;4;1;0;5;176;0.02;0.01;0.0
8669_1.txt;22;0;1;23;459;0.05;0.0;0.0
657_1.txt;36;0;2;38;652;0.06;0.0;0.0
4277_3.txt;23;4;2;29;393;0.06;0.01;0.01
4963_4.txt;5;0;0;5;259;0.02;0.0;0.0
11079_2.txt;0;0;0;0;151;0.0;0.0;0.0
11488_3.txt;9;0;0;9;336;0.03;0.0;0.0
1297_2.txt;9;1;0;10;295;0.03;0.0;0.0
4125_2.txt;4;0;0;4;212;0.02;0.0;0.0
9046_1.txt;0;0;2;2;154;0.0;0.0;0.01
10234_1.txt;1;1;0;2;162;0.01;0.01;0.0
8651_1.txt;0;0;0;0;154;0.0;0.0;0.0
3694_2.txt;6;3;2;11;374;0.02;0.01;0.01
6956_2.txt;6;0;1;7;175;0.03;0.0;0.01
5195_4.txt;2;1;0;3;269;0.01;0.0;0.0
11789_1.txt;0;0;0;0;133;0.0;0.0;0.0
1469_1.txt;5;0;0;5;133;0.04;0.0;0.0
10431_1.txt;0;3;0;3;324;0.0;0.01;0.0
7691_2.txt;17;0;0;17;279;0.06;0.0;0.0
4502_3.txt;31;0;6;37;504;0.06;0.0;0.01
7361_3.txt;4;0;1;5;113;0.04;0.0;0.01
10998_1.txt;0;0;0;0;56;0.0;0.0;0.0
5119_3.txt;12;0;1;13;528;0.02;0.0;0.0
12257_3.txt;0;0;0;0;142;0.0;0.0;0.0
8085_2.txt;12;1;0;13;619;0.02;0.0;0.0
4304_1.txt;11;11;7;29;326;0.03;0.03;0.02
2052_1.txt;3;0;0;3;106;0.03;0.0;0.0
8778_3.txt;5;0;0;5;238;0.02;0.0;0.0
7861_4.txt;0;0;0;0;204;0.0;0.0;0.0
10286_1.txt;7;0;0;7;220;0.03;0.0;0.0
6519_3.txt;10;0;0;10;121;0.08;0.0;0.0
8368_1.txt;0;0;0;0;287;0.0;0.0;0.0
6561_4.txt;2;1;4;7;146;0.01;0.01;0.03
947_2.txt;0;0;2;2;251;0.0;0.0;0.01
7303_3.txt;9;3;0;12;196;0.05;0.02;0.0
8489_1.txt;2;0;0;2;143;0.01;0.0;0.0
10875_2.txt;1;0;0;1;65;0.02;0.0;0.0
7050_3.txt;9;3;0;12;471;0.02;0.01;0.0
1954_3.txt;4;0;0;4;610;0.01;0.0;0.0
1518_1.txt;0;2;0;2;89;0.0;0.02;0.0
3380_4.txt;9;2;1;12;179;0.05;0.01;0.01
1948_1.txt;0;0;0;0;139;0.0;0.0;0.0
9697_3.txt;3;0;1;4;249;0.01;0.0;0.0
5784_4.txt;9;0;0;9;380;0.02;0.0;0.0
4784_2.txt;0;0;0;0;119;0.0;0.0;0.0
10755_1.txt;3;0;1;4;119;0.03;0.0;0.01
1575_1.txt;0;0;0;0;82;0.0;0.0;0.0
4845_1.txt;2;0;0;2;147;0.01;0.0;0.0
4470_3.txt;2;0;0;2;193;0.01;0.0;0.0
5419_1.txt;12;6;0;18;205;0.06;0.03;0.0
5577_1.txt;0;0;3;3;148;0.0;0.0;0.02
6409_1.txt;6;0;1;7;259;0.02;0.0;0.0
2425_4.txt;3;2;0;5;212;0.01;0.01;0.0
9965_1.txt;5;0;1;6;275;0.02;0.0;0.0
6578_3.txt;7;0;1;8;185;0.04;0.0;0.01
8232_1.txt;0;0;0;0;193;0.0;0.0;0.0
11836_2.txt;0;0;0;0;129;0.0;0.0;0.0
3359_1.txt;7;0;2;9;218;0.03;0.0;0.01
9107_1.txt;1;0;0;1;156;0.01;0.0;0.0
2517_2.txt;2;0;0;2;350;0.01;0.0;0.0
10256_3.txt;2;0;1;3;170;0.01;0.0;0.01
3602_2.txt;7;1;0;8;316;0.02;0.0;0.0
10216_3.txt;18;1;0;19;569;0.03;0.0;0.0
9142_1.txt;3;0;0;3;613;0.0;0.0;0.0
7766_1.txt;10;0;0;10;172;0.06;0.0;0.0
11544_3.txt;6;0;0;6;168;0.04;0.0;0.0
916_3.txt;13;0;0;13;158;0.08;0.0;0.0
9779_3.txt;9;0;0;9;144;0.06;0.0;0.0
8406_3.txt;0;2;0;2;155;0.0;0.01;0.0
6334_1.txt;0;0;0;0;217;0.0;0.0;0.0
2304_1.txt;0;2;6;8;584;0.0;0.0;0.01
9514_1.txt;4;0;0;4;165;0.02;0.0;0.0
8693_4.txt;0;10;0;10;148;0.0;0.07;0.0
1814_1.txt;6;3;1;10;205;0.03;0.01;0.0
6086_4.txt;0;2;1;3;420;0.0;0.0;0.0
11520_3.txt;7;0;3;10;187;0.04;0.0;0.02
10020_3.txt;18;0;2;20;208;0.09;0.0;0.01
4001_3.txt;6;0;0;6;174;0.03;0.0;0.0
7809_1.txt;8;0;0;8;118;0.07;0.0;0.0
9346_1.txt;3;0;0;3;113;0.03;0.0;0.0
10415_2.txt;19;2;0;21;377;0.05;0.01;0.0
9814_1.txt;1;0;0;1;153;0.01;0.0;0.0
9033_4.txt;42;1;1;44;404;0.1;0.0;0.0
8991_2.txt;0;0;0;0;54;0.0;0.0;0.0
9273_1.txt;2;0;0;2;182;0.01;0.0;0.0
5405_1.txt;1;0;0;1;211;0.0;0.0;0.0
6146_4.txt;2;3;0;5;481;0.0;0.01;0.0
7897_1.txt;9;0;0;9;287;0.03;0.0;0.0
2817_1.txt;6;1;0;7;238;0.03;0.0;0.0
5476_4.txt;9;4;0;13;394;0.02;0.01;0.0
5720_3.txt;2;2;0;4;373;0.01;0.01;0.0
368_4.txt;0;0;0;0;172;0.0;0.0;0.0
3_4.txt;6;3;0;9;371;0.02;0.01;0.0
3246_4.txt;4;0;0;4;290;0.01;0.0;0.0
9718_4.txt;36;4;1;41;673;0.05;0.01;0.0
8774_4.txt;1;3;4;8;218;0.0;0.01;0.02
1431_3.txt;16;0;0;16;349;0.05;0.0;0.0
2586_2.txt;0;0;2;2;207;0.0;0.0;0.01
1052_1.txt;7;0;2;9;402;0.02;0.0;0.0
11089_1.txt;4;3;0;7;107;0.04;0.03;0.0
3056_1.txt;2;16;0;18;377;0.01;0.04;0.0
3337_2.txt;2;0;0;2;236;0.01;0.0;0.0
1957_2.txt;0;0;0;0;173;0.0;0.0;0.0
5492_3.txt;20;0;8;28;397;0.05;0.0;0.02
2187_2.txt;7;0;0;7;110;0.06;0.0;0.0
8924_3.txt;11;0;0;11;197;0.06;0.0;0.0
884_4.txt;33;18;2;53;561;0.06;0.03;0.0
12047_1.txt;8;1;0;9;309;0.03;0.0;0.0
7863_4.txt;1;0;0;1;166;0.01;0.0;0.0
3456_4.txt;12;0;1;13;557;0.02;0.0;0.0
3545_4.txt;30;10;1;41;667;0.04;0.01;0.0
11161_4.txt;42;1;7;50;993;0.04;0.0;0.01
8556_1.txt;2;0;0;2;305;0.01;0.0;0.0
7498_3.txt;5;0;0;5;119;0.04;0.0;0.0
7023_1.txt;2;0;0;2;137;0.01;0.0;0.0
9498_1.txt;0;0;0;0;140;0.0;0.0;0.0
6375_3.txt;33;4;2;39;669;0.05;0.01;0.0
12096_3.txt;0;0;0;0;74;0.0;0.0;0.0
9454_1.txt;8;2;0;10;162;0.05;0.01;0.0
11878_1.txt;5;0;2;7;160;0.03;0.0;0.01
3974_4.txt;1;2;0;3;279;0.0;0.01;0.0
11140_1.txt;3;0;0;3;111;0.03;0.0;0.0
6979_3.txt;0;3;0;3;156;0.0;0.02;0.0
8585_4.txt;9;1;1;11;205;0.04;0.0;0.0
1152_3.txt;2;0;0;2;206;0.01;0.0;0.0
109_2.txt;0;0;0;0;85;0.0;0.0;0.0
5093_3.txt;1;0;0;1;161;0.01;0.0;0.0
2678_1.txt;2;0;0;2;203;0.01;0.0;0.0
2369_4.txt;16;1;0;17;259;0.06;0.0;0.0
7393_1.txt;6;1;0;7;243;0.02;0.0;0.0
5634_1.txt;6;0;0;6;305;0.02;0.0;0.0
5062_1.txt;0;0;0;0;228;0.0;0.0;0.0
7763_3.txt;2;6;0;8;449;0.0;0.01;0.0
1042_1.txt;0;1;0;1;197;0.0;0.01;0.0
284_2.txt;14;1;0;15;412;0.03;0.0;0.0
9247_4.txt;6;0;1;7;193;0.03;0.0;0.01
5050_1.txt;2;0;0;2;84;0.02;0.0;0.0
12151_1.txt;0;0;0;0;164;0.0;0.0;0.0
3939_3.txt;8;0;0;8;58;0.14;0.0;0.0
3552_2.txt;0;2;0;2;328;0.0;0.01;0.0
2274_2.txt;8;0;4;12;344;0.02;0.0;0.01
5821_4.txt;8;0;0;8;131;0.06;0.0;0.0
12498_2.txt;4;2;4;10;175;0.02;0.01;0.02
4178_4.txt;20;1;0;21;461;0.04;0.0;0.0
2639_1.txt;8;0;0;8;360;0.02;0.0;0.0
60_4.txt;2;0;1;3;157;0.01;0.0;0.01
626_2.txt;0;0;0;0;242;0.0;0.0;0.0
2192_4.txt;0;0;0;0;148;0.0;0.0;0.0
1375_1.txt;2;0;0;2;61;0.03;0.0;0.0
261_4.txt;2;0;0;2;75;0.03;0.0;0.0
5714_1.txt;0;0;0;0;153;0.0;0.0;0.0
215_4.txt;13;0;2;15;347;0.04;0.0;0.01
5188_1.txt;5;0;2;7;157;0.03;0.0;0.01
7024_2.txt;0;3;0;3;151;0.0;0.02;0.0
8627_4.txt;4;0;0;4;168;0.02;0.0;0.0
9617_2.txt;19;0;0;19;205;0.09;0.0;0.0
5667_2.txt;2;0;1;3;234;0.01;0.0;0.0
10335_3.txt;1;0;0;1;113;0.01;0.0;0.0
1167_4.txt;2;0;0;2;254;0.01;0.0;0.0
8704_1.txt;2;0;2;4;105;0.02;0.0;0.02
728_3.txt;0;0;2;2;50;0.0;0.0;0.04
7442_4.txt;0;0;0;0;174;0.0;0.0;0.0
12272_1.txt;0;1;1;2;98;0.0;0.01;0.01
3720_2.txt;0;2;0;2;187;0.0;0.01;0.0
295_3.txt;0;0;0;0;130;0.0;0.0;0.0
5388_2.txt;5;1;0;6;392;0.01;0.0;0.0
3301_3.txt;3;4;0;7;362;0.01;0.01;0.0
6401_1.txt;0;0;0;0;227;0.0;0.0;0.0
8443_4.txt;5;1;0;6;172;0.03;0.01;0.0
2389_2.txt;15;2;0;17;216;0.07;0.01;0.0
12150_3.txt;0;4;0;4;250;0.0;0.02;0.0
861_2.txt;3;0;0;3;122;0.02;0.0;0.0
12395_4.txt;0;1;0;1;209;0.0;0.0;0.0
5803_1.txt;21;6;2;29;963;0.02;0.01;0.0
7592_3.txt;16;4;0;20;571;0.03;0.01;0.0
4702_1.txt;23;0;2;25;427;0.05;0.0;0.0
3402_2.txt;0;1;0;1;161;0.0;0.01;0.0
4099_4.txt;14;0;0;14;317;0.04;0.0;0.0
10703_3.txt;6;0;0;6;103;0.06;0.0;0.0
3156_2.txt;6;0;0;6;243;0.02;0.0;0.0
5432_2.txt;7;0;0;7;288;0.02;0.0;0.0
4029_3.txt;2;6;0;8;298;0.01;0.02;0.0
1169_4.txt;2;0;0;2;58;0.03;0.0;0.0
12312_4.txt;11;2;1;14;467;0.02;0.0;0.0
80_3.txt;3;0;0;3;129;0.02;0.0;0.0
3513_4.txt;6;0;0;6;316;0.02;0.0;0.0
10296_1.txt;0;1;0;1;216;0.0;0.0;0.0
9364_3.txt;10;1;0;11;948;0.01;0.0;0.0
7971_1.txt;3;0;0;3;161;0.02;0.0;0.0
6725_1.txt;7;0;3;10;246;0.03;0.0;0.01
3031_2.txt;19;2;0;21;362;0.05;0.01;0.0
2468_4.txt;4;1;3;8;424;0.01;0.0;0.01
4464_1.txt;0;0;0;0;42;0.0;0.0;0.0
11072_2.txt;0;0;0;0;147;0.0;0.0;0.0
4221_1.txt;2;1;0;3;140;0.01;0.01;0.0
6605_1.txt;1;2;1;4;164;0.01;0.01;0.01
2790_4.txt;23;3;0;26;370;0.06;0.01;0.0
3147_3.txt;30;3;3;36;618;0.05;0.0;0.0
11937_1.txt;1;0;0;1;78;0.01;0.0;0.0
2029_3.txt;4;0;0;4;535;0.01;0.0;0.0
12487_3.txt;25;0;0;25;318;0.08;0.0;0.0
11489_3.txt;7;5;1;13;283;0.02;0.02;0.0
1894_4.txt;0;0;0;0;241;0.0;0.0;0.0
1937_2.txt;7;0;0;7;202;0.03;0.0;0.0
75_1.txt;12;1;2;15;545;0.02;0.0;0.0
4842_2.txt;1;1;0;2;180;0.01;0.01;0.0
8591_1.txt;15;1;0;16;262;0.06;0.0;0.0
11888_2.txt;2;2;0;4;146;0.01;0.01;0.0
4960_1.txt;27;0;0;27;775;0.03;0.0;0.0
3833_3.txt;0;0;0;0;71;0.0;0.0;0.0
11700_2.txt;6;0;0;6;147;0.04;0.0;0.0
7129_1.txt;2;0;1;3;177;0.01;0.0;0.01
2564_2.txt;4;0;0;4;175;0.02;0.0;0.0
964_3.txt;2;0;0;2;42;0.05;0.0;0.0
7137_1.txt;0;0;1;1;193;0.0;0.0;0.01
8396_4.txt;6;0;0;6;175;0.03;0.0;0.0
1819_2.txt;9;0;0;9;340;0.03;0.0;0.0
4704_1.txt;2;1;1;4;125;0.02;0.01;0.01
2159_4.txt;15;0;0;15;540;0.03;0.0;0.0
2587_2.txt;1;0;0;1;143;0.01;0.0;0.0
11188_1.txt;2;0;0;2;147;0.01;0.0;0.0
7715_2.txt;17;2;0;19;162;0.1;0.01;0.0
7755_3.txt;11;1;1;13;533;0.02;0.0;0.0
10371_3.txt;10;2;2;14;434;0.02;0.0;0.0
8796_3.txt;4;2;0;6;266;0.02;0.01;0.0
7483_2.txt;8;1;0;9;265;0.03;0.0;0.0
6910_2.txt;4;0;0;4;197;0.02;0.0;0.0
8927_3.txt;42;0;1;43;376;0.11;0.0;0.0
3847_4.txt;30;3;4;37;232;0.13;0.01;0.02
1509_2.txt;2;0;0;2;130;0.02;0.0;0.0
3873_4.txt;9;0;0;9;111;0.08;0.0;0.0
8821_3.txt;8;4;0;12;348;0.02;0.01;0.0
8376_2.txt;8;0;2;10;217;0.04;0.0;0.01
9262_3.txt;1;0;0;1;264;0.0;0.0;0.0
9829_1.txt;4;0;0;4;157;0.03;0.0;0.0
9466_2.txt;5;0;0;5;157;0.03;0.0;0.0
3551_1.txt;0;0;0;0;76;0.0;0.0;0.0
88_2.txt;5;0;0;5;140;0.04;0.0;0.0
11508_1.txt;7;0;1;8;158;0.04;0.0;0.01
9450_1.txt;1;0;0;1;158;0.01;0.0;0.0
8199_2.txt;0;0;0;0;121;0.0;0.0;0.0
6035_1.txt;0;0;0;0;167;0.0;0.0;0.0
1680_4.txt;20;4;0;24;126;0.16;0.03;0.0
6821_4.txt;0;0;0;0;164;0.0;0.0;0.0
10717_4.txt;15;0;0;15;321;0.05;0.0;0.0
6209_4.txt;18;5;0;23;992;0.02;0.01;0.0
10729_1.txt;0;0;0;0;280;0.0;0.0;0.0
6393_4.txt;2;1;0;3;393;0.01;0.0;0.0
8647_1.txt;1;0;0;1;149;0.01;0.0;0.0
5078_2.txt;9;1;0;10;149;0.06;0.01;0.0
1922_3.txt;0;0;0;0;134;0.0;0.0;0.0
396_3.txt;0;0;0;0;220;0.0;0.0;0.0
11211_1.txt;0;0;0;0;161;0.0;0.0;0.0
6634_2.txt;3;0;0;3;171;0.02;0.0;0.0
7979_1.txt;3;0;0;3;95;0.03;0.0;0.0
4162_1.txt;2;0;0;2;201;0.01;0.0;0.0
2186_1.txt;0;0;0;0;181;0.0;0.0;0.0
10676_3.txt;2;0;0;2;210;0.01;0.0;0.0
7819_1.txt;8;0;0;8;336;0.02;0.0;0.0
12104_1.txt;8;4;3;15;318;0.03;0.01;0.01
6694_1.txt;1;0;0;1;75;0.01;0.0;0.0
4577_1.txt;8;0;2;10;485;0.02;0.0;0.0
7214_1.txt;42;0;0;42;804;0.05;0.0;0.0
8183_4.txt;7;0;1;8;174;0.04;0.0;0.01
7651_1.txt;32;1;0;33;993;0.03;0.0;0.0
9380_4.txt;3;0;0;3;126;0.02;0.0;0.0
624_2.txt;7;0;0;7;240;0.03;0.0;0.0
4203_2.txt;15;0;0;15;287;0.05;0.0;0.0
7349_1.txt;7;1;0;8;231;0.03;0.0;0.0
11233_2.txt;0;0;0;0;145;0.0;0.0;0.0
10076_4.txt;30;2;0;32;326;0.09;0.01;0.0
4531_4.txt;18;0;0;18;207;0.09;0.0;0.0
956_1.txt;2;0;0;2;154;0.01;0.0;0.0
4870_4.txt;1;0;0;1;114;0.01;0.0;0.0
3294_3.txt;29;4;0;33;537;0.05;0.01;0.0
391_4.txt;4;0;2;6;393;0.01;0.0;0.01
1227_4.txt;2;0;0;2;264;0.01;0.0;0.0
10672_1.txt;4;0;0;4;134;0.03;0.0;0.0
4503_3.txt;6;1;0;7;294;0.02;0.0;0.0
7329_3.txt;9;0;0;9;264;0.03;0.0;0.0
10047_1.txt;0;0;0;0;195;0.0;0.0;0.0
2540_2.txt;0;4;0;4;214;0.0;0.02;0.0
35_3.txt;47;2;9;58;955;0.05;0.0;0.01
5125_1.txt;5;0;0;5;331;0.02;0.0;0.0
4615_1.txt;0;0;0;0;167;0.0;0.0;0.0
5294_4.txt;5;0;0;5;59;0.08;0.0;0.0
9942_1.txt;0;0;0;0;120;0.0;0.0;0.0
7528_2.txt;14;0;0;14;166;0.08;0.0;0.0
12233_1.txt;7;2;0;9;439;0.02;0.0;0.0
9579_4.txt;10;0;0;10;304;0.03;0.0;0.0
6387_3.txt;2;0;0;2;252;0.01;0.0;0.0
8084_4.txt;22;0;1;23;1009;0.02;0.0;0.0
10025_1.txt;23;2;0;25;545;0.04;0.0;0.0
11341_4.txt;10;0;0;10;329;0.03;0.0;0.0
3605_1.txt;0;0;0;0;114;0.0;0.0;0.0
1331_1.txt;4;0;0;4;85;0.05;0.0;0.0
3311_4.txt;8;0;0;8;324;0.02;0.0;0.0
8905_4.txt;23;0;0;23;476;0.05;0.0;0.0
5255_4.txt;0;0;0;0;147;0.0;0.0;0.0
4512_1.txt;1;2;0;3;144;0.01;0.01;0.0
7629_3.txt;1;0;0;1;153;0.01;0.0;0.0
4590_1.txt;0;2;4;6;142;0.0;0.01;0.03
860_1.txt;36;2;4;42;899;0.04;0.0;0.0
4559_1.txt;2;0;5;7;180;0.01;0.0;0.03
12451_2.txt;0;0;0;0;134;0.0;0.0;0.0
7792_1.txt;0;0;0;0;31;0.0;0.0;0.0
10022_4.txt;45;5;2;52;953;0.05;0.01;0.0
8101_1.txt;8;0;0;8;167;0.05;0.0;0.0
6734_4.txt;2;0;0;2;215;0.01;0.0;0.0
8866_1.txt;8;0;0;8;276;0.03;0.0;0.0
2434_4.txt;4;0;0;4;108;0.04;0.0;0.0
7910_2.txt;2;4;1;7;220;0.01;0.02;0.0
11478_4.txt;0;0;0;0;205;0.0;0.0;0.0
5631_2.txt;4;0;0;4;166;0.02;0.0;0.0
4236_3.txt;6;0;2;8;373;0.02;0.0;0.01
1512_2.txt;4;0;0;4;268;0.01;0.0;0.0
1933_4.txt;5;2;4;11;396;0.01;0.01;0.01
3928_3.txt;48;0;2;50;579;0.08;0.0;0.0
7352_3.txt;1;0;0;1;94;0.01;0.0;0.0
397_3.txt;11;0;0;11;608;0.02;0.0;0.0
6889_1.txt;8;0;0;8;143;0.06;0.0;0.0
10949_1.txt;0;0;0;0;129;0.0;0.0;0.0
10574_1.txt;3;0;0;3;213;0.01;0.0;0.0
1080_2.txt;5;0;0;5;151;0.03;0.0;0.0
6022_1.txt;0;1;0;1;118;0.0;0.01;0.0
11741_3.txt;8;0;0;8;169;0.05;0.0;0.0
6018_1.txt;0;0;0;0;79;0.0;0.0;0.0
9817_2.txt;0;0;0;0;137;0.0;0.0;0.0
11225_3.txt;26;1;3;30;265;0.1;0.0;0.01
1911_3.txt;2;0;0;2;115;0.02;0.0;0.0
9486_4.txt;17;3;0;20;612;0.03;0.0;0.0
8147_4.txt;2;0;0;2;135;0.01;0.0;0.0
6797_1.txt;0;1;0;1;134;0.0;0.01;0.0
11157_3.txt;15;1;0;16;500;0.03;0.0;0.0
217_3.txt;0;0;2;2;165;0.0;0.0;0.01
8402_4.txt;20;1;0;21;171;0.12;0.01;0.0
200_1.txt;2;0;1;3;168;0.01;0.0;0.01
249_3.txt;8;0;0;8;172;0.05;0.0;0.0
9111_1.txt;25;2;0;27;569;0.04;0.0;0.0
10960_1.txt;4;0;1;5;158;0.03;0.0;0.01
6894_2.txt;0;0;0;0;214;0.0;0.0;0.0
4788_3.txt;15;0;0;15;252;0.06;0.0;0.0
1736_3.txt;7;0;0;7;144;0.05;0.0;0.0
10305_4.txt;2;0;0;2;224;0.01;0.0;0.0
5887_3.txt;19;1;0;20;151;0.13;0.01;0.0
2566_1.txt;4;0;1;5;161;0.02;0.0;0.01
1240_1.txt;2;0;1;3;94;0.02;0.0;0.01
11392_1.txt;2;4;2;8;294;0.01;0.01;0.01
9254_4.txt;5;1;0;6;431;0.01;0.0;0.0
11346_2.txt;3;1;2;6;69;0.04;0.01;0.03
10536_4.txt;24;1;0;25;298;0.08;0.0;0.0
4032_4.txt;1;0;2;3;159;0.01;0.0;0.01
3327_3.txt;8;0;2;10;188;0.04;0.0;0.01
3623_3.txt;18;0;0;18;327;0.06;0.0;0.0
4479_1.txt;0;0;1;1;221;0.0;0.0;0.0
1761_1.txt;2;1;0;3;330;0.01;0.0;0.0
7064_2.txt;7;0;4;11;399;0.02;0.0;0.01
6727_4.txt;32;0;3;35;628;0.05;0.0;0.0
4770_2.txt;0;0;0;0;166;0.0;0.0;0.0
8010_1.txt;0;0;0;0;132;0.0;0.0;0.0
6827_4.txt;12;0;0;12;145;0.08;0.0;0.0
12135_1.txt;0;0;0;0;150;0.0;0.0;0.0
12093_3.txt;4;0;0;4;184;0.02;0.0;0.0
1070_1.txt;21;0;0;21;203;0.1;0.0;0.0
1763_1.txt;2;1;1;4;157;0.01;0.01;0.01
8135_2.txt;0;0;0;0;73;0.0;0.0;0.0
2163_4.txt;23;0;2;25;337;0.07;0.0;0.01
2518_4.txt;0;0;0;0;206;0.0;0.0;0.0
3766_3.txt;1;0;1;2;144;0.01;0.0;0.01
11060_1.txt;2;1;0;3;83;0.02;0.01;0.0
1793_4.txt;0;0;0;0;220;0.0;0.0;0.0
7144_2.txt;2;0;0;2;190;0.01;0.0;0.0
12180_3.txt;4;0;0;4;332;0.01;0.0;0.0
10671_1.txt;0;0;0;0;147;0.0;0.0;0.0
374_2.txt;24;1;3;28;896;0.03;0.0;0.0
10698_4.txt;29;0;0;29;431;0.07;0.0;0.0
7418_1.txt;4;0;0;4;162;0.02;0.0;0.0
6898_1.txt;0;0;0;0;173;0.0;0.0;0.0
10321_2.txt;0;0;5;5;214;0.0;0.0;0.02
672_1.txt;3;0;0;3;518;0.01;0.0;0.0
10090_1.txt;0;0;0;0;184;0.0;0.0;0.0
487_4.txt;1;2;0;3;134;0.01;0.01;0.0
8956_1.txt;0;0;0;0;142;0.0;0.0;0.0
505_2.txt;0;0;0;0;303;0.0;0.0;0.0
1685_1.txt;0;0;0;0;207;0.0;0.0;0.0
11647_2.txt;16;2;2;20;158;0.1;0.01;0.01
3063_3.txt;6;1;0;7;161;0.04;0.01;0.0
5708_1.txt;4;3;0;7;205;0.02;0.01;0.0
7693_4.txt;4;0;0;4;620;0.01;0.0;0.0
5121_2.txt;2;0;0;2;135;0.01;0.0;0.0
11674_2.txt;2;3;3;8;596;0.0;0.01;0.01
11311_4.txt;10;1;0;11;199;0.05;0.01;0.0
4103_2.txt;0;0;6;6;165;0.0;0.0;0.04
10124_1.txt;2;0;0;2;158;0.01;0.0;0.0
7460_1.txt;5;0;0;5;78;0.06;0.0;0.0
7125_3.txt;26;0;2;28;362;0.07;0.0;0.01
12048_1.txt;3;0;0;3;102;0.03;0.0;0.0
11051_1.txt;5;2;0;7;273;0.02;0.01;0.0
10139_4.txt;10;0;0;10;249;0.04;0.0;0.0
11511_1.txt;4;1;0;5;219;0.02;0.0;0.0
6434_3.txt;5;1;1;7;315;0.02;0.0;0.0
5318_2.txt;0;0;0;0;92;0.0;0.0;0.0
2651_4.txt;1;0;0;1;121;0.01;0.0;0.0
5921_4.txt;18;3;0;21;214;0.08;0.01;0.0
6097_1.txt;2;0;0;2;221;0.01;0.0;0.0
6438_1.txt;3;0;0;3;256;0.01;0.0;0.0
9120_1.txt;2;0;0;2;35;0.06;0.0;0.0
10240_1.txt;1;1;0;2;514;0.0;0.0;0.0
5897_1.txt;4;1;0;5;172;0.02;0.01;0.0
2514_3.txt;4;0;0;4;172;0.02;0.0;0.0
2444_1.txt;4;0;0;4;164;0.02;0.0;0.0
7666_2.txt;21;3;0;24;1150;0.02;0.0;0.0
10117_1.txt;0;0;0;0;212;0.0;0.0;0.0
7710_4.txt;0;0;0;0;137;0.0;0.0;0.0
5603_1.txt;0;0;0;0;59;0.0;0.0;0.0
9238_4.txt;9;0;0;9;197;0.05;0.0;0.0
7338_3.txt;3;0;0;3;180;0.02;0.0;0.0
6823_1.txt;5;1;5;11;242;0.02;0.0;0.02
6530_4.txt;12;3;0;15;152;0.08;0.02;0.0
28_2.txt;2;1;0;3;150;0.01;0.01;0.0
10514_3.txt;5;0;0;5;213;0.02;0.0;0.0
11648_2.txt;8;0;2;10;236;0.03;0.0;0.01
8432_1.txt;7;1;0;8;254;0.03;0.0;0.0
3896_1.txt;7;2;0;9;266;0.03;0.01;0.0
3615_2.txt;2;0;0;2;210;0.01;0.0;0.0
7477_4.txt;3;2;0;5;77;0.04;0.03;0.0
8670_3.txt;40;1;0;41;935;0.04;0.0;0.0
2297_4.txt;3;0;0;3;174;0.02;0.0;0.0
4535_1.txt;0;2;0;2;144;0.0;0.01;0.0
7187_4.txt;0;0;0;0;158;0.0;0.0;0.0
9320_1.txt;1;0;1;2;159;0.01;0.0;0.01
10819_3.txt;14;1;1;16;205;0.07;0.0;0.0
6892_2.txt;19;0;0;19;253;0.08;0.0;0.0
10530_4.txt;21;2;0;23;224;0.09;0.01;0.0
8534_3.txt;0;0;2;2;58;0.0;0.0;0.03
1363_1.txt;1;0;0;1;195;0.01;0.0;0.0
10668_3.txt;2;1;0;3;145;0.01;0.01;0.0
3534_1.txt;3;2;0;5;135;0.02;0.01;0.0
548_3.txt;1;0;0;1;499;0.0;0.0;0.0
8949_1.txt;9;0;0;9;275;0.03;0.0;0.0
9935_1.txt;12;2;3;17;354;0.03;0.01;0.01
6568_4.txt;31;3;9;43;513;0.06;0.01;0.02
6867_1.txt;3;2;0;5;239;0.01;0.01;0.0
4520_4.txt;12;0;1;13;143;0.08;0.0;0.01
5089_1.txt;6;0;0;6;153;0.04;0.0;0.0
4250_3.txt;0;0;0;0;93;0.0;0.0;0.0
9933_1.txt;54;1;3;58;706;0.08;0.0;0.0
6569_3.txt;3;0;4;7;338;0.01;0.0;0.01
605_4.txt;0;3;0;3;280;0.0;0.01;0.0
10901_1.txt;0;0;4;4;284;0.0;0.0;0.01
1895_3.txt;4;0;0;4;415;0.01;0.0;0.0
4939_1.txt;2;0;5;7;286;0.01;0.0;0.02
2328_3.txt;11;0;1;12;255;0.04;0.0;0.0
8611_3.txt;8;1;6;15;454;0.02;0.0;0.01
8430_3.txt;31;4;0;35;764;0.04;0.01;0.0
11747_2.txt;4;0;2;6;154;0.03;0.0;0.01
12208_2.txt;0;3;1;4;216;0.0;0.01;0.0
3396_3.txt;0;0;0;0;43;0.0;0.0;0.0
10575_3.txt;38;0;4;42;610;0.06;0.0;0.01
384_4.txt;4;2;0;6;185;0.02;0.01;0.0
169_1.txt;0;0;0;0;217;0.0;0.0;0.0
7915_4.txt;6;2;2;10;391;0.02;0.01;0.01
12265_1.txt;14;0;0;14;180;0.08;0.0;0.0
5096_4.txt;32;0;5;37;335;0.1;0.0;0.01
12155_1.txt;0;0;0;0;156;0.0;0.0;0.0
11260_4.txt;0;0;0;0;410;0.0;0.0;0.0
10704_4.txt;8;0;0;8;91;0.09;0.0;0.0
6085_3.txt;2;0;0;2;180;0.01;0.0;0.0
9229_2.txt;5;1;0;6;207;0.02;0.0;0.0
3729_2.txt;2;0;0;2;164;0.01;0.0;0.0
11627_1.txt;6;2;0;8;144;0.04;0.01;0.0
1797_4.txt;0;0;0;0;136;0.0;0.0;0.0
5795_4.txt;0;0;0;0;124;0.0;0.0;0.0
5059_4.txt;8;0;0;8;190;0.04;0.0;0.0
3500_1.txt;2;0;0;2;156;0.01;0.0;0.0
9594_1.txt;0;0;0;0;291;0.0;0.0;0.0
7667_1.txt;12;0;0;12;885;0.01;0.0;0.0
10467_1.txt;5;0;0;5;186;0.03;0.0;0.0
6252_1.txt;16;0;0;16;234;0.07;0.0;0.0
221_4.txt;4;0;0;4;211;0.02;0.0;0.0
4448_4.txt;11;2;0;13;339;0.03;0.01;0.0
6115_1.txt;24;6;1;31;826;0.03;0.01;0.0
3373_1.txt;2;0;0;2;93;0.02;0.0;0.0
3678_4.txt;20;1;0;21;453;0.04;0.0;0.0
7055_3.txt;7;0;20;27;387;0.02;0.0;0.05
5912_2.txt;5;0;4;9;183;0.03;0.0;0.02
4329_4.txt;8;2;3;13;309;0.03;0.01;0.01
8935_3.txt;58;4;1;63;1050;0.06;0.0;0.0
8954_4.txt;1;0;0;1;194;0.01;0.0;0.0
2555_2.txt;3;0;0;3;180;0.02;0.0;0.0
11309_3.txt;5;0;0;5;143;0.03;0.0;0.0
5702_1.txt;2;1;0;3;126;0.02;0.01;0.0
6860_2.txt;13;0;0;13;523;0.02;0.0;0.0
4471_4.txt;0;0;0;0;114;0.0;0.0;0.0
7464_3.txt;12;0;1;13;308;0.04;0.0;0.0
6811_4.txt;13;0;0;13;228;0.06;0.0;0.0
4844_2.txt;0;0;0;0;177;0.0;0.0;0.0
1809_1.txt;4;0;0;4;170;0.02;0.0;0.0
9842_1.txt;2;0;0;2;152;0.01;0.0;0.0
5474_3.txt;0;0;1;1;173;0.0;0.0;0.01
4163_3.txt;5;0;0;5;280;0.02;0.0;0.0
8965_1.txt;0;0;0;0;191;0.0;0.0;0.0
1662_1.txt;5;0;2;7;131;0.04;0.0;0.02
2618_1.txt;11;0;0;11;166;0.07;0.0;0.0
8294_1.txt;0;1;0;1;149;0.0;0.01;0.0
5329_1.txt;2;2;0;4;90;0.02;0.02;0.0
9240_4.txt;14;4;0;18;281;0.05;0.01;0.0
6841_1.txt;8;0;0;8;127;0.06;0.0;0.0
201_4.txt;2;0;1;3;139;0.01;0.0;0.01
1298_3.txt;4;0;0;4;160;0.03;0.0;0.0
11323_1.txt;0;0;2;2;147;0.0;0.0;0.01
7852_1.txt;0;0;3;3;490;0.0;0.0;0.01
6051_2.txt;5;0;0;5;172;0.03;0.0;0.0
6130_1.txt;8;4;0;12;256;0.03;0.02;0.0
7317_2.txt;18;1;0;19;378;0.05;0.0;0.0
3577_2.txt;5;1;0;6;197;0.03;0.01;0.0
3937_3.txt;8;0;0;8;270;0.03;0.0;0.0
5781_2.txt;1;2;2;5;251;0.0;0.01;0.01
12401_4.txt;8;0;0;8;144;0.06;0.0;0.0
5822_3.txt;26;2;0;28;594;0.04;0.0;0.0
2257_1.txt;20;2;2;24;884;0.02;0.0;0.0
8282_4.txt;20;2;0;22;256;0.08;0.01;0.0
1135_3.txt;9;1;0;10;291;0.03;0.0;0.0
10384_4.txt;0;0;0;0;188;0.0;0.0;0.0
12453_1.txt;5;0;0;5;108;0.05;0.0;0.0
5222_3.txt;0;0;0;0;81;0.0;0.0;0.0
7567_4.txt;2;2;0;4;230;0.01;0.01;0.0
9662_4.txt;1;0;0;1;260;0.0;0.0;0.0
6498_1.txt;5;0;0;5;161;0.03;0.0;0.0
577_3.txt;5;0;0;5;92;0.05;0.0;0.0
7559_1.txt;4;0;0;4;173;0.02;0.0;0.0
6154_4.txt;10;0;0;10;115;0.09;0.0;0.0
3023_1.txt;6;0;0;6;284;0.02;0.0;0.0
8036_2.txt;0;2;0;2;401;0.0;0.0;0.0
9583_4.txt;2;0;0;2;56;0.04;0.0;0.0
2681_3.txt;0;0;0;0;98;0.0;0.0;0.0
3408_4.txt;7;0;0;7;263;0.03;0.0;0.0
3852_2.txt;0;0;0;0;183;0.0;0.0;0.0
6923_2.txt;8;0;0;8;412;0.02;0.0;0.0
3292_1.txt;16;0;0;16;242;0.07;0.0;0.0
1294_1.txt;2;2;0;4;365;0.01;0.01;0.0
2386_2.txt;5;0;0;5;211;0.02;0.0;0.0
8356_4.txt;6;3;0;9;231;0.03;0.01;0.0
7479_3.txt;0;0;0;0;49;0.0;0.0;0.0
11239_1.txt;2;0;0;2;178;0.01;0.0;0.0
8419_1.txt;4;2;0;6;266;0.02;0.01;0.0
2749_1.txt;0;0;0;0;136;0.0;0.0;0.0
10597_2.txt;4;0;0;4;162;0.02;0.0;0.0
3409_1.txt;0;3;1;4;136;0.0;0.02;0.01
7016_4.txt;9;0;0;9;438;0.02;0.0;0.0
4881_1.txt;4;0;0;4;336;0.01;0.0;0.0
1177_1.txt;3;0;0;3;143;0.02;0.0;0.0
4566_1.txt;16;0;14;30;915;0.02;0.0;0.02
11278_1.txt;0;0;0;0;207;0.0;0.0;0.0
2375_2.txt;13;2;0;15;355;0.04;0.01;0.0
12173_1.txt;0;0;0;0;67;0.0;0.0;0.0
4349_2.txt;1;1;2;4;170;0.01;0.01;0.01
8803_4.txt;7;0;0;7;266;0.03;0.0;0.0
8185_2.txt;4;1;0;5;159;0.03;0.01;0.0
8067_1.txt;0;0;0;0;167;0.0;0.0;0.0
7302_3.txt;2;0;0;2;135;0.01;0.0;0.0
530_3.txt;5;0;0;5;181;0.03;0.0;0.0
3013_2.txt;6;3;0;9;265;0.02;0.01;0.0
3313_2.txt;2;0;0;2;153;0.01;0.0;0.0
6512_1.txt;9;0;0;9;245;0.04;0.0;0.0
436_1.txt;49;2;0;51;1140;0.04;0.0;0.0
8546_3.txt;3;0;0;3;376;0.01;0.0;0.0
294_4.txt;27;7;2;36;483;0.06;0.01;0.0
1808_3.txt;30;1;3;34;1163;0.03;0.0;0.0
327_3.txt;19;0;0;19;478;0.04;0.0;0.0
9545_4.txt;6;2;0;8;296;0.02;0.01;0.0
8362_1.txt;0;0;3;3;173;0.0;0.0;0.02
9537_1.txt;13;0;0;13;848;0.02;0.0;0.0
6315_1.txt;0;0;0;0;143;0.0;0.0;0.0
3967_2.txt;0;2;1;3;726;0.0;0.0;0.0
11252_1.txt;14;3;0;17;741;0.02;0.0;0.0
8748_4.txt;0;0;3;3;139;0.0;0.0;0.02
9115_1.txt;6;0;0;6;168;0.04;0.0;0.0
5808_4.txt;15;1;0;16;174;0.09;0.01;0.0
6850_3.txt;10;1;2;13;144;0.07;0.01;0.01
12357_1.txt;0;2;2;4;207;0.0;0.01;0.01
6478_1.txt;3;4;2;9;182;0.02;0.02;0.01
12174_4.txt;2;0;0;2;122;0.02;0.0;0.0
11175_2.txt;4;2;0;6;149;0.03;0.01;0.0
9476_4.txt;0;1;0;1;148;0.0;0.01;0.0
8157_4.txt;94;0;10;104;972;0.1;0.0;0.01
2487_1.txt;19;2;0;21;399;0.05;0.01;0.0
805_1.txt;2;1;0;3;111;0.02;0.01;0.0
10849_1.txt;4;0;0;4;276;0.01;0.0;0.0
10387_1.txt;0;0;0;0;37;0.0;0.0;0.0
2152_1.txt;2;4;0;6;479;0.0;0.01;0.0
6657_1.txt;0;0;0;0;141;0.0;0.0;0.0
11174_2.txt;8;0;0;8;146;0.05;0.0;0.0
11054_4.txt;9;2;0;11;755;0.01;0.0;0.0
10_2.txt;0;0;0;0;145;0.0;0.0;0.0
4940_1.txt;0;0;3;3;136;0.0;0.0;0.02
871_4.txt;17;0;1;18;222;0.08;0.0;0.0
4027_3.txt;2;0;0;2;133;0.02;0.0;0.0
12480_3.txt;26;0;0;26;633;0.04;0.0;0.0
7449_1.txt;7;0;0;7;144;0.05;0.0;0.0
8827_4.txt;0;1;1;2;192;0.0;0.01;0.01
6793_4.txt;13;0;0;13;143;0.09;0.0;0.0
834_4.txt;9;1;0;10;228;0.04;0.0;0.0
5352_4.txt;2;0;0;2;258;0.01;0.0;0.0
6627_2.txt;18;1;0;19;351;0.05;0.0;0.0
5514_4.txt;6;3;0;9;152;0.04;0.02;0.0
4637_4.txt;5;0;2;7;243;0.02;0.0;0.01
9931_4.txt;9;0;0;9;163;0.06;0.0;0.0
343_2.txt;10;2;0;12;284;0.04;0.01;0.0
7960_4.txt;1;0;1;2;118;0.01;0.0;0.01
3021_1.txt;17;3;0;20;484;0.04;0.01;0.0
3360_1.txt;15;0;0;15;579;0.03;0.0;0.0
4434_1.txt;15;0;1;16;303;0.05;0.0;0.0
12348_4.txt;7;0;0;7;135;0.05;0.0;0.0
10265_2.txt;0;2;2;4;150;0.0;0.01;0.01
4943_2.txt;0;0;0;0;155;0.0;0.0;0.0
12229_3.txt;2;0;0;2;144;0.01;0.0;0.0
3958_1.txt;3;0;0;3;183;0.02;0.0;0.0
3480_1.txt;8;1;0;9;175;0.05;0.01;0.0
6128_2.txt;0;1;0;1;118;0.0;0.01;0.0
9027_2.txt;1;0;0;1;141;0.01;0.0;0.0
9196_1.txt;1;0;0;1;243;0.0;0.0;0.0
990_1.txt;0;0;0;0;189;0.0;0.0;0.0
12323_4.txt;0;0;0;0;192;0.0;0.0;0.0
8639_3.txt;3;0;0;3;64;0.05;0.0;0.0
9201_4.txt;0;0;0;0;131;0.0;0.0;0.0
2719_4.txt;1;0;0;1;146;0.01;0.0;0.0
7006_4.txt;6;0;0;6;165;0.04;0.0;0.0
5569_4.txt;0;0;0;0;147;0.0;0.0;0.0
7848_4.txt;0;0;0;0;143;0.0;0.0;0.0
3430_4.txt;2;0;0;2;165;0.01;0.0;0.0
1648_1.txt;0;0;0;0;150;0.0;0.0;0.0
6750_1.txt;4;0;3;7;518;0.01;0.0;0.01
4181_4.txt;10;0;5;15;508;0.02;0.0;0.01
11873_1.txt;0;0;0;0;51;0.0;0.0;0.0
4223_4.txt;1;0;0;1;37;0.03;0.0;0.0
3460_1.txt;0;0;0;0;94;0.0;0.0;0.0
11428_1.txt;2;0;0;2;142;0.01;0.0;0.0
7998_1.txt;4;0;0;4;190;0.02;0.0;0.0
11082_1.txt;0;0;0;0;185;0.0;0.0;0.0
7949_2.txt;28;14;0;42;797;0.04;0.02;0.0
9632_1.txt;0;0;0;0;167;0.0;0.0;0.0
2811_3.txt;2;0;0;2;151;0.01;0.0;0.0
4461_2.txt;6;0;0;6;180;0.03;0.0;0.0
2418_2.txt;0;1;0;1;153;0.0;0.01;0.0
5581_4.txt;25;0;1;26;143;0.17;0.0;0.01
11756_2.txt;0;0;0;0;78;0.0;0.0;0.0
3510_4.txt;0;0;0;0;223;0.0;0.0;0.0
9765_1.txt;11;1;1;13;393;0.03;0.0;0.0
138_4.txt;0;0;0;0;109;0.0;0.0;0.0
5477_4.txt;12;2;0;14;276;0.04;0.01;0.0
10454_1.txt;1;0;1;2;508;0.0;0.0;0.0
6794_1.txt;2;0;0;2;80;0.03;0.0;0.0
12446_3.txt;1;0;0;1;65;0.02;0.0;0.0
9607_4.txt;0;0;0;0;310;0.0;0.0;0.0
954_4.txt;31;12;2;45;608;0.05;0.02;0.0
987_4.txt;15;1;2;18;624;0.02;0.0;0.0
3168_2.txt;6;0;0;6;184;0.03;0.0;0.0
12296_3.txt;10;0;21;31;688;0.01;0.0;0.03
11220_1.txt;0;0;0;0;141;0.0;0.0;0.0
10365_1.txt;0;0;0;0;227;0.0;0.0;0.0
11196_1.txt;2;0;0;2;116;0.02;0.0;0.0
3260_3.txt;3;0;0;3;147;0.02;0.0;0.0
2786_2.txt;10;12;5;27;635;0.02;0.02;0.01
11412_1.txt;0;2;0;2;394;0.0;0.01;0.0
10619_1.txt;6;0;0;6;149;0.04;0.0;0.0
615_1.txt;4;0;0;4;227;0.02;0.0;0.0
5539_3.txt;27;0;1;28;258;0.1;0.0;0.0
11661_1.txt;0;0;0;0;264;0.0;0.0;0.0
5110_3.txt;1;1;1;3;510;0.0;0.0;0.0
4252_4.txt;1;0;0;1;140;0.01;0.0;0.0
11442_1.txt;0;0;0;0;99;0.0;0.0;0.0
5594_2.txt;0;0;0;0;571;0.0;0.0;0.0
5673_1.txt;14;5;5;24;311;0.05;0.02;0.02
10666_4.txt;15;1;7;23;343;0.04;0.0;0.02
7857_2.txt;7;1;0;8;932;0.01;0.0;0.0
5986_2.txt;21;3;3;27;922;0.02;0.0;0.0
10860_4.txt;9;0;0;9;200;0.04;0.0;0.0
8352_1.txt;4;0;0;4;151;0.03;0.0;0.0
1785_2.txt;10;0;0;10;531;0.02;0.0;0.0
2524_4.txt;18;3;1;22;782;0.02;0.0;0.0
6424_3.txt;18;0;0;18;270;0.07;0.0;0.0
2558_1.txt;0;0;0;0;129;0.0;0.0;0.0
394_3.txt;30;0;0;30;830;0.04;0.0;0.0
2723_4.txt;10;1;0;11;419;0.02;0.0;0.0
9516_4.txt;11;0;0;11;187;0.06;0.0;0.0
10055_3.txt;9;1;0;10;418;0.02;0.0;0.0
4433_3.txt;0;2;0;2;211;0.0;0.01;0.0
2871_1.txt;0;0;0;0;142;0.0;0.0;0.0
2911_3.txt;8;0;0;8;104;0.08;0.0;0.0
68_2.txt;1;1;0;2;54;0.02;0.02;0.0
10100_1.txt;0;0;0;0;113;0.0;0.0;0.0
2724_1.txt;2;0;0;2;504;0.0;0.0;0.0
2536_1.txt;4;0;0;4;166;0.02;0.0;0.0
8521_3.txt;21;1;0;22;397;0.05;0.0;0.0
5707_2.txt;14;4;3;21;513;0.03;0.01;0.01
2001_1.txt;31;20;2;53;1118;0.03;0.02;0.0
11160_1.txt;0;0;0;0;182;0.0;0.0;0.0
3187_1.txt;4;0;0;4;75;0.05;0.0;0.0
7630_1.txt;8;2;0;10;142;0.06;0.01;0.0
4545_1.txt;17;1;5;23;247;0.07;0.0;0.02
8156_4.txt;16;0;0;16;135;0.12;0.0;0.0
13_2.txt;0;0;1;1;134;0.0;0.0;0.01
9321_1.txt;0;0;0;0;139;0.0;0.0;0.0
8348_2.txt;3;1;0;4;182;0.02;0.01;0.0
456_1.txt;2;0;2;4;131;0.02;0.0;0.02
5335_4.txt;10;1;2;13;218;0.05;0.0;0.01
501_2.txt;43;7;10;60;843;0.05;0.01;0.01
11049_1.txt;7;1;4;12;397;0.02;0.0;0.01
306_1.txt;2;0;0;2;26;0.08;0.0;0.0
6175_4.txt;0;0;0;0;163;0.0;0.0;0.0
4522_1.txt;2;0;0;2;181;0.01;0.0;0.0
4048_2.txt;2;0;2;4;163;0.01;0.0;0.01
2417_1.txt;7;0;2;9;842;0.01;0.0;0.0
4980_2.txt;5;0;0;5;262;0.02;0.0;0.0
9639_4.txt;11;0;0;11;269;0.04;0.0;0.0
7930_1.txt;11;0;0;11;152;0.07;0.0;0.0
8766_1.txt;2;2;0;4;300;0.01;0.01;0.0
5235_1.txt;1;0;0;1;252;0.0;0.0;0.0
6947_1.txt;0;0;0;0;103;0.0;0.0;0.0
3468_4.txt;6;0;0;6;382;0.02;0.0;0.0
6027_4.txt;2;0;2;4;260;0.01;0.0;0.01
2842_4.txt;10;3;2;15;426;0.02;0.01;0.0
1117_1.txt;0;0;0;0;169;0.0;0.0;0.0
4631_2.txt;7;0;3;10;168;0.04;0.0;0.02
11751_3.txt;2;0;1;3;176;0.01;0.0;0.01
4332_1.txt;2;0;0;2;133;0.02;0.0;0.0
1103_4.txt;0;0;0;0;142;0.0;0.0;0.0
4530_3.txt;3;0;0;3;121;0.02;0.0;0.0
10935_3.txt;11;3;0;14;532;0.02;0.01;0.0
4560_4.txt;1;0;4;5;227;0.0;0.0;0.02
2658_1.txt;10;0;1;11;389;0.03;0.0;0.0
4016_4.txt;0;4;2;6;119;0.0;0.03;0.02
11684_3.txt;4;1;2;7;137;0.03;0.01;0.01
10517_1.txt;19;0;2;21;930;0.02;0.0;0.0
8222_1.txt;5;2;1;8;257;0.02;0.01;0.0
1679_1.txt;19;2;0;21;485;0.04;0.0;0.0
11713_1.txt;3;0;0;3;140;0.02;0.0;0.0
9400_1.txt;0;0;0;0;91;0.0;0.0;0.0
8955_3.txt;0;0;0;0;172;0.0;0.0;0.0
6762_1.txt;7;0;0;7;119;0.06;0.0;0.0
7158_1.txt;5;0;0;5;112;0.04;0.0;0.0
10087_4.txt;5;0;0;5;102;0.05;0.0;0.0
461_1.txt;3;0;2;5;153;0.02;0.0;0.01
10925_1.txt;1;0;0;1;147;0.01;0.0;0.0
10795_1.txt;0;0;0;0;100;0.0;0.0;0.0
2317_1.txt;4;3;0;7;186;0.02;0.02;0.0
2666_1.txt;5;1;0;6;157;0.03;0.01;0.0
7903_1.txt;1;0;0;1;209;0.0;0.0;0.0
10490_1.txt;16;0;3;19;304;0.05;0.0;0.01
7332_4.txt;2;0;0;2;140;0.01;0.0;0.0
7793_1.txt;0;1;0;1;267;0.0;0.0;0.0
10685_3.txt;0;0;0;0;135;0.0;0.0;0.0
1460_1.txt;9;0;0;9;307;0.03;0.0;0.0
2869_1.txt;0;0;2;2;355;0.0;0.0;0.01
3817_1.txt;5;3;0;8;139;0.04;0.02;0.0
1683_1.txt;0;0;0;0;132;0.0;0.0;0.0
11524_2.txt;1;0;0;1;269;0.0;0.0;0.0
5959_2.txt;0;0;3;3;240;0.0;0.0;0.01
566_3.txt;0;0;0;0;54;0.0;0.0;0.0
1962_2.txt;2;0;0;2;220;0.01;0.0;0.0
9426_2.txt;4;0;0;4;128;0.03;0.0;0.0
4365_1.txt;6;0;0;6;151;0.04;0.0;0.0
552_1.txt;0;0;0;0;107;0.0;0.0;0.0
7577_4.txt;4;0;0;4;253;0.02;0.0;0.0
1774_3.txt;1;0;1;2;284;0.0;0.0;0.0
7210_1.txt;6;1;6;13;406;0.01;0.0;0.01
1380_1.txt;0;0;1;1;163;0.0;0.0;0.01
2758_1.txt;0;0;2;2;345;0.0;0.0;0.01
941_2.txt;0;0;0;0;118;0.0;0.0;0.0
621_1.txt;1;1;0;2;400;0.0;0.0;0.0
3485_3.txt;10;0;0;10;226;0.04;0.0;0.0
6384_2.txt;0;1;1;2;313;0.0;0.0;0.0
10751_1.txt;3;0;0;3;161;0.02;0.0;0.0
4396_3.txt;2;0;2;4;138;0.01;0.0;0.01
3231_1.txt;1;0;0;1;190;0.01;0.0;0.0
6641_1.txt;3;3;0;6;185;0.02;0.02;0.0
9717_3.txt;6;0;0;6;154;0.04;0.0;0.0
9885_4.txt;9;0;8;17;149;0.06;0.0;0.05
4643_4.txt;2;1;0;3;141;0.01;0.01;0.0
7674_1.txt;12;3;0;15;813;0.01;0.0;0.0
12225_1.txt;0;0;0;0;90;0.0;0.0;0.0
3426_3.txt;3;0;0;3;210;0.01;0.0;0.0
11255_1.txt;9;2;0;11;191;0.05;0.01;0.0
10377_1.txt;0;0;0;0;48;0.0;0.0;0.0
8843_3.txt;10;2;0;12;611;0.02;0.0;0.0
806_1.txt;0;0;0;0;244;0.0;0.0;0.0
416_4.txt;18;0;0;18;649;0.03;0.0;0.0
7686_1.txt;9;0;1;10;1069;0.01;0.0;0.0
11165_1.txt;0;0;0;0;139;0.0;0.0;0.0
2953_1.txt;17;2;0;19;386;0.04;0.01;0.0
1977_1.txt;1;2;1;4;209;0.0;0.01;0.0
3762_3.txt;1;0;0;1;444;0.0;0.0;0.0
6594_1.txt;0;0;9;9;151;0.0;0.0;0.06
7689_4.txt;1;0;0;1;110;0.01;0.0;0.0
8497_3.txt;19;2;2;23;392;0.05;0.01;0.01
10065_2.txt;0;0;0;0;62;0.0;0.0;0.0
4698_1.txt;1;0;0;1;159;0.01;0.0;0.0
8264_4.txt;4;0;0;4;162;0.02;0.0;0.0
307_1.txt;0;0;0;0;63;0.0;0.0;0.0
801_4.txt;4;0;0;4;183;0.02;0.0;0.0
9806_1.txt;0;0;0;0;187;0.0;0.0;0.0
5263_1.txt;2;0;0;2;214;0.01;0.0;0.0
7034_2.txt;16;6;0;22;966;0.02;0.01;0.0
1544_2.txt;0;1;0;1;74;0.0;0.01;0.0
3955_1.txt;6;0;0;6;669;0.01;0.0;0.0
359_3.txt;10;0;0;10;239;0.04;0.0;0.0
9706_1.txt;2;0;0;2;152;0.01;0.0;0.0
3616_2.txt;0;0;0;0;117;0.0;0.0;0.0
9292_3.txt;0;0;0;0;262;0.0;0.0;0.0
495_1.txt;0;0;0;0;37;0.0;0.0;0.0
7701_4.txt;4;0;0;4;130;0.03;0.0;0.0
675_3.txt;8;0;0;8;185;0.04;0.0;0.0
7768_1.txt;2;0;0;2;192;0.01;0.0;0.0
4875_3.txt;12;0;0;12;313;0.04;0.0;0.0
11945_3.txt;0;1;0;1;49;0.0;0.02;0.0
3858_1.txt;0;0;0;0;185;0.0;0.0;0.0
2180_1.txt;7;0;0;7;224;0.03;0.0;0.0
8173_1.txt;0;0;0;0;163;0.0;0.0;0.0
3619_3.txt;4;0;0;4;154;0.03;0.0;0.0
2170_4.txt;14;0;0;14;253;0.06;0.0;0.0
348_2.txt;11;0;2;13;143;0.08;0.0;0.01
4161_1.txt;0;0;0;0;118;0.0;0.0;0.0
3088_2.txt;1;2;5;8;499;0.0;0.0;0.01
8160_1.txt;0;0;0;0;137;0.0;0.0;0.0
2683_3.txt;2;3;3;8;184;0.01;0.02;0.02
11476_3.txt;0;4;0;4;874;0.0;0.0;0.0
7127_1.txt;4;4;5;13;235;0.02;0.02;0.02
9331_1.txt;1;0;0;1;182;0.01;0.0;0.0
2922_4.txt;2;1;0;3;136;0.01;0.01;0.0
1232_1.txt;8;0;2;10;893;0.01;0.0;0.0
759_1.txt;1;0;0;1;42;0.02;0.0;0.0
3161_1.txt;9;3;0;12;256;0.04;0.01;0.0
3963_2.txt;2;1;0;3;310;0.01;0.0;0.0
3478_4.txt;30;0;1;31;188;0.16;0.0;0.01
3935_1.txt;0;0;0;0;37;0.0;0.0;0.0
2864_1.txt;0;0;0;0;138;0.0;0.0;0.0
3210_3.txt;0;0;1;1;222;0.0;0.0;0.0
10527_4.txt;3;0;0;3;250;0.01;0.0;0.0
702_2.txt;7;0;0;7;201;0.03;0.0;0.0
12406_2.txt;0;0;0;0;356;0.0;0.0;0.0
3025_1.txt;15;0;0;15;191;0.08;0.0;0.0
7957_2.txt;5;0;0;5;216;0.02;0.0;0.0
11043_1.txt;0;0;0;0;65;0.0;0.0;0.0
837_1.txt;10;1;0;11;355;0.03;0.0;0.0
6967_3.txt;0;0;0;0;94;0.0;0.0;0.0
7787_4.txt;0;0;0;0;227;0.0;0.0;0.0
2361_1.txt;0;0;0;0;252;0.0;0.0;0.0
1554_4.txt;1;0;0;1;185;0.01;0.0;0.0
2770_4.txt;16;11;6;33;367;0.04;0.03;0.02
10064_3.txt;0;0;0;0;153;0.0;0.0;0.0
3825_3.txt;28;4;9;41;682;0.04;0.01;0.01
11058_1.txt;6;0;0;6;237;0.03;0.0;0.0
5024_4.txt;0;3;0;3;255;0.0;0.01;0.0
10834_4.txt;3;0;0;3;154;0.02;0.0;0.0
10369_1.txt;0;0;0;0;222;0.0;0.0;0.0
4562_1.txt;6;0;2;8;248;0.02;0.0;0.01
2066_2.txt;2;1;0;3;185;0.01;0.01;0.0
7774_3.txt;3;2;0;5;315;0.01;0.01;0.0
12460_1.txt;3;0;0;3;157;0.02;0.0;0.0
8971_3.txt;13;0;2;15;447;0.03;0.0;0.0
6188_1.txt;14;2;0;16;144;0.1;0.01;0.0
2249_2.txt;2;0;1;3;203;0.01;0.0;0.0
6833_2.txt;9;1;0;10;74;0.12;0.01;0.0
10172_1.txt;6;0;0;6;194;0.03;0.0;0.0
4288_2.txt;0;0;0;0;53;0.0;0.0;0.0
3190_1.txt;2;2;0;4;179;0.01;0.01;0.0
5223_1.txt;1;1;0;2;100;0.01;0.01;0.0
7429_1.txt;3;0;0;3;627;0.0;0.0;0.0
10033_1.txt;1;0;0;1;182;0.01;0.0;0.0
6282_4.txt;17;1;0;18;528;0.03;0.0;0.0
184_2.txt;8;8;1;17;141;0.06;0.06;0.01
2473_1.txt;1;0;0;1;161;0.01;0.0;0.0
4896_3.txt;0;0;0;0;183;0.0;0.0;0.0
5341_1.txt;1;0;0;1;133;0.01;0.0;0.0
1667_1.txt;2;1;0;3;150;0.01;0.01;0.0
8780_4.txt;20;1;3;24;349;0.06;0.0;0.01
4539_1.txt;2;0;1;3;197;0.01;0.0;0.01
10904_3.txt;0;0;0;0;85;0.0;0.0;0.0
4951_1.txt;3;1;1;5;364;0.01;0.0;0.0
6017_2.txt;0;1;0;1;111;0.0;0.01;0.0
2489_2.txt;12;1;0;13;320;0.04;0.0;0.0
4307_1.txt;0;0;0;0;143;0.0;0.0;0.0
8148_1.txt;6;1;0;7;155;0.04;0.01;0.0
9311_1.txt;1;0;0;1;132;0.01;0.0;0.0
4752_1.txt;2;0;1;3;124;0.02;0.0;0.01
8202_4.txt;2;0;0;2;263;0.01;0.0;0.0
2055_1.txt;12;2;3;17;143;0.08;0.01;0.02
4831_4.txt;4;1;0;5;315;0.01;0.0;0.0
7096_1.txt;2;0;0;2;170;0.01;0.0;0.0
4926_4.txt;9;2;0;11;140;0.06;0.01;0.0
3913_1.txt;2;0;0;2;98;0.02;0.0;0.0
1109_1.txt;9;0;0;9;298;0.03;0.0;0.0
9495_1.txt;10;3;0;13;223;0.04;0.01;0.0
764_2.txt;2;0;1;3;223;0.01;0.0;0.0
4787_3.txt;0;0;0;0;73;0.0;0.0;0.0
4620_1.txt;0;0;0;0;52;0.0;0.0;0.0
5983_4.txt;5;0;0;5;221;0.02;0.0;0.0
2986_4.txt;2;1;0;3;515;0.0;0.0;0.0
3462_1.txt;0;0;0;0;134;0.0;0.0;0.0
89_2.txt;9;1;0;10;258;0.03;0.0;0.0
5314_1.txt;1;1;0;2;256;0.0;0.0;0.0
12031_1.txt;0;0;0;0;146;0.0;0.0;0.0
933_2.txt;6;0;0;6;164;0.04;0.0;0.0
8496_4.txt;0;1;0;1;326;0.0;0.0;0.0
9923_2.txt;11;1;0;12;197;0.06;0.01;0.0
7569_3.txt;4;2;2;8;210;0.02;0.01;0.01
6623_1.txt;20;4;3;27;378;0.05;0.01;0.01
12051_2.txt;7;0;0;7;245;0.03;0.0;0.0
542_4.txt;6;0;0;6;153;0.04;0.0;0.0
11743_3.txt;0;0;0;0;92;0.0;0.0;0.0
6670_4.txt;5;1;0;6;218;0.02;0.0;0.0
9058_3.txt;31;4;0;35;471;0.07;0.01;0.0
8180_4.txt;0;0;0;0;124;0.0;0.0;0.0
8751_2.txt;0;2;1;3;159;0.0;0.01;0.01
6398_2.txt;8;0;0;8;156;0.05;0.0;0.0
10416_2.txt;8;0;0;8;123;0.07;0.0;0.0
3575_1.txt;6;0;0;6;68;0.09;0.0;0.0
7887_1.txt;0;0;0;0;242;0.0;0.0;0.0
3440_1.txt;0;0;0;0;143;0.0;0.0;0.0
3894_3.txt;1;0;0;1;228;0.0;0.0;0.0
10054_1.txt;6;0;0;6;183;0.03;0.0;0.0
2982_1.txt;10;3;2;15;926;0.01;0.0;0.0
5515_3.txt;3;0;0;3;235;0.01;0.0;0.0
9852_1.txt;0;0;0;0;185;0.0;0.0;0.0
4138_1.txt;0;0;0;0;145;0.0;0.0;0.0
10417_1.txt;2;0;1;3;370;0.01;0.0;0.0
12011_4.txt;9;0;1;10;188;0.05;0.0;0.01
1732_4.txt;27;0;0;27;388;0.07;0.0;0.0
6543_1.txt;2;0;0;2;208;0.01;0.0;0.0
9855_2.txt;0;0;0;0;185;0.0;0.0;0.0
10495_1.txt;2;0;0;2;132;0.02;0.0;0.0
4299_2.txt;5;0;0;5;151;0.03;0.0;0.0
4855_3.txt;3;4;2;9;586;0.01;0.01;0.0
10547_1.txt;0;0;1;1;97;0.0;0.0;0.01
9576_1.txt;0;0;0;0;57;0.0;0.0;0.0
2087_4.txt;25;0;0;25;500;0.05;0.0;0.0
3624_2.txt;18;0;1;19;864;0.02;0.0;0.0
9586_3.txt;4;1;0;5;153;0.03;0.01;0.0
4628_2.txt;4;0;0;4;168;0.02;0.0;0.0
255_3.txt;27;2;0;29;973;0.03;0.0;0.0
6981_1.txt;16;0;0;16;736;0.02;0.0;0.0
6606_3.txt;25;2;6;33;394;0.06;0.01;0.02
11123_2.txt;28;0;3;31;558;0.05;0.0;0.01
12231_3.txt;2;0;0;2;247;0.01;0.0;0.0
7681_4.txt;4;0;0;4;83;0.05;0.0;0.0
2218_1.txt;6;0;0;6;365;0.02;0.0;0.0
854_1.txt;3;0;0;3;203;0.01;0.0;0.0
9255_2.txt;17;3;1;21;584;0.03;0.01;0.0
2045_1.txt;0;0;0;0;160;0.0;0.0;0.0
10360_3.txt;0;0;0;0;166;0.0;0.0;0.0
1214_3.txt;4;1;0;5;328;0.01;0.0;0.0
857_1.txt;9;0;1;10;383;0.02;0.0;0.0
879_2.txt;18;4;3;25;448;0.04;0.01;0.01
11538_1.txt;12;3;12;27;416;0.03;0.01;0.03
366_1.txt;9;0;5;14;483;0.02;0.0;0.01
4147_1.txt;0;0;0;0;227;0.0;0.0;0.0
8262_1.txt;0;0;0;0;132;0.0;0.0;0.0
2430_3.txt;30;3;13;46;1085;0.03;0.0;0.01
5310_1.txt;2;0;0;2;176;0.01;0.0;0.0
6441_1.txt;2;0;3;5;272;0.01;0.0;0.01
6674_3.txt;4;0;0;4;402;0.01;0.0;0.0
7136_3.txt;2;0;0;2;147;0.01;0.0;0.0
10230_1.txt;0;0;0;0;134;0.0;0.0;0.0
10142_2.txt;30;7;0;37;648;0.05;0.01;0.0
37_3.txt;5;1;3;9;327;0.02;0.0;0.01
12086_2.txt;5;0;0;5;98;0.05;0.0;0.0
8208_2.txt;0;1;1;2;276;0.0;0.0;0.0
5565_3.txt;31;0;0;31;547;0.06;0.0;0.0
4900_2.txt;4;1;1;6;369;0.01;0.0;0.0
5444_1.txt;18;1;0;19;483;0.04;0.0;0.0
2150_4.txt;8;0;0;8;262;0.03;0.0;0.0
769_1.txt;2;0;0;2;178;0.01;0.0;0.0
5197_4.txt;10;3;0;13;142;0.07;0.02;0.0
29_4.txt;11;4;0;15;563;0.02;0.01;0.0
6810_1.txt;0;0;0;0;164;0.0;0.0;0.0
228_1.txt;1;0;0;1;298;0.0;0.0;0.0
6600_1.txt;13;0;3;16;353;0.04;0.0;0.01
1643_1.txt;0;0;0;0;119;0.0;0.0;0.0
7509_1.txt;21;6;4;31;430;0.05;0.01;0.01
3650_2.txt;1;0;0;1;255;0.0;0.0;0.0
4059_2.txt;15;1;2;18;126;0.12;0.01;0.02
5592_2.txt;10;0;0;10;503;0.02;0.0;0.0
4513_1.txt;0;2;0;2;176;0.0;0.01;0.0
248_4.txt;0;0;0;0;84;0.0;0.0;0.0
9841_4.txt;16;0;0;16;408;0.04;0.0;0.0
9067_3.txt;4;0;0;4;307;0.01;0.0;0.0
5618_4.txt;0;0;0;0;291;0.0;0.0;0.0
7849_2.txt;2;0;2;4;280;0.01;0.0;0.01
2832_4.txt;30;2;4;36;406;0.07;0.0;0.01
6748_4.txt;3;0;0;3;142;0.02;0.0;0.0
1345_4.txt;10;0;3;13;681;0.01;0.0;0.0
4499_1.txt;3;1;0;4;163;0.02;0.01;0.0
9824_4.txt;0;1;0;1;212;0.0;0.0;0.0
8439_3.txt;24;4;8;36;627;0.04;0.01;0.01
4633_3.txt;39;0;0;39;707;0.06;0.0;0.0
2157_1.txt;6;0;6;12;252;0.02;0.0;0.02
1082_1.txt;2;0;0;2;199;0.01;0.0;0.0
8808_1.txt;8;1;2;11;365;0.02;0.0;0.01
8518_2.txt;6;0;0;6;145;0.04;0.0;0.0
11486_4.txt;15;0;0;15;392;0.04;0.0;0.0
9268_3.txt;52;2;10;64;816;0.06;0.0;0.01
7555_2.txt;2;0;0;2;140;0.01;0.0;0.0
3236_4.txt;0;0;0;0;536;0.0;0.0;0.0
2838_2.txt;1;0;2;3;116;0.01;0.0;0.02
2356_4.txt;14;0;0;14;146;0.1;0.0;0.0
3272_4.txt;5;0;0;5;169;0.03;0.0;0.0
1573_1.txt;1;0;0;1;135;0.01;0.0;0.0
10765_1.txt;22;2;3;27;451;0.05;0.0;0.01
813_3.txt;3;0;0;3;126;0.02;0.0;0.0
8597_1.txt;0;0;0;0;57;0.0;0.0;0.0
270_1.txt;0;1;0;1;125;0.0;0.01;0.0
12261_4.txt;2;0;0;2;300;0.01;0.0;0.0
6638_4.txt;5;2;5;12;238;0.02;0.01;0.02
1447_3.txt;8;2;0;10;161;0.05;0.01;0.0
7519_2.txt;11;1;0;12;546;0.02;0.0;0.0
4593_1.txt;0;0;0;0;488;0.0;0.0;0.0
9887_2.txt;15;0;0;15;624;0.02;0.0;0.0
2162_3.txt;13;0;1;14;181;0.07;0.0;0.01
5764_1.txt;0;1;3;4;194;0.0;0.01;0.02
8564_2.txt;3;0;0;3;129;0.02;0.0;0.0
5491_1.txt;1;0;0;1;148;0.01;0.0;0.0
3736_2.txt;4;0;0;4;124;0.03;0.0;0.0
1251_4.txt;3;0;0;3;42;0.07;0.0;0.0
1474_4.txt;54;4;0;58;660;0.08;0.01;0.0
11097_2.txt;0;0;0;0;97;0.0;0.0;0.0
2910_4.txt;15;0;0;15;357;0.04;0.0;0.0
11111_1.txt;2;0;0;2;250;0.01;0.0;0.0
10716_3.txt;20;3;0;23;870;0.02;0.0;0.0
8220_1.txt;0;0;0;0;699;0.0;0.0;0.0
185_4.txt;24;9;3;36;581;0.04;0.02;0.01
11861_4.txt;4;0;3;7;833;0.0;0.0;0.0
10809_1.txt;0;0;0;0;67;0.0;0.0;0.0
1504_3.txt;30;0;0;30;518;0.06;0.0;0.0
12028_2.txt;2;0;0;2;114;0.02;0.0;0.0
9783_4.txt;0;0;0;0;339;0.0;0.0;0.0
5157_1.txt;4;0;0;4;111;0.04;0.0;0.0
9767_3.txt;0;0;0;0;165;0.0;0.0;0.0
560_1.txt;16;3;1;20;488;0.03;0.01;0.0
10260_1.txt;0;0;0;0;71;0.0;0.0;0.0
1299_1.txt;3;1;0;4;126;0.02;0.01;0.0
9488_2.txt;9;0;2;11;371;0.02;0.0;0.01
3985_4.txt;23;1;0;24;206;0.11;0.0;0.0
4823_3.txt;0;0;1;1;183;0.0;0.0;0.01
5691_1.txt;28;2;3;33;930;0.03;0.0;0.0
5017_4.txt;9;1;0;10;182;0.05;0.01;0.0
4938_1.txt;0;0;3;3;173;0.0;0.0;0.02
2288_3.txt;13;5;0;18;323;0.04;0.02;0.0
5412_2.txt;21;1;0;22;195;0.11;0.01;0.0
11879_1.txt;2;0;1;3;314;0.01;0.0;0.0
9360_1.txt;0;0;0;0;185;0.0;0.0;0.0
4997_2.txt;7;0;1;8;173;0.04;0.0;0.01
4030_4.txt;2;1;0;3;216;0.01;0.0;0.0
2740_1.txt;9;0;2;11;572;0.02;0.0;0.0
7301_3.txt;3;0;0;3;218;0.01;0.0;0.0
8626_1.txt;0;1;0;1;181;0.0;0.01;0.0
6069_3.txt;11;3;0;14;251;0.04;0.01;0.0
7139_1.txt;0;0;0;0;173;0.0;0.0;0.0
7911_3.txt;9;2;1;12;498;0.02;0.0;0.0
3444_1.txt;6;0;0;6;429;0.01;0.0;0.0
5914_1.txt;4;1;0;5;210;0.02;0.0;0.0
12103_3.txt;9;0;0;9;468;0.02;0.0;0.0
11670_1.txt;15;0;3;18;617;0.02;0.0;0.0
7202_1.txt;0;0;0;0;71;0.0;0.0;0.0
1107_1.txt;5;0;0;5;137;0.04;0.0;0.0
9922_4.txt;16;0;2;18;306;0.05;0.0;0.01
3024_1.txt;2;0;0;2;482;0.0;0.0;0.0
6609_1.txt;2;1;0;3;390;0.01;0.0;0.0
9838_1.txt;0;0;0;0;281;0.0;0.0;0.0
1675_4.txt;4;0;0;4;156;0.03;0.0;0.0
3027_1.txt;5;0;0;5;169;0.03;0.0;0.0
7101_2.txt;8;0;0;8;210;0.04;0.0;0.0
8054_1.txt;2;0;0;2;130;0.02;0.0;0.0
9799_1.txt;0;0;2;2;106;0.0;0.0;0.02
7692_2.txt;10;0;0;10;572;0.02;0.0;0.0
790_1.txt;2;0;0;2;93;0.02;0.0;0.0
9938_3.txt;5;0;2;7;180;0.03;0.0;0.01
3870_3.txt;2;1;0;3;145;0.01;0.01;0.0
10730_1.txt;0;2;0;2;194;0.0;0.01;0.0
12200_4.txt;4;0;0;4;118;0.03;0.0;0.0
6008_1.txt;13;3;0;16;271;0.05;0.01;0.0
2046_1.txt;0;0;0;0;139;0.0;0.0;0.0
11921_2.txt;2;0;0;2;175;0.01;0.0;0.0
11187_2.txt;0;0;2;2;287;0.0;0.0;0.01
7890_1.txt;0;0;0;0;146;0.0;0.0;0.0
1826_3.txt;2;0;0;2;139;0.01;0.0;0.0
5656_1.txt;5;0;0;5;187;0.03;0.0;0.0
4829_2.txt;0;0;0;0;233;0.0;0.0;0.0
9809_2.txt;9;0;3;12;224;0.04;0.0;0.01
8735_4.txt;3;0;0;3;249;0.01;0.0;0.0
5807_1.txt;0;0;0;0;123;0.0;0.0;0.0
11931_2.txt;3;3;0;6;52;0.06;0.06;0.0
7109_2.txt;7;0;0;7;286;0.02;0.0;0.0
3568_4.txt;14;0;0;14;170;0.08;0.0;0.0
6356_1.txt;3;0;0;3;244;0.01;0.0;0.0
10554_1.txt;2;0;0;2;151;0.01;0.0;0.0
1754_3.txt;15;1;5;21;155;0.1;0.01;0.03
2435_1.txt;4;0;0;4;234;0.02;0.0;0.0
11152_1.txt;0;0;0;0;152;0.0;0.0;0.0
2206_2.txt;3;0;0;3;151;0.02;0.0;0.0
10488_1.txt;17;0;0;17;217;0.08;0.0;0.0
9200_3.txt;1;1;0;2;114;0.01;0.01;0.0
3040_1.txt;0;0;0;0;123;0.0;0.0;0.0
8238_1.txt;1;0;0;1;245;0.0;0.0;0.0
9190_1.txt;1;0;0;1;160;0.01;0.0;0.0
4270_1.txt;14;1;0;15;181;0.08;0.01;0.0
5824_1.txt;0;0;0;0;136;0.0;0.0;0.0
4231_1.txt;0;0;0;0;271;0.0;0.0;0.0
11706_3.txt;17;3;1;21;450;0.04;0.01;0.0
886_1.txt;0;23;0;23;250;0.0;0.09;0.0
602_1.txt;0;2;5;7;156;0.0;0.01;0.03
9968_4.txt;3;0;0;3;126;0.02;0.0;0.0
9604_3.txt;8;0;0;8;309;0.03;0.0;0.0
1335_4.txt;6;0;0;6;88;0.07;0.0;0.0
10452_1.txt;2;0;0;2;263;0.01;0.0;0.0
2012_2.txt;4;1;0;5;369;0.01;0.0;0.0
10713_1.txt;4;3;0;7;137;0.03;0.02;0.0
1928_1.txt;14;1;0;15;376;0.04;0.0;0.0
10143_1.txt;8;0;0;8;189;0.04;0.0;0.0
5406_4.txt;0;0;0;0;139;0.0;0.0;0.0
10553_1.txt;0;0;0;0;153;0.0;0.0;0.0
1686_1.txt;2;0;0;2;275;0.01;0.0;0.0
3344_1.txt;3;0;0;3;142;0.02;0.0;0.0
393_2.txt;2;2;4;8;214;0.01;0.01;0.02
1287_3.txt;9;2;3;14;731;0.01;0.0;0.0
6030_1.txt;10;3;0;13;657;0.02;0.0;0.0
6653_3.txt;15;0;0;15;237;0.06;0.0;0.0
3576_1.txt;3;0;0;3;109;0.03;0.0;0.0
937_1.txt;9;2;3;14;680;0.01;0.0;0.0
8580_4.txt;11;2;0;13;616;0.02;0.0;0.0
5066_1.txt;0;0;0;0;179;0.0;0.0;0.0
1790_4.txt;7;0;0;7;153;0.05;0.0;0.0
1702_1.txt;8;1;0;9;245;0.03;0.0;0.0
11691_4.txt;10;2;0;12;544;0.02;0.0;0.0
1190_1.txt;8;1;2;11;141;0.06;0.01;0.01
6884_4.txt;59;6;3;68;1150;0.05;0.01;0.0
945_2.txt;31;0;2;33;697;0.04;0.0;0.0
2074_1.txt;8;0;1;9;682;0.01;0.0;0.0
5770_1.txt;0;0;0;0;223;0.0;0.0;0.0
12217_4.txt;3;0;0;3;248;0.01;0.0;0.0
3095_1.txt;2;0;2;4;302;0.01;0.0;0.01
940_1.txt;0;1;0;1;222;0.0;0.0;0.0
11487_3.txt;20;0;2;22;480;0.04;0.0;0.0
4623_4.txt;1;0;0;1;302;0.0;0.0;0.0
539_4.txt;55;3;11;69;1134;0.05;0.0;0.01
5904_3.txt;0;0;0;0;305;0.0;0.0;0.0
4580_1.txt;13;0;0;13;241;0.05;0.0;0.0
1321_1.txt;5;0;0;5;210;0.02;0.0;0.0
7917_4.txt;0;1;0;1;132;0.0;0.01;0.0
11216_4.txt;0;0;0;0;138;0.0;0.0;0.0
8865_4.txt;69;14;1;84;1022;0.07;0.01;0.0
6205_1.txt;3;0;0;3;201;0.01;0.0;0.0
5769_3.txt;2;0;0;2;236;0.01;0.0;0.0
1188_4.txt;1;1;0;2;70;0.01;0.01;0.0
5343_1.txt;1;0;2;3;50;0.02;0.0;0.04
38_2.txt;24;1;0;25;373;0.06;0.0;0.0
11166_1.txt;5;2;2;9;326;0.02;0.01;0.01
11325_4.txt;21;3;1;25;176;0.12;0.02;0.01
5775_3.txt;0;0;0;0;143;0.0;0.0;0.0
2742_4.txt;0;0;0;0;216;0.0;0.0;0.0
9167_4.txt;17;6;2;25;563;0.03;0.01;0.0
1253_3.txt;0;1;1;2;83;0.0;0.01;0.01
11598_4.txt;3;0;0;3;119;0.03;0.0;0.0
5179_4.txt;2;0;4;6;242;0.01;0.0;0.02
316_1.txt;4;0;0;4;137;0.03;0.0;0.0
2400_3.txt;8;4;0;12;302;0.03;0.01;0.0
12492_4.txt;2;0;1;3;121;0.02;0.0;0.01
4193_3.txt;32;4;6;42;690;0.05;0.01;0.01
10549_2.txt;6;0;0;6;210;0.03;0.0;0.0
2613_2.txt;4;2;0;6;149;0.03;0.01;0.0
10658_4.txt;24;9;2;35;875;0.03;0.01;0.0
5997_3.txt;30;0;0;30;538;0.06;0.0;0.0
11229_1.txt;0;0;0;0;165;0.0;0.0;0.0
1455_1.txt;7;2;0;9;281;0.02;0.01;0.0
3162_1.txt;0;0;0;0;157;0.0;0.0;0.0
12167_1.txt;4;0;1;5;113;0.04;0.0;0.01
4449_4.txt;10;0;4;14;133;0.08;0.0;0.03
12111_2.txt;12;0;0;12;805;0.01;0.0;0.0
7467_1.txt;21;0;4;25;473;0.04;0.0;0.01
4065_4.txt;4;0;0;4;363;0.01;0.0;0.0
10546_1.txt;0;0;1;1;88;0.0;0.0;0.01
10461_1.txt;0;0;0;0;142;0.0;0.0;0.0
5601_4.txt;11;2;0;13;137;0.08;0.01;0.0
665_3.txt;17;5;0;22;221;0.08;0.02;0.0
4228_1.txt;1;0;0;1;152;0.01;0.0;0.0
9930_1.txt;10;0;1;11;132;0.08;0.0;0.01
2112_3.txt;4;0;0;4;373;0.01;0.0;0.0
11643_2.txt;2;0;2;4;156;0.01;0.0;0.01
425_2.txt;3;4;1;8;306;0.01;0.01;0.0
4626_4.txt;6;0;0;6;490;0.01;0.0;0.0
6698_2.txt;7;3;7;17;648;0.01;0.0;0.01
10859_4.txt;12;0;0;12;154;0.08;0.0;0.0
5969_3.txt;5;2;2;9;355;0.01;0.01;0.01
315_1.txt;2;0;4;6;143;0.01;0.0;0.03
5094_3.txt;0;0;0;0;217;0.0;0.0;0.0
10916_3.txt;0;0;0;0;263;0.0;0.0;0.0
6596_1.txt;4;2;5;11;246;0.02;0.01;0.02
9074_1.txt;2;0;0;2;218;0.01;0.0;0.0
1658_1.txt;2;3;0;5;155;0.01;0.02;0.0
7767_2.txt;5;0;1;6;257;0.02;0.0;0.0
10385_3.txt;13;1;0;14;649;0.02;0.0;0.0
6105_2.txt;0;0;0;0;176;0.0;0.0;0.0
7742_3.txt;4;2;5;11;487;0.01;0.0;0.01
8190_4.txt;31;6;1;38;513;0.06;0.01;0.0
11198_1.txt;3;0;4;7;322;0.01;0.0;0.01
6163_2.txt;4;0;0;4;160;0.03;0.0;0.0
5799_1.txt;0;0;2;2;281;0.0;0.0;0.01
1923_4.txt;19;0;0;19;298;0.06;0.0;0.0
8073_1.txt;0;0;0;0;108;0.0;0.0;0.0
274_2.txt;5;4;3;12;299;0.02;0.01;0.01
1846_3.txt;2;1;0;3;156;0.01;0.01;0.0
10643_1.txt;4;0;0;4;98;0.04;0.0;0.0
5298_2.txt;0;0;0;0;226;0.0;0.0;0.0
1715_3.txt;7;0;0;7;256;0.03;0.0;0.0
5748_4.txt;7;0;0;7;198;0.04;0.0;0.0
12177_3.txt;22;4;0;26;434;0.05;0.01;0.0
5935_4.txt;10;0;0;10;365;0.03;0.0;0.0
11135_2.txt;0;0;0;0;202;0.0;0.0;0.0
11363_1.txt;0;3;0;3;147;0.0;0.02;0.0
576_3.txt;2;0;0;2;71;0.03;0.0;0.0
10248_1.txt;13;1;1;15;229;0.06;0.0;0.0
3404_2.txt;0;0;1;1;202;0.0;0.0;0.0
1897_2.txt;0;0;2;2;64;0.0;0.0;0.03
444_4.txt;12;0;2;14;386;0.03;0.0;0.01
6462_2.txt;3;1;0;4;132;0.02;0.01;0.0
2306_1.txt;0;0;0;0;151;0.0;0.0;0.0
10743_2.txt;0;0;0;0;87;0.0;0.0;0.0
1467_3.txt;20;3;0;23;368;0.05;0.01;0.0
4037_2.txt;0;0;0;0;143;0.0;0.0;0.0
9451_1.txt;3;0;0;3;137;0.02;0.0;0.0
10991_1.txt;3;0;0;3;180;0.02;0.0;0.0
3395_4.txt;2;0;0;2;62;0.03;0.0;0.0
7047_2.txt;2;0;0;2;111;0.02;0.0;0.0
12170_3.txt;3;0;0;3;156;0.02;0.0;0.0
1166_2.txt;0;0;0;0;144;0.0;0.0;0.0
7299_1.txt;0;0;0;0;150;0.0;0.0;0.0
734_2.txt;8;0;0;8;329;0.02;0.0;0.0
9086_3.txt;15;1;0;16;424;0.04;0.0;0.0
9721_2.txt;0;0;0;0;75;0.0;0.0;0.0
4469_2.txt;2;0;0;2;639;0.0;0.0;0.0
4052_1.txt;13;3;3;19;558;0.02;0.01;0.01
1147_4.txt;8;1;7;16;158;0.05;0.01;0.04
3335_1.txt;11;0;0;11;183;0.06;0.0;0.0
11872_1.txt;0;0;0;0;87;0.0;0.0;0.0
2229_1.txt;0;0;0;0;132;0.0;0.0;0.0
1597_3.txt;5;0;0;5;353;0.01;0.0;0.0
4392_3.txt;0;0;0;0;122;0.0;0.0;0.0
8992_4.txt;0;0;0;0;188;0.0;0.0;0.0
5332_3.txt;23;1;5;29;346;0.07;0.0;0.01
2437_3.txt;1;1;5;7;377;0.0;0.0;0.01
5100_4.txt;0;0;0;0;147;0.0;0.0;0.0
7604_1.txt;1;0;0;1;240;0.0;0.0;0.0
8852_3.txt;9;1;2;12;398;0.02;0.0;0.01
4082_3.txt;14;0;0;14;380;0.04;0.0;0.0
7469_3.txt;9;0;0;9;143;0.06;0.0;0.0
182_1.txt;0;0;0;0;140;0.0;0.0;0.0
4070_1.txt;0;0;0;0;164;0.0;0.0;0.0
3783_4.txt;25;6;3;34;310;0.08;0.02;0.01
8892_2.txt;13;0;0;13;169;0.08;0.0;0.0
334_4.txt;9;0;0;9;285;0.03;0.0;0.0
7385_1.txt;1;0;0;1;184;0.01;0.0;0.0
1426_1.txt;0;0;6;6;362;0.0;0.0;0.02
4910_1.txt;4;3;0;7;366;0.01;0.01;0.0
9166_1.txt;6;1;0;7;656;0.01;0.0;0.0
8447_3.txt;19;0;0;19;552;0.03;0.0;0.0
1438_4.txt;7;2;0;9;335;0.02;0.01;0.0
9223_3.txt;1;0;0;1;80;0.01;0.0;0.0
7733_1.txt;2;0;0;2;234;0.01;0.0;0.0
5554_3.txt;11;1;0;12;416;0.03;0.0;0.0
10314_4.txt;6;2;0;8;231;0.03;0.01;0.0
3699_3.txt;0;0;0;0;79;0.0;0.0;0.0
9605_3.txt;1;1;2;4;190;0.01;0.01;0.01
1074_4.txt;2;1;0;3;103;0.02;0.01;0.0
3223_3.txt;2;10;0;12;251;0.01;0.04;0.0
7782_2.txt;22;4;0;26;455;0.05;0.01;0.0
285_3.txt;7;0;0;7;246;0.03;0.0;0.0
4128_1.txt;0;0;0;0;120;0.0;0.0;0.0
4635_4.txt;15;0;2;17;564;0.03;0.0;0.0
2610_3.txt;4;0;0;4;90;0.04;0.0;0.0
209_1.txt;5;1;0;6;136;0.04;0.01;0.0
8944_1.txt;4;0;0;4;192;0.02;0.0;0.0
12099_4.txt;18;8;15;41;699;0.03;0.01;0.02
8252_3.txt;2;2;0;4;185;0.01;0.01;0.0
8609_3.txt;6;0;0;6;115;0.05;0.0;0.0
3354_2.txt;4;0;0;4;207;0.02;0.0;0.0
2178_3.txt;11;0;0;11;157;0.07;0.0;0.0
2440_1.txt;7;0;0;7;147;0.05;0.0;0.0
4049_3.txt;16;0;0;16;401;0.04;0.0;0.0
11650_1.txt;0;0;0;0;320;0.0;0.0;0.0
2936_3.txt;0;0;0;0;155;0.0;0.0;0.0
9979_1.txt;0;1;0;1;38;0.0;0.03;0.0
4843_3.txt;2;2;0;4;300;0.01;0.01;0.0
8682_3.txt;5;0;0;5;195;0.03;0.0;0.0
5669_1.txt;1;0;0;1;155;0.01;0.0;0.0
10323_1.txt;2;0;0;2;234;0.01;0.0;0.0
8122_3.txt;2;0;0;2;89;0.02;0.0;0.0
2273_4.txt;2;0;0;2;142;0.01;0.0;0.0
4636_3.txt;13;0;0;13;243;0.05;0.0;0.0
8086_2.txt;5;3;0;8;287;0.02;0.01;0.0
7847_3.txt;2;3;6;11;551;0.0;0.01;0.01
6456_1.txt;0;0;0;0;146;0.0;0.0;0.0
7731_4.txt;8;2;0;10;273;0.03;0.01;0.0
3338_1.txt;0;2;0;2;185;0.0;0.01;0.0
8351_4.txt;11;0;0;11;148;0.07;0.0;0.0
8663_4.txt;22;0;3;25;345;0.06;0.0;0.01
2469_2.txt;0;0;1;1;153;0.0;0.0;0.01
4369_3.txt;15;2;0;17;403;0.04;0.0;0.0
7954_2.txt;4;0;0;4;137;0.03;0.0;0.0
965_4.txt;16;0;0;16;286;0.06;0.0;0.0
4996_3.txt;6;2;4;12;153;0.04;0.01;0.03
12358_1.txt;2;0;0;2;100;0.02;0.0;0.0
1709_3.txt;1;0;0;1;260;0.0;0.0;0.0
331_1.txt;5;1;0;6;225;0.02;0.0;0.0
2010_3.txt;1;0;0;1;179;0.01;0.0;0.0
11550_4.txt;4;0;0;4;196;0.02;0.0;0.0
6426_4.txt;0;0;0;0;131;0.0;0.0;0.0
11481_1.txt;2;0;0;2;185;0.01;0.0;0.0
4315_4.txt;29;0;0;29;495;0.06;0.0;0.0
3942_1.txt;1;0;0;1;147;0.01;0.0;0.0
7295_2.txt;8;0;0;8;214;0.04;0.0;0.0
2183_2.txt;2;0;0;2;174;0.01;0.0;0.0
10807_1.txt;1;2;0;3;214;0.0;0.01;0.0
2528_2.txt;0;1;0;1;91;0.0;0.01;0.0
483_2.txt;2;0;0;2;313;0.01;0.0;0.0
1626_1.txt;0;2;0;2;131;0.0;0.02;0.0
12360_4.txt;5;0;0;5;145;0.03;0.0;0.0
5823_2.txt;0;0;0;0;378;0.0;0.0;0.0
12224_3.txt;4;0;0;4;130;0.03;0.0;0.0
1212_1.txt;0;0;0;0;276;0.0;0.0;0.0
6081_4.txt;7;2;0;9;269;0.03;0.01;0.0
7682_2.txt;24;0;0;24;218;0.11;0.0;0.0
10233_1.txt;2;1;0;3;203;0.01;0.0;0.0
1502_1.txt;5;0;0;5;87;0.06;0.0;0.0
11164_1.txt;2;0;0;2;123;0.02;0.0;0.0
8848_3.txt;9;6;0;15;302;0.03;0.02;0.0
11149_3.txt;3;0;0;3;650;0.0;0.0;0.0
2123_3.txt;2;2;1;5;181;0.01;0.01;0.01
3245_4.txt;21;0;0;21;712;0.03;0.0;0.0
3323_1.txt;0;0;0;0;166;0.0;0.0;0.0
3916_3.txt;7;1;1;9;296;0.02;0.0;0.0
3840_3.txt;0;2;0;2;157;0.0;0.01;0.0
4808_3.txt;0;5;0;5;297;0.0;0.02;0.0
10728_3.txt;0;0;0;0;133;0.0;0.0;0.0
1324_1.txt;0;0;0;0;127;0.0;0.0;0.0
8031_1.txt;2;0;3;5;162;0.01;0.0;0.02
3541_1.txt;13;0;0;13;423;0.03;0.0;0.0
5202_2.txt;0;0;0;0;308;0.0;0.0;0.0
7005_4.txt;38;4;8;50;723;0.05;0.01;0.01
4285_2.txt;8;1;1;10;192;0.04;0.01;0.01
2831_4.txt;12;1;0;13;211;0.06;0.0;0.0
10779_4.txt;23;0;0;23;332;0.07;0.0;0.0
10736_1.txt;0;0;0;0;226;0.0;0.0;0.0
11560_4.txt;43;0;0;43;683;0.06;0.0;0.0
5816_3.txt;2;0;0;2;164;0.01;0.0;0.0
10225_3.txt;5;0;0;5;451;0.01;0.0;0.0
11104_1.txt;4;0;0;4;329;0.01;0.0;0.0
11537_4.txt;10;0;0;10;351;0.03;0.0;0.0
11452_1.txt;0;0;0;0;157;0.0;0.0;0.0
8169_4.txt;4;1;0;5;856;0.0;0.0;0.0
5306_2.txt;5;4;0;9;154;0.03;0.03;0.0
2098_3.txt;3;0;0;3;115;0.03;0.0;0.0
9161_1.txt;0;0;0;0;340;0.0;0.0;0.0
2409_1.txt;1;0;2;3;185;0.01;0.0;0.01
2600_2.txt;1;0;0;1;225;0.0;0.0;0.0
900_1.txt;18;4;1;23;559;0.03;0.01;0.0
7063_3.txt;0;0;0;0;128;0.0;0.0;0.0
2188_2.txt;10;0;0;10;83;0.12;0.0;0.0
3107_3.txt;6;0;0;6;149;0.04;0.0;0.0
5622_2.txt;4;0;0;4;269;0.01;0.0;0.0
5978_2.txt;0;0;0;0;73;0.0;0.0;0.0
864_2.txt;14;0;0;14;266;0.05;0.0;0.0
2937_3.txt;7;0;0;7;365;0.02;0.0;0.0
1484_2.txt;5;0;0;5;153;0.03;0.0;0.0
3355_4.txt;18;0;0;18;186;0.1;0.0;0.0
36_4.txt;0;0;0;0;135;0.0;0.0;0.0
6691_1.txt;0;0;0;0;256;0.0;0.0;0.0
10491_1.txt;0;0;0;0;63;0.0;0.0;0.0
11660_1.txt;2;3;1;6;155;0.01;0.02;0.01
3648_4.txt;10;0;0;10;211;0.05;0.0;0.0
12079_2.txt;1;0;0;1;121;0.01;0.0;0.0
6225_1.txt;5;0;0;5;191;0.03;0.0;0.0
6779_1.txt;19;0;1;20;270;0.07;0.0;0.0
7186_2.txt;0;0;0;0;162;0.0;0.0;0.0
9859_1.txt;0;0;0;0;158;0.0;0.0;0.0
10038_3.txt;1;0;0;1;140;0.01;0.0;0.0
11457_4.txt;6;1;0;7;133;0.05;0.01;0.0
8306_1.txt;12;0;0;12;157;0.08;0.0;0.0
478_2.txt;13;1;6;20;214;0.06;0.0;0.03
6355_1.txt;9;0;0;9;166;0.05;0.0;0.0
9946_1.txt;30;4;14;48;1162;0.03;0.0;0.01
8947_2.txt;0;0;0;0;231;0.0;0.0;0.0
11528_1.txt;2;0;0;2;193;0.01;0.0;0.0
5272_1.txt;0;0;0;0;141;0.0;0.0;0.0
7347_1.txt;6;3;2;11;152;0.04;0.02;0.01
2559_1.txt;0;1;0;1;148;0.0;0.01;0.0
5849_2.txt;0;0;0;0;138;0.0;0.0;0.0
8191_4.txt;37;5;2;44;539;0.07;0.01;0.0
2099_1.txt;4;1;2;7;1175;0.0;0.0;0.0
3250_3.txt;25;1;0;26;694;0.04;0.0;0.0
2281_4.txt;14;0;0;14;147;0.1;0.0;0.0
6347_3.txt;1;0;0;1;151;0.01;0.0;0.0
310_1.txt;4;0;0;4;80;0.05;0.0;0.0
4699_2.txt;1;0;3;4;184;0.01;0.0;0.02
11982_4.txt;34;1;8;43;292;0.12;0.0;0.03
5615_4.txt;9;0;4;13;336;0.03;0.0;0.01
6520_4.txt;14;2;0;16;400;0.04;0.01;0.0
10680_1.txt;6;0;0;6;384;0.02;0.0;0.0
156_1.txt;3;0;0;3;327;0.01;0.0;0.0
9867_1.txt;0;0;0;0;227;0.0;0.0;0.0
5469_4.txt;5;0;0;5;99;0.05;0.0;0.0
1993_4.txt;14;1;1;16;401;0.03;0.0;0.0
11329_1.txt;14;0;0;14;128;0.11;0.0;0.0
1921_3.txt;5;1;1;7;329;0.02;0.0;0.0
12122_4.txt;18;2;4;24;423;0.04;0.0;0.01
9667_2.txt;0;0;0;0;92;0.0;0.0;0.0
6066_2.txt;7;1;0;8;540;0.01;0.0;0.0
12474_2.txt;0;0;0;0;192;0.0;0.0;0.0
5402_4.txt;4;0;0;4;144;0.03;0.0;0.0
9447_1.txt;1;0;0;1;274;0.0;0.0;0.0
11618_1.txt;2;0;0;2;169;0.01;0.0;0.0
1743_2.txt;6;1;2;9;348;0.02;0.0;0.01
3057_1.txt;1;1;0;2;271;0.0;0.0;0.0
12171_3.txt;2;5;0;7;351;0.01;0.01;0.0
9742_2.txt;0;0;0;0;129;0.0;0.0;0.0
6720_2.txt;5;2;0;7;309;0.02;0.01;0.0
1367_1.txt;0;0;0;0;75;0.0;0.0;0.0
11948_2.txt;5;0;0;5;217;0.02;0.0;0.0
10443_3.txt;4;2;0;6;167;0.02;0.01;0.0
4487_1.txt;3;1;0;4;507;0.01;0.0;0.0
12_1.txt;2;2;0;4;387;0.01;0.01;0.0
3476_4.txt;5;0;0;5;251;0.02;0.0;0.0
690_4.txt;0;0;1;1;271;0.0;0.0;0.0
599_4.txt;0;0;0;0;274;0.0;0.0;0.0
4319_1.txt;0;3;0;3;226;0.0;0.01;0.0
9675_4.txt;24;2;13;39;683;0.04;0.0;0.02
11750_1.txt;4;0;0;4;139;0.03;0.0;0.0
795_4.txt;11;3;0;14;324;0.03;0.01;0.0
8834_4.txt;2;2;0;4;144;0.01;0.01;0.0
3788_3.txt;4;0;0;4;191;0.02;0.0;0.0
6962_1.txt;2;0;2;4;94;0.02;0.0;0.02
2486_3.txt;3;0;0;3;55;0.05;0.0;0.0
1516_3.txt;29;0;0;29;568;0.05;0.0;0.0
9248_3.txt;2;0;2;4;63;0.03;0.0;0.03
7344_4.txt;0;1;0;1;186;0.0;0.01;0.0
1291_4.txt;7;1;0;8;151;0.05;0.01;0.0
10281_1.txt;8;3;0;11;158;0.05;0.02;0.0
8383_1.txt;3;1;0;4;311;0.01;0.0;0.0
1187_3.txt;4;0;2;6;954;0.0;0.0;0.0
2656_1.txt;3;0;0;3;215;0.01;0.0;0.0
404_2.txt;6;0;0;6;100;0.06;0.0;0.0
10299_4.txt;1;3;3;7;171;0.01;0.02;0.02
858_1.txt;3;0;0;3;183;0.02;0.0;0.0
8372_1.txt;1;0;0;1;144;0.01;0.0;0.0
2470_2.txt;1;1;0;2;164;0.01;0.01;0.0
4663_1.txt;0;0;0;0;183;0.0;0.0;0.0
6789_4.txt;2;0;0;2;175;0.01;0.0;0.0
10521_1.txt;2;0;0;2;147;0.01;0.0;0.0
1548_1.txt;4;1;0;5;219;0.02;0.0;0.0
4810_3.txt;13;4;0;17;499;0.03;0.01;0.0
9307_1.txt;0;0;0;0;287;0.0;0.0;0.0
11287_3.txt;14;0;0;14;385;0.04;0.0;0.0
1413_2.txt;11;0;1;12;431;0.03;0.0;0.0
398_3.txt;6;0;0;6;277;0.02;0.0;0.0
5324_3.txt;3;0;0;3;150;0.02;0.0;0.0
5386_2.txt;0;0;0;0;235;0.0;0.0;0.0
5676_1.txt;0;0;1;1;132;0.0;0.0;0.01
8677_2.txt;0;1;0;1;155;0.0;0.01;0.0
10638_2.txt;7;0;0;7;103;0.07;0.0;0.0
1209_1.txt;0;0;0;0;225;0.0;0.0;0.0
11697_4.txt;0;0;1;1;190;0.0;0.0;0.01
5473_2.txt;28;3;0;31;1106;0.03;0.0;0.0
2426_1.txt;3;0;2;5;228;0.01;0.0;0.01
3774_3.txt;2;0;0;2;84;0.02;0.0;0.0
6132_2.txt;2;0;0;2;275;0.01;0.0;0.0
7252_4.txt;3;4;2;9;274;0.01;0.01;0.01
3128_3.txt;4;0;0;4;156;0.03;0.0;0.0
3849_4.txt;14;1;0;15;167;0.08;0.01;0.0
8656_4.txt;2;0;0;2;170;0.01;0.0;0.0
1881_1.txt;0;0;0;0;158;0.0;0.0;0.0
2743_1.txt;2;0;0;2;153;0.01;0.0;0.0
10237_2.txt;12;5;4;21;777;0.02;0.01;0.01
4660_4.txt;17;0;2;19;297;0.06;0.0;0.01
4817_4.txt;0;2;0;2;141;0.0;0.01;0.0
7931_3.txt;4;0;0;4;256;0.02;0.0;0.0
7764_1.txt;3;2;0;5;149;0.02;0.01;0.0
7322_2.txt;16;0;0;16;268;0.06;0.0;0.0
4515_1.txt;4;1;7;12;380;0.01;0.0;0.02
11722_4.txt;8;4;2;14;391;0.02;0.01;0.01
1016_4.txt;5;1;2;8;195;0.03;0.01;0.01
6788_2.txt;5;0;0;5;123;0.04;0.0;0.0
1972_1.txt;10;0;0;10;183;0.05;0.0;0.0
1301_4.txt;11;1;0;12;290;0.04;0.0;0.0
5022_1.txt;0;0;1;1;154;0.0;0.0;0.01
3800_1.txt;3;0;0;3;321;0.01;0.0;0.0
4761_4.txt;29;0;0;29;479;0.06;0.0;0.0
11067_2.txt;3;0;0;3;90;0.03;0.0;0.0
8933_4.txt;34;3;0;37;642;0.05;0.0;0.0
10268_1.txt;1;0;0;1;142;0.01;0.0;0.0
11862_2.txt;1;0;0;1;340;0.0;0.0;0.0
1086_3.txt;29;4;0;33;385;0.08;0.01;0.0
10456_1.txt;0;0;0;0;159;0.0;0.0;0.0
492_4.txt;2;0;1;3;164;0.01;0.0;0.01
1130_2.txt;4;4;0;8;236;0.02;0.02;0.0
379_2.txt;0;0;1;1;150;0.0;0.0;0.01
5012_4.txt;3;0;0;3;317;0.01;0.0;0.0
4192_4.txt;0;0;0;0;82;0.0;0.0;0.0
1_1.txt;6;0;0;6;144;0.04;0.0;0.0
9611_3.txt;9;1;1;11;327;0.03;0.0;0.0
11635_1.txt;3;0;0;3;212;0.01;0.0;0.0
10058_1.txt;0;0;0;0;147;0.0;0.0;0.0
10320_2.txt;0;2;4;6;258;0.0;0.01;0.02
6545_4.txt;16;4;1;21;525;0.03;0.01;0.0
3768_3.txt;6;0;0;6;369;0.02;0.0;0.0
3296_1.txt;15;5;4;24;419;0.04;0.01;0.01
4366_4.txt;5;0;0;5;621;0.01;0.0;0.0
8442_1.txt;17;0;1;18;398;0.04;0.0;0.0
7643_4.txt;2;0;0;2;275;0.01;0.0;0.0
6189_1.txt;3;1;3;7;143;0.02;0.01;0.02
12270_4.txt;4;0;0;4;210;0.02;0.0;0.0
6902_3.txt;3;4;0;7;336;0.01;0.01;0.0
1519_1.txt;0;0;0;0;72;0.0;0.0;0.0
2880_1.txt;0;0;1;1;139;0.0;0.0;0.01
9485_3.txt;0;0;0;0;368;0.0;0.0;0.0
6587_4.txt;2;0;0;2;621;0.0;0.0;0.0
7860_4.txt;16;1;0;17;271;0.06;0.0;0.0
5290_3.txt;9;0;0;9;228;0.04;0.0;0.0
6366_3.txt;0;1;1;2;220;0.0;0.0;0.0
9468_1.txt;4;0;2;6;162;0.02;0.0;0.01
9925_1.txt;2;1;0;3;167;0.01;0.01;0.0
2696_3.txt;4;0;0;4;152;0.03;0.0;0.0
5130_3.txt;21;2;0;23;406;0.05;0.0;0.0
649_4.txt;0;0;0;0;313;0.0;0.0;0.0
4714_1.txt;3;0;1;4;222;0.01;0.0;0.0
6785_1.txt;7;0;0;7;152;0.05;0.0;0.0
6197_1.txt;1;1;0;2;247;0.0;0.0;0.0
9770_1.txt;6;0;0;6;123;0.05;0.0;0.0
2381_1.txt;2;0;0;2;81;0.02;0.0;0.0
5380_1.txt;5;1;0;6;342;0.01;0.0;0.0
6095_1.txt;0;1;0;1;164;0.0;0.01;0.0
2700_1.txt;8;1;0;9;239;0.03;0.0;0.0
3630_4.txt;13;2;0;15;443;0.03;0.0;0.0
7713_1.txt;0;0;0;0;115;0.0;0.0;0.0
7237_2.txt;8;2;0;10;114;0.07;0.02;0.0
2089_1.txt;0;0;1;1;161;0.0;0.0;0.01
9329_1.txt;0;2;0;2;129;0.0;0.02;0.0
12175_3.txt;13;1;0;14;339;0.04;0.0;0.0
8507_1.txt;2;0;0;2;105;0.02;0.0;0.0
1031_2.txt;9;0;0;9;238;0.04;0.0;0.0
4404_4.txt;8;19;0;27;686;0.01;0.03;0.0
4946_1.txt;3;0;0;3;128;0.02;0.0;0.0
2520_2.txt;0;0;0;0;297;0.0;0.0;0.0
3627_1.txt;6;4;0;10;190;0.03;0.02;0.0
10622_3.txt;2;0;0;2;153;0.01;0.0;0.0
6096_1.txt;80;5;2;87;1142;0.07;0.0;0.0
5550_4.txt;1;0;0;1;324;0.0;0.0;0.0
4114_1.txt;0;1;1;2;205;0.0;0.0;0.0
7257_1.txt;3;0;0;3;156;0.02;0.0;0.0
7951_2.txt;11;1;0;12;220;0.05;0.0;0.0
8686_3.txt;7;2;1;10;413;0.02;0.0;0.0
10739_4.txt;0;0;0;0;137;0.0;0.0;0.0
2336_4.txt;0;0;0;0;216;0.0;0.0;0.0
2863_1.txt;0;0;0;0;172;0.0;0.0;0.0
2752_1.txt;0;0;0;0;196;0.0;0.0;0.0
3952_1.txt;1;1;0;2;130;0.01;0.01;0.0
8451_4.txt;1;0;0;1;191;0.01;0.0;0.0
8404_2.txt;7;0;0;7;439;0.02;0.0;0.0
6963_4.txt;0;1;0;1;122;0.0;0.01;0.0
9225_1.txt;0;0;0;0;94;0.0;0.0;0.0
9049_3.txt;7;0;0;7;154;0.05;0.0;0.0
8976_1.txt;3;1;0;4;130;0.02;0.01;0.0
11335_2.txt;1;0;3;4;176;0.01;0.0;0.02
6708_3.txt;4;0;0;4;234;0.02;0.0;0.0
8842_4.txt;2;1;0;3;342;0.01;0.0;0.0
8197_3.txt;32;1;0;33;401;0.08;0.0;0.0
666_1.txt;1;0;0;1;295;0.0;0.0;0.0
6203_1.txt;0;0;0;0;112;0.0;0.0;0.0
8675_3.txt;19;7;1;27;679;0.03;0.01;0.0
195_4.txt;24;3;0;27;81;0.3;0.04;0.0
102_1.txt;10;0;0;10;212;0.05;0.0;0.0
6966_3.txt;0;0;0;0;806;0.0;0.0;0.0
11662_1.txt;1;1;0;2;209;0.0;0.0;0.0
7922_1.txt;7;2;0;9;220;0.03;0.01;0.0
6050_4.txt;3;1;0;4;178;0.02;0.01;0.0
5169_2.txt;1;0;2;3;247;0.0;0.0;0.01
5374_3.txt;6;3;0;9;286;0.02;0.01;0.0
5690_2.txt;5;0;1;6;731;0.01;0.0;0.0
4549_1.txt;4;1;1;6;136;0.03;0.01;0.01
11609_1.txt;0;1;0;1;267;0.0;0.0;0.0
10837_1.txt;2;0;0;2;177;0.01;0.0;0.0
3792_4.txt;0;0;0;0;197;0.0;0.0;0.0
829_1.txt;0;0;0;0;128;0.0;0.0;0.0
6900_1.txt;0;0;0;0;142;0.0;0.0;0.0
2032_2.txt;0;0;0;0;108;0.0;0.0;0.0
4638_3.txt;52;0;0;52;823;0.06;0.0;0.0
5216_4.txt;6;0;0;6;397;0.02;0.0;0.0
8436_4.txt;6;0;0;6;222;0.03;0.0;0.0
4269_4.txt;0;0;0;0;237;0.0;0.0;0.0
8875_4.txt;11;0;0;11;459;0.02;0.0;0.0
104_3.txt;11;0;0;11;375;0.03;0.0;0.0
9757_4.txt;13;0;0;13;118;0.11;0.0;0.0
6707_1.txt;0;0;0;0;231;0.0;0.0;0.0
11590_3.txt;9;0;0;9;154;0.06;0.0;0.0
1724_1.txt;0;0;0;0;272;0.0;0.0;0.0
11904_1.txt;2;1;0;3;246;0.01;0.0;0.0
4834_4.txt;2;0;1;3;178;0.01;0.0;0.01
2773_1.txt;6;2;0;8;273;0.02;0.01;0.0
12052_1.txt;0;0;1;1;181;0.0;0.0;0.01
7035_3.txt;4;0;0;4;181;0.02;0.0;0.0
9511_1.txt;0;2;1;3;235;0.0;0.01;0.0
2741_2.txt;10;1;1;12;225;0.04;0.0;0.0
3829_4.txt;5;1;0;6;177;0.03;0.01;0.0
6235_1.txt;2;0;1;3;139;0.01;0.0;0.01
12368_3.txt;9;0;1;10;595;0.02;0.0;0.0
10366_1.txt;0;0;0;0;161;0.0;0.0;0.0
8228_1.txt;0;0;0;0;211;0.0;0.0;0.0
3784_1.txt;16;6;0;22;495;0.03;0.01;0.0
12042_2.txt;42;0;2;44;215;0.2;0.0;0.01
9412_3.txt;0;0;0;0;162;0.0;0.0;0.0
10964_1.txt;6;0;0;6;301;0.02;0.0;0.0
10433_4.txt;0;0;0;0;136;0.0;0.0;0.0
422_1.txt;0;0;0;0;305;0.0;0.0;0.0
7078_4.txt;7;0;0;7;238;0.03;0.0;0.0
9145_1.txt;20;0;0;20;296;0.07;0.0;0.0
5070_1.txt;1;2;1;4;171;0.01;0.01;0.01
7415_2.txt;0;0;0;0;317;0.0;0.0;0.0
8029_1.txt;0;0;0;0;205;0.0;0.0;0.0
2805_1.txt;4;3;0;7;167;0.02;0.02;0.0
10768_1.txt;11;0;0;11;316;0.03;0.0;0.0
4390_2.txt;0;0;0;0;191;0.0;0.0;0.0
2216_1.txt;6;0;0;6;231;0.03;0.0;0.0
4709_2.txt;43;2;9;54;899;0.05;0.0;0.01
8577_3.txt;14;0;0;14;343;0.04;0.0;0.0
11814_1.txt;9;0;3;12;264;0.03;0.0;0.01
1858_3.txt;2;0;0;2;186;0.01;0.0;0.0
2905_2.txt;11;2;0;13;373;0.03;0.01;0.0
10898_3.txt;0;0;0;0;142;0.0;0.0;0.0
1871_4.txt;4;0;0;4;162;0.02;0.0;0.0
639_3.txt;4;0;1;5;192;0.02;0.0;0.01
11407_1.txt;3;0;0;3;136;0.02;0.0;0.0
7993_4.txt;4;3;0;7;519;0.01;0.01;0.0
8411_1.txt;2;2;0;4;213;0.01;0.01;0.0
7233_4.txt;5;0;0;5;488;0.01;0.0;0.0
5947_1.txt;6;0;0;6;219;0.03;0.0;0.0
4563_1.txt;9;1;2;12;396;0.02;0.0;0.01
3756_1.txt;0;2;6;8;291;0.0;0.01;0.02
6079_2.txt;0;0;0;0;130;0.0;0.0;0.0
6871_4.txt;0;0;0;0;163;0.0;0.0;0.0
473_1.txt;10;2;1;13;765;0.01;0.0;0.0
4736_2.txt;11;0;0;11;393;0.03;0.0;0.0
1912_4.txt;4;0;0;4;85;0.05;0.0;0.0
10469_1.txt;0;1;3;4;181;0.0;0.01;0.02
9330_2.txt;9;0;0;9;122;0.07;0.0;0.0
3038_4.txt;2;0;0;2;146;0.01;0.0;0.0
8223_1.txt;0;0;0;0;283;0.0;0.0;0.0
7300_3.txt;0;0;0;0;319;0.0;0.0;0.0
4177_4.txt;11;0;4;15;191;0.06;0.0;0.02
3004_1.txt;0;0;0;0;190;0.0;0.0;0.0
10691_3.txt;0;0;0;0;160;0.0;0.0;0.0
3293_1.txt;2;1;0;3;116;0.02;0.01;0.0
11924_4.txt;2;0;3;5;594;0.0;0.0;0.01
11677_4.txt;2;3;0;5;161;0.01;0.02;0.0
10322_2.txt;0;0;1;1;205;0.0;0.0;0.0
4174_3.txt;0;0;4;4;172;0.0;0.0;0.02
637_3.txt;6;0;0;6;169;0.04;0.0;0.0
3221_3.txt;0;0;0;0;146;0.0;0.0;0.0
10306_4.txt;11;0;1;12;512;0.02;0.0;0.0
2784_1.txt;4;0;3;7;200;0.02;0.0;0.01
11162_4.txt;9;1;0;10;157;0.06;0.01;0.0
12337_1.txt;0;0;0;0;31;0.0;0.0;0.0
10661_3.txt;24;2;5;31;227;0.11;0.01;0.02
5599_4.txt;27;6;1;34;431;0.06;0.01;0.0
12082_1.txt;6;0;0;6;174;0.03;0.0;0.0
134_2.txt;6;0;0;6;272;0.02;0.0;0.0
1628_1.txt;5;0;2;7;238;0.02;0.0;0.01
2189_2.txt;0;0;0;0;51;0.0;0.0;0.0
8870_4.txt;19;6;0;25;201;0.09;0.03;0.0
8767_1.txt;1;4;0;5;138;0.01;0.03;0.0
11120_2.txt;4;3;0;7;420;0.01;0.01;0.0
7502_2.txt;7;0;0;7;128;0.05;0.0;0.0
7218_1.txt;0;0;0;0;160;0.0;0.0;0.0
4173_4.txt;4;0;1;5;326;0.01;0.0;0.0
3269_4.txt;0;0;0;0;373;0.0;0.0;0.0
5893_1.txt;0;0;0;0;186;0.0;0.0;0.0
1156_2.txt;6;0;0;6;381;0.02;0.0;0.0
2859_1.txt;0;2;0;2;189;0.0;0.01;0.0
5733_2.txt;0;0;0;0;167;0.0;0.0;0.0
124_2.txt;4;0;0;4;143;0.03;0.0;0.0
7117_1.txt;9;1;1;11;325;0.03;0.0;0.0
9733_3.txt;2;0;0;2;198;0.01;0.0;0.0
5899_3.txt;9;2;1;12;330;0.03;0.01;0.0
7579_4.txt;0;0;0;0;360;0.0;0.0;0.0
8777_2.txt;1;0;0;1;226;0.0;0.0;0.0
5819_4.txt;16;5;0;21;203;0.08;0.02;0.0
11206_1.txt;18;0;0;18;364;0.05;0.0;0.0
1238_1.txt;6;0;0;6;133;0.05;0.0;0.0
2684_1.txt;0;0;0;0;92;0.0;0.0;0.0
5544_3.txt;11;0;0;11;353;0.03;0.0;0.0
6639_1.txt;4;1;0;5;89;0.04;0.01;0.0
6241_3.txt;6;2;1;9;272;0.02;0.01;0.0
515_1.txt;15;0;1;16;335;0.04;0.0;0.0
4891_1.txt;7;3;0;10;483;0.01;0.01;0.0
10917_4.txt;2;1;0;3;149;0.01;0.01;0.0
3225_3.txt;2;0;0;2;104;0.02;0.0;0.0
11163_1.txt;2;0;3;5;153;0.01;0.0;0.02
11300_4.txt;4;2;0;6;248;0.02;0.01;0.0
1869_2.txt;9;3;0;12;330;0.03;0.01;0.0
9622_3.txt;0;1;0;1;197;0.0;0.01;0.0
7470_1.txt;6;5;0;11;331;0.02;0.02;0.0
7039_1.txt;0;0;0;0;52;0.0;0.0;0.0
10217_1.txt;0;0;0;0;64;0.0;0.0;0.0
11456_1.txt;3;0;1;4;152;0.02;0.0;0.01
6911_1.txt;0;0;0;0;145;0.0;0.0;0.0
11069_1.txt;7;0;1;8;320;0.02;0.0;0.0
4023_3.txt;8;0;0;8;219;0.04;0.0;0.0
6312_2.txt;1;9;4;14;408;0.0;0.02;0.01
3220_4.txt;2;0;0;2;220;0.01;0.0;0.0
3481_4.txt;6;0;0;6;156;0.04;0.0;0.0
9286_1.txt;3;0;0;3;136;0.02;0.0;0.0
1155_1.txt;1;0;0;1;169;0.01;0.0;0.0
10001_4.txt;0;0;0;0;158;0.0;0.0;0.0
9460_1.txt;0;0;0;0;182;0.0;0.0;0.0
774_3.txt;8;0;0;8;172;0.05;0.0;0.0
609_1.txt;10;1;0;11;132;0.08;0.01;0.0
1569_2.txt;1;0;0;1;110;0.01;0.0;0.0
8604_3.txt;12;0;0;12;267;0.04;0.0;0.0
8096_1.txt;0;0;0;0;104;0.0;0.0;0.0
712_1.txt;6;1;1;8;215;0.03;0.0;0.0
11333_3.txt;16;0;0;16;266;0.06;0.0;0.0
753_1.txt;4;3;2;9;373;0.01;0.01;0.01
10613_3.txt;0;0;0;0;104;0.0;0.0;0.0
1203_4.txt;16;1;0;17;524;0.03;0.0;0.0
983_4.txt;24;1;0;25;429;0.06;0.0;0.0
8667_3.txt;2;0;0;2;118;0.02;0.0;0.0
8887_4.txt;0;1;0;1;78;0.0;0.01;0.0
12376_1.txt;3;0;0;3;155;0.02;0.0;0.0
6365_1.txt;6;0;0;6;315;0.02;0.0;0.0
2156_1.txt;5;0;0;5;219;0.02;0.0;0.0
6959_2.txt;1;1;0;2;180;0.01;0.01;0.0
12240_1.txt;35;3;3;41;386;0.09;0.01;0.01
2968_1.txt;8;0;0;8;398;0.02;0.0;0.0
5878_4.txt;7;1;0;8;143;0.05;0.01;0.0
8582_1.txt;3;11;0;14;405;0.01;0.03;0.0
4480_1.txt;7;0;0;7;511;0.01;0.0;0.0
4473_2.txt;5;0;0;5;147;0.03;0.0;0.0
1487_1.txt;9;0;1;10;139;0.06;0.0;0.01
8233_1.txt;0;0;0;0;160;0.0;0.0;0.0
1372_1.txt;0;0;0;0;153;0.0;0.0;0.0
3363_1.txt;0;0;0;0;126;0.0;0.0;0.0
4271_4.txt;7;0;0;7;238;0.03;0.0;0.0
6348_2.txt;9;0;1;10;178;0.05;0.0;0.01
10352_4.txt;18;0;1;19;398;0.05;0.0;0.0
7027_4.txt;26;0;0;26;462;0.06;0.0;0.0
3091_3.txt;0;0;0;0;54;0.0;0.0;0.0
11148_4.txt;4;0;1;5;236;0.02;0.0;0.0
9679_2.txt;2;0;0;2;112;0.02;0.0;0.0
1441_2.txt;0;2;0;2;141;0.0;0.01;0.0
4497_4.txt;2;0;0;2;162;0.01;0.0;0.0
4933_3.txt;4;0;0;4;178;0.02;0.0;0.0
7810_3.txt;9;0;0;9;261;0.03;0.0;0.0
10118_4.txt;12;2;2;16;72;0.17;0.03;0.03
4662_4.txt;2;5;2;9;269;0.01;0.02;0.01
8692_2.txt;6;1;0;7;162;0.04;0.01;0.0
9083_1.txt;0;0;0;0;163;0.0;0.0;0.0
8369_1.txt;4;0;0;4;282;0.01;0.0;0.0
7382_2.txt;1;0;0;1;208;0.0;0.0;0.0
794_1.txt;1;0;0;1;317;0.0;0.0;0.0
6844_1.txt;6;0;0;6;322;0.02;0.0;0.0
11910_1.txt;3;0;0;3;159;0.02;0.0;0.0
8319_4.txt;2;0;0;2;147;0.01;0.0;0.0
6042_1.txt;19;0;0;19;749;0.03;0.0;0.0
1213_1.txt;6;1;0;7;204;0.03;0.0;0.0
6571_3.txt;7;0;0;7;187;0.04;0.0;0.0
8740_1.txt;1;0;0;1;175;0.01;0.0;0.0
1144_4.txt;5;3;6;14;427;0.01;0.01;0.01
9811_3.txt;9;0;0;9;153;0.06;0.0;0.0
1619_1.txt;0;0;0;0;224;0.0;0.0;0.0
4576_1.txt;0;2;0;2;216;0.0;0.01;0.0
9854_1.txt;0;1;0;1;324;0.0;0.0;0.0
8674_2.txt;10;3;0;13;228;0.04;0.01;0.0
8754_1.txt;2;0;1;3;159;0.01;0.0;0.01
3096_1.txt;3;1;0;4;352;0.01;0.0;0.0
5853_3.txt;3;0;0;3;276;0.01;0.0;0.0
2079_4.txt;11;0;0;11;159;0.07;0.0;0.0
9726_2.txt;4;0;0;4;158;0.03;0.0;0.0
7414_3.txt;4;1;2;7;464;0.01;0.0;0.0
10115_1.txt;0;2;0;2;137;0.0;0.01;0.0
7454_3.txt;4;0;0;4;100;0.04;0.0;0.0
5281_1.txt;0;0;0;0;64;0.0;0.0;0.0
10219_2.txt;2;11;0;13;473;0.0;0.02;0.0
3639_1.txt;0;0;1;1;131;0.0;0.0;0.01
5535_2.txt;0;2;0;2;272;0.0;0.01;0.0
912_3.txt;0;0;0;0;216;0.0;0.0;0.0
11319_2.txt;24;0;0;24;290;0.08;0.0;0.0
4213_1.txt;9;0;0;9;199;0.05;0.0;0.0
8142_2.txt;7;0;0;7;134;0.05;0.0;0.0
4295_2.txt;0;0;0;0;142;0.0;0.0;0.0
11909_1.txt;4;0;0;4;152;0.03;0.0;0.0
4587_1.txt;5;0;7;12;1023;0.0;0.0;0.01
6019_1.txt;6;0;0;6;171;0.04;0.0;0.0
8265_4.txt;10;5;0;15;207;0.05;0.02;0.0
3483_2.txt;23;0;0;23;159;0.14;0.0;0.0
8858_2.txt;18;1;0;19;297;0.06;0.0;0.0
11389_2.txt;3;0;0;3;225;0.01;0.0;0.0
12247_1.txt;0;0;0;0;138;0.0;0.0;0.0
10232_1.txt;0;0;0;0;136;0.0;0.0;0.0
5663_3.txt;0;0;0;0;218;0.0;0.0;0.0
7404_1.txt;11;4;2;17;588;0.02;0.01;0.0
8420_3.txt;1;0;1;2;87;0.01;0.0;0.01
10752_1.txt;3;0;0;3;349;0.01;0.0;0.0
12203_2.txt;8;4;2;14;149;0.05;0.03;0.01
750_1.txt;1;2;0;3;580;0.0;0.0;0.0
10587_1.txt;2;1;2;5;376;0.01;0.0;0.01
2948_1.txt;0;0;0;0;54;0.0;0.0;0.0
7814_4.txt;38;3;3;44;294;0.13;0.01;0.01
935_4.txt;9;0;2;11;475;0.02;0.0;0.0
2570_3.txt;4;0;0;4;128;0.03;0.0;0.0
9418_2.txt;1;0;0;1;156;0.01;0.0;0.0
7880_3.txt;2;0;0;2;156;0.01;0.0;0.0
4045_1.txt;0;9;3;12;830;0.0;0.01;0.0
11819_3.txt;4;0;0;4;123;0.03;0.0;0.0
827_4.txt;9;0;0;9;167;0.05;0.0;0.0
3536_1.txt;9;0;2;11;283;0.03;0.0;0.01
9835_3.txt;36;0;4;40;690;0.05;0.0;0.01
1525_1.txt;1;0;0;1;138;0.01;0.0;0.0
9089_2.txt;0;8;0;8;195;0.0;0.04;0.0
9318_1.txt;0;1;0;1;245;0.0;0.0;0.0
3002_2.txt;7;0;1;8;634;0.01;0.0;0.0
3970_2.txt;1;0;0;1;152;0.01;0.0;0.0
9138_1.txt;21;2;0;23;937;0.02;0.0;0.0
9312_1.txt;0;0;0;0;178;0.0;0.0;0.0
793_2.txt;4;0;0;4;285;0.01;0.0;0.0
6663_1.txt;14;0;1;15;505;0.03;0.0;0.0
11881_1.txt;3;0;0;3;83;0.04;0.0;0.0
459_1.txt;5;0;0;5;202;0.02;0.0;0.0
2879_1.txt;0;1;0;1;151;0.0;0.01;0.0
11444_2.txt;15;2;0;17;201;0.07;0.01;0.0
2460_1.txt;0;0;0;0;173;0.0;0.0;0.0
8115_1.txt;2;0;0;2;154;0.01;0.0;0.0
10383_2.txt;2;0;0;2;178;0.01;0.0;0.0
1269_2.txt;11;0;0;11;260;0.04;0.0;0.0
11556_1.txt;2;0;0;2;101;0.02;0.0;0.0
658_1.txt;0;0;0;0;462;0.0;0.0;0.0
7364_3.txt;15;2;0;17;149;0.1;0.01;0.0
3163_1.txt;0;0;0;0;237;0.0;0.0;0.0
8075_1.txt;17;1;0;18;466;0.04;0.0;0.0
4202_1.txt;14;2;0;16;368;0.04;0.01;0.0
12140_2.txt;2;1;1;4;160;0.01;0.01;0.01
242_1.txt;27;0;0;27;258;0.1;0.0;0.0
2669_1.txt;3;0;1;4;190;0.02;0.0;0.01
855_1.txt;0;0;0;0;151;0.0;0.0;0.0
2554_1.txt;2;0;0;2;249;0.01;0.0;0.0
12078_1.txt;2;0;0;2;177;0.01;0.0;0.0
8103_3.txt;2;0;0;2;183;0.01;0.0;0.0
4653_2.txt;2;0;2;4;190;0.01;0.0;0.01
7057_1.txt;9;0;0;9;185;0.05;0.0;0.0
8069_1.txt;14;0;0;14;267;0.05;0.0;0.0
6199_1.txt;0;0;0;0;195;0.0;0.0;0.0
3423_4.txt;7;0;0;7;231;0.03;0.0;0.0
598_4.txt;5;3;3;11;294;0.02;0.01;0.01
12161_3.txt;15;2;0;17;285;0.05;0.01;0.0
4706_1.txt;3;0;0;3;186;0.02;0.0;0.0
8324_1.txt;0;0;0;0;165;0.0;0.0;0.0
11740_1.txt;11;0;0;11;102;0.11;0.0;0.0
7482_2.txt;4;0;0;4;85;0.05;0.0;0.0
11116_4.txt;0;0;0;0;166;0.0;0.0;0.0
3334_4.txt;2;0;0;2;180;0.01;0.0;0.0
2200_3.txt;0;0;0;0;401;0.0;0.0;0.0
8321_2.txt;31;2;2;35;534;0.06;0.0;0.0
5184_2.txt;0;0;0;0;116;0.0;0.0;0.0
4681_4.txt;2;3;1;6;275;0.01;0.01;0.0
11507_2.txt;5;0;5;10;142;0.04;0.0;0.04
1050_4.txt;22;3;1;26;384;0.06;0.01;0.0
6140_2.txt;2;0;0;2;77;0.03;0.0;0.0
11577_1.txt;33;2;2;37;151;0.22;0.01;0.01
2545_2.txt;2;0;0;2;150;0.01;0.0;0.0
7711_3.txt;4;0;4;8;319;0.01;0.0;0.01
12295_3.txt;1;0;0;1;61;0.02;0.0;0.0
8532_4.txt;38;2;0;40;315;0.12;0.01;0.0
11485_2.txt;8;0;1;9;459;0.02;0.0;0.0
12192_4.txt;42;1;2;45;715;0.06;0.0;0.0
10982_3.txt;9;0;1;10;304;0.03;0.0;0.0
2360_1.txt;3;0;0;3;174;0.02;0.0;0.0
191_3.txt;1;1;0;2;190;0.01;0.01;0.0
3413_4.txt;10;2;5;17;348;0.03;0.01;0.01
7199_1.txt;2;0;3;5;102;0.02;0.0;0.03
7827_1.txt;21;2;0;23;983;0.02;0.0;0.0
7270_2.txt;1;0;0;1;203;0.0;0.0;0.0
11496_4.txt;0;0;0;0;158;0.0;0.0;0.0
8007_1.txt;2;1;0;3;236;0.01;0.0;0.0
11168_1.txt;10;0;0;10;207;0.05;0.0;0.0
9463_1.txt;4;0;0;4;132;0.03;0.0;0.0
12113_1.txt;4;0;0;4;334;0.01;0.0;0.0
3543_1.txt;7;0;0;7;729;0.01;0.0;0.0
4226_3.txt;2;0;0;2;417;0.0;0.0;0.0
12260_2.txt;2;0;0;2;233;0.01;0.0;0.0
11805_2.txt;3;0;0;3;195;0.02;0.0;0.0
11064_3.txt;2;1;0;3;361;0.01;0.0;0.0
8329_4.txt;6;0;0;6;453;0.01;0.0;0.0
6557_3.txt;18;0;0;18;311;0.06;0.0;0.0
4227_1.txt;0;0;0;0;141;0.0;0.0;0.0
2867_1.txt;3;0;2;5;151;0.02;0.0;0.01
3973_3.txt;2;0;0;2;371;0.01;0.0;0.0
5742_2.txt;0;0;0;0;150;0.0;0.0;0.0
684_2.txt;3;0;0;3;140;0.02;0.0;0.0
9666_1.txt;0;0;0;0;124;0.0;0.0;0.0
10444_1.txt;2;0;0;2;229;0.01;0.0;0.0
10346_4.txt;24;1;4;29;551;0.04;0.0;0.01
2337_4.txt;1;0;0;1;157;0.01;0.0;0.0
10331_2.txt;3;0;1;4;222;0.01;0.0;0.0
4093_4.txt;2;0;0;2;210;0.01;0.0;0.0
9423_4.txt;18;1;11;30;627;0.03;0.0;0.02
2084_1.txt;12;0;0;12;145;0.08;0.0;0.0
6650_3.txt;0;6;0;6;196;0.0;0.03;0.0
7950_3.txt;11;0;3;14;216;0.05;0.0;0.01
12355_2.txt;2;4;0;6;229;0.01;0.02;0.0
12388_4.txt;11;0;0;11;222;0.05;0.0;0.0
9651_3.txt;14;2;5;21;237;0.06;0.01;0.02
10294_1.txt;0;0;0;0;158;0.0;0.0;0.0
11540_2.txt;2;0;0;2;152;0.01;0.0;0.0
11093_2.txt;10;2;0;12;296;0.03;0.01;0.0
2930_1.txt;2;0;0;2;213;0.01;0.0;0.0
6164_3.txt;0;0;0;0;65;0.0;0.0;0.0
4651_3.txt;6;2;0;8;115;0.05;0.02;0.0
2870_1.txt;0;0;0;0;134;0.0;0.0;0.0
2504_3.txt;0;0;0;0;161;0.0;0.0;0.0
2616_2.txt;4;0;0;4;149;0.03;0.0;0.0
6386_1.txt;0;0;0;0;163;0.0;0.0;0.0
3685_3.txt;58;8;3;69;1053;0.06;0.01;0.0
5936_3.txt;14;0;1;15;222;0.06;0.0;0.0
3706_1.txt;6;0;0;6;69;0.09;0.0;0.0
5797_3.txt;19;0;0;19;1102;0.02;0.0;0.0
8747_3.txt;9;0;0;9;141;0.06;0.0;0.0
11244_4.txt;16;4;2;22;427;0.04;0.01;0.0
2776_2.txt;1;1;0;2;174;0.01;0.01;0.0
11767_4.txt;9;0;1;10;194;0.05;0.0;0.01
8541_1.txt;0;0;0;0;522;0.0;0.0;0.0
8961_2.txt;0;0;0;0;227;0.0;0.0;0.0
1789_3.txt;11;3;0;14;332;0.03;0.01;0.0
6380_2.txt;2;0;0;2;171;0.01;0.0;0.0
4609_4.txt;40;0;3;43;618;0.06;0.0;0.0
10004_3.txt;13;0;0;13;119;0.11;0.0;0.0
1462_1.txt;23;0;1;24;471;0.05;0.0;0.0
3339_4.txt;13;0;0;13;241;0.05;0.0;0.0
1882_1.txt;2;0;0;2;156;0.01;0.0;0.0
1885_1.txt;1;0;0;1;143;0.01;0.0;0.0
280_2.txt;3;0;1;4;222;0.01;0.0;0.0
930_2.txt;1;0;0;1;583;0.0;0.0;0.0
7341_4.txt;0;0;0;0;108;0.0;0.0;0.0
8405_3.txt;1;0;0;1;372;0.0;0.0;0.0
54_1.txt;8;0;0;8;131;0.06;0.0;0.0
572_1.txt;1;2;0;3;254;0.0;0.01;0.0
12405_3.txt;0;2;0;2;153;0.0;0.01;0.0
4917_1.txt;12;0;0;12;231;0.05;0.0;0.0
9790_4.txt;33;0;1;34;178;0.19;0.0;0.01
749_1.txt;3;0;4;7;175;0.02;0.0;0.02
7982_1.txt;16;0;11;27;472;0.03;0.0;0.02
1432_3.txt;2;0;0;2;48;0.04;0.0;0.0
4397_3.txt;0;0;0;0;152;0.0;0.0;0.0
3036_2.txt;0;0;0;0;170;0.0;0.0;0.0
7184_4.txt;3;0;1;4;154;0.02;0.0;0.01
3332_2.txt;0;0;0;0;201;0.0;0.0;0.0
351_4.txt;8;0;0;8;200;0.04;0.0;0.0
3045_3.txt;0;1;1;2;335;0.0;0.0;0.0
8918_3.txt;2;5;1;8;301;0.01;0.02;0.0
4155_1.txt;0;0;3;3;397;0.0;0.0;0.01
11108_1.txt;4;0;0;4;241;0.02;0.0;0.0
1002_3.txt;0;0;3;3;172;0.0;0.0;0.02
2844_4.txt;14;0;1;15;434;0.03;0.0;0.0
9985_1.txt;1;0;0;1;144;0.01;0.0;0.0
6700_1.txt;3;4;0;7;293;0.01;0.01;0.0
4144_1.txt;38;1;5;44;815;0.05;0.0;0.01
9475_4.txt;0;0;0;0;132;0.0;0.0;0.0
12440_1.txt;6;0;0;6;199;0.03;0.0;0.0
8689_3.txt;10;0;0;10;262;0.04;0.0;0.0
10970_3.txt;2;0;5;7;303;0.01;0.0;0.02
1440_4.txt;18;1;0;19;152;0.12;0.01;0.0
3499_3.txt;4;0;0;4;139;0.03;0.0;0.0
7033_3.txt;0;0;0;0;326;0.0;0.0;0.0
9148_1.txt;6;0;0;6;133;0.05;0.0;0.0
6786_1.txt;58;1;2;61;685;0.08;0.0;0.0
9109_1.txt;20;2;0;22;339;0.06;0.01;0.0
6944_2.txt;3;0;0;3;159;0.02;0.0;0.0
2729_4.txt;14;3;5;22;253;0.06;0.01;0.02
2497_1.txt;0;0;0;0;207;0.0;0.0;0.0
10749_1.txt;1;4;0;5;418;0.0;0.01;0.0
3633_4.txt;12;0;0;12;182;0.07;0.0;0.0
449_4.txt;9;4;0;13;260;0.03;0.02;0.0
10625_2.txt;5;0;1;6;180;0.03;0.0;0.01
9306_1.txt;0;0;1;1;224;0.0;0.0;0.0
4921_2.txt;10;4;3;17;163;0.06;0.02;0.02
6502_3.txt;16;0;0;16;538;0.03;0.0;0.0
9179_3.txt;2;13;1;16;546;0.0;0.02;0.0
7196_4.txt;27;0;1;28;824;0.03;0.0;0.0
11393_4.txt;10;0;10;20;431;0.02;0.0;0.02
11096_3.txt;6;1;0;7;258;0.02;0.0;0.0
1727_3.txt;4;0;6;10;298;0.01;0.0;0.02
7265_1.txt;7;0;0;7;158;0.04;0.0;0.0
11382_3.txt;6;0;1;7;271;0.02;0.0;0.0
3445_1.txt;2;3;0;5;294;0.01;0.01;0.0
10457_3.txt;0;0;0;0;271;0.0;0.0;0.0
11019_4.txt;18;0;0;18;171;0.11;0.0;0.0
10345_4.txt;13;2;3;18;213;0.06;0.01;0.01
8561_3.txt;7;0;1;8;193;0.04;0.0;0.01
3555_1.txt;10;0;1;11;260;0.04;0.0;0.0
3466_3.txt;2;3;1;6;409;0.0;0.01;0.0
1312_3.txt;9;0;0;9;269;0.03;0.0;0.0
5115_1.txt;0;0;0;0;208;0.0;0.0;0.0
12069_4.txt;5;0;0;5;120;0.04;0.0;0.0
11834_1.txt;0;0;0;0;163;0.0;0.0;0.0
8813_1.txt;0;0;0;0;61;0.0;0.0;0.0
8549_3.txt;4;0;0;4;383;0.01;0.0;0.0
2995_3.txt;0;0;0;0;125;0.0;0.0;0.0
452_3.txt;2;0;0;2;196;0.01;0.0;0.0
1942_2.txt;0;1;1;2;550;0.0;0.0;0.0
9889_1.txt;10;0;0;10;473;0.02;0.0;0.0
5810_3.txt;11;0;0;11;279;0.04;0.0;0.0
5331_1.txt;0;0;0;0;33;0.0;0.0;0.0
3283_1.txt;15;0;0;15;159;0.09;0.0;0.0
5490_1.txt;15;1;0;16;158;0.09;0.01;0.0
5522_2.txt;0;1;0;1;161;0.0;0.01;0.0
1366_3.txt;15;0;0;15;422;0.04;0.0;0.0
3085_1.txt;0;0;3;3;204;0.0;0.0;0.01
6866_1.txt;4;1;0;5;139;0.03;0.01;0.0
4701_1.txt;0;0;0;0;279;0.0;0.0;0.0
2733_1.txt;6;0;0;6;316;0.02;0.0;0.0
10559_3.txt;20;0;0;20;439;0.05;0.0;0.0
5212_3.txt;5;0;0;5;385;0.01;0.0;0.0
1450_3.txt;3;1;0;4;319;0.01;0.0;0.0
3695_1.txt;0;0;0;0;120;0.0;0.0;0.0
1442_1.txt;3;1;0;4;208;0.01;0.0;0.0
46_4.txt;5;2;0;7;149;0.03;0.01;0.0
11968_4.txt;8;1;1;10;258;0.03;0.0;0.0
465_1.txt;12;0;0;12;375;0.03;0.0;0.0
2277_4.txt;13;0;0;13;282;0.05;0.0;0.0
7474_1.txt;0;2;0;2;167;0.0;0.01;0.0
4857_2.txt;0;1;0;1;307;0.0;0.0;0.0
9524_3.txt;2;0;0;2;70;0.03;0.0;0.0
800_2.txt;4;0;0;4;341;0.01;0.0;0.0
8388_1.txt;0;0;0;0;343;0.0;0.0;0.0
1271_3.txt;0;0;1;1;184;0.0;0.0;0.01
8158_2.txt;0;0;0;0;140;0.0;0.0;0.0
3600_3.txt;13;0;0;13;210;0.06;0.0;0.0
648_1.txt;2;0;0;2;457;0.0;0.0;0.0
7935_4.txt;0;0;0;0;144;0.0;0.0;0.0
11613_2.txt;12;3;0;15;173;0.07;0.02;0.0
3364_1.txt;1;0;0;1;268;0.0;0.0;0.0
11973_4.txt;0;0;0;0;123;0.0;0.0;0.0
11502_1.txt;2;0;0;2;153;0.01;0.0;0.0
7757_1.txt;3;2;0;5;268;0.01;0.01;0.0
10202_3.txt;21;1;0;22;394;0.05;0.0;0.0
6580_4.txt;8;0;0;8;43;0.19;0.0;0.0
9612_4.txt;1;0;0;1;133;0.01;0.0;0.0
4160_1.txt;0;0;0;0;151;0.0;0.0;0.0
10754_4.txt;2;0;0;2;135;0.01;0.0;0.0
426_3.txt;0;3;4;7;283;0.0;0.01;0.01
8868_1.txt;2;0;0;2;145;0.01;0.0;0.0
12467_1.txt;0;1;0;1;229;0.0;0.0;0.0
3211_1.txt;2;0;0;2;394;0.01;0.0;0.0
2818_4.txt;22;1;3;26;229;0.1;0.0;0.01
2449_1.txt;2;0;1;3;132;0.02;0.0;0.01
2884_1.txt;2;0;0;2;294;0.01;0.0;0.0
1199_3.txt;0;0;0;0;221;0.0;0.0;0.0
9677_3.txt;0;0;0;0;136;0.0;0.0;0.0
10382_4.txt;53;5;0;58;716;0.07;0.01;0.0
9688_4.txt;8;1;0;9;238;0.03;0.0;0.0
9473_1.txt;0;0;0;0;66;0.0;0.0;0.0
7163_3.txt;2;0;0;2;235;0.01;0.0;0.0
6377_1.txt;14;8;7;29;820;0.02;0.01;0.01
2365_3.txt;10;0;0;10;176;0.06;0.0;0.0
7444_2.txt;0;0;0;0;263;0.0;0.0;0.0
5662_3.txt;1;0;0;1;259;0.0;0.0;0.0
5826_1.txt;1;0;0;1;121;0.01;0.0;0.0
5653_2.txt;7;0;0;7;161;0.04;0.0;0.0
6278_2.txt;2;0;0;2;197;0.01;0.0;0.0
6695_1.txt;3;0;0;3;188;0.02;0.0;0.0
5730_1.txt;3;0;1;4;181;0.02;0.0;0.01
3194_1.txt;9;4;0;13;189;0.05;0.02;0.0
4794_4.txt;11;0;0;11;282;0.04;0.0;0.0
4750_2.txt;4;0;2;6;216;0.02;0.0;0.01
8433_4.txt;3;0;0;3;264;0.01;0.0;0.0
3362_1.txt;14;0;0;14;370;0.04;0.0;0.0
11153_2.txt;1;0;0;1;299;0.0;0.0;0.0
8332_2.txt;8;0;0;8;477;0.02;0.0;0.0
5364_3.txt;7;2;0;9;157;0.04;0.01;0.0
9890_3.txt;1;0;1;2;134;0.01;0.0;0.01
5067_1.txt;2;0;0;2;151;0.01;0.0;0.0
7245_4.txt;2;2;0;4;96;0.02;0.02;0.0
8801_1.txt;7;2;1;10;429;0.02;0.0;0.0
6260_1.txt;1;0;0;1;136;0.01;0.0;0.0
10580_4.txt;3;0;1;4;220;0.01;0.0;0.0
12353_1.txt;0;0;0;0;45;0.0;0.0;0.0
8479_3.txt;10;3;0;13;357;0.03;0.01;0.0
9592_4.txt;5;0;0;5;166;0.03;0.0;0.0
10950_1.txt;0;1;0;1;155;0.0;0.01;0.0
3761_2.txt;1;2;2;5;168;0.01;0.01;0.01
1205_3.txt;0;0;0;0;268;0.0;0.0;0.0
10468_1.txt;0;0;0;0;118;0.0;0.0;0.0
5736_2.txt;0;0;0;0;159;0.0;0.0;0.0
6062_1.txt;7;0;0;7;258;0.03;0.0;0.0
2650_3.txt;3;0;0;3;137;0.02;0.0;0.0
960_1.txt;2;3;0;5;135;0.01;0.02;0.0
2792_4.txt;1;1;0;2;580;0.0;0.0;0.0
2673_3.txt;4;0;0;4;151;0.03;0.0;0.0
8292_4.txt;31;0;0;31;472;0.07;0.0;0.0
8200_2.txt;0;0;0;0;130;0.0;0.0;0.0
2107_3.txt;6;0;0;6;109;0.06;0.0;0.0
8127_2.txt;15;1;1;17;655;0.02;0.0;0.0
12084_3.txt;9;1;0;10;291;0.03;0.0;0.0
1938_1.txt;7;2;2;11;358;0.02;0.01;0.01
12483_4.txt;6;0;0;6;138;0.04;0.0;0.0
7963_4.txt;7;0;0;7;310;0.02;0.0;0.0
10738_4.txt;0;0;0;0;103;0.0;0.0;0.0
6467_3.txt;11;0;0;11;267;0.04;0.0;0.0
3835_3.txt;34;1;0;35;896;0.04;0.0;0.0
8366_4.txt;4;1;0;5;193;0.02;0.01;0.0
3497_3.txt;14;2;0;16;375;0.04;0.01;0.0
9785_3.txt;0;0;0;0;221;0.0;0.0;0.0
4322_1.txt;1;2;0;3;200;0.01;0.01;0.0
437_4.txt;0;0;0;0;141;0.0;0.0;0.0
3069_3.txt;0;0;0;0;161;0.0;0.0;0.0
10721_3.txt;12;1;1;14;237;0.05;0.0;0.0
3075_1.txt;4;0;0;4;178;0.02;0.0;0.0
2538_4.txt;11;4;0;15;385;0.03;0.01;0.0
9758_4.txt;34;0;14;48;562;0.06;0.0;0.02
5604_3.txt;13;0;4;17;212;0.06;0.0;0.02
3026_1.txt;0;2;0;2;147;0.0;0.01;0.0
2848_3.txt;9;0;1;10;211;0.04;0.0;0.0
1030_2.txt;4;0;0;4;64;0.06;0.0;0.0
148_2.txt;2;3;0;5;472;0.0;0.01;0.0
6908_2.txt;0;0;0;0;161;0.0;0.0;0.0
7446_2.txt;10;0;0;10;214;0.05;0.0;0.0
8889_4.txt;30;3;3;36;462;0.06;0.01;0.01
4607_4.txt;16;0;1;17;349;0.05;0.0;0.0
2679_3.txt;2;0;0;2;418;0.0;0.0;0.0
10056_2.txt;8;5;0;13;216;0.04;0.02;0.0
6067_1.txt;15;0;0;15;928;0.02;0.0;0.0
5339_2.txt;0;1;0;1;83;0.0;0.01;0.0
2909_4.txt;14;0;0;14;210;0.07;0.0;0.0
7928_4.txt;0;2;0;2;123;0.0;0.02;0.0
11510_1.txt;3;0;0;3;65;0.05;0.0;0.0
9440_3.txt;2;1;0;3;530;0.0;0.0;0.0
8468_3.txt;0;0;0;0;138;0.0;0.0;0.0
3827_3.txt;8;0;0;8;146;0.05;0.0;0.0
7455_3.txt;0;0;0;0;51;0.0;0.0;0.0
2235_1.txt;0;0;0;0;65;0.0;0.0;0.0
101_1.txt;5;0;0;5;274;0.02;0.0;0.0
11270_1.txt;0;0;0;0;102;0.0;0.0;0.0
3775_1.txt;4;1;0;5;204;0.02;0.0;0.0
5047_3.txt;5;1;0;6;621;0.01;0.0;0.0
289_3.txt;5;1;0;6;129;0.04;0.01;0.0
1578_1.txt;0;0;0;0;226;0.0;0.0;0.0
5626_1.txt;0;0;0;0;151;0.0;0.0;0.0
21_4.txt;5;0;0;5;271;0.02;0.0;0.0
8391_1.txt;6;0;4;10;241;0.02;0.0;0.02
3676_2.txt;5;3;0;8;176;0.03;0.02;0.0
6729_4.txt;4;0;0;4;133;0.03;0.0;0.0
9263_1.txt;0;0;0;0;307;0.0;0.0;0.0
7618_1.txt;0;0;0;0;184;0.0;0.0;0.0
6248_2.txt;7;0;2;9;303;0.02;0.0;0.01
3856_3.txt;3;0;0;3;222;0.01;0.0;0.0
3470_1.txt;4;0;0;4;192;0.02;0.0;0.0
4122_3.txt;1;0;2;3;63;0.02;0.0;0.03
3068_1.txt;0;1;0;1;125;0.0;0.01;0.0
7175_4.txt;0;0;0;0;392;0.0;0.0;0.0
9981_1.txt;0;0;0;0;80;0.0;0.0;0.0
6977_4.txt;4;1;1;6;144;0.03;0.01;0.01
10566_3.txt;0;0;0;0;107;0.0;0.0;0.0
7003_4.txt;10;3;3;16;334;0.03;0.01;0.01
11253_1.txt;2;0;1;3;167;0.01;0.0;0.01
5697_3.txt;1;2;2;5;132;0.01;0.02;0.02
10513_3.txt;0;0;0;0;143;0.0;0.0;0.0
7201_1.txt;2;0;0;2;428;0.0;0.0;0.0
7040_1.txt;10;0;0;10;169;0.06;0.0;0.0
3101_1.txt;11;0;1;12;615;0.02;0.0;0.0
6848_4.txt;0;0;0;0;95;0.0;0.0;0.0
10218_3.txt;13;3;0;16;337;0.04;0.01;0.0
1673_2.txt;0;0;0;0;55;0.0;0.0;0.0
12198_3.txt;1;0;8;9;204;0.0;0.0;0.04
5122_3.txt;0;2;0;2;756;0.0;0.0;0.0
10684_3.txt;1;2;0;3;156;0.01;0.01;0.0
4751_2.txt;4;0;2;6;150;0.03;0.0;0.01
12165_3.txt;6;0;0;6;667;0.01;0.0;0.0
3588_1.txt;13;1;0;14;138;0.09;0.01;0.0
1583_1.txt;6;0;1;7;345;0.02;0.0;0.0
1401_3.txt;0;0;0;0;181;0.0;0.0;0.0
4822_2.txt;0;0;0;0;60;0.0;0.0;0.0
4713_3.txt;11;1;0;12;482;0.02;0.0;0.0
1356_4.txt;6;1;0;7;219;0.03;0.0;0.0
5896_3.txt;0;0;0;0;172;0.0;0.0;0.0
5199_1.txt;2;3;2;7;298;0.01;0.01;0.01
6063_4.txt;18;0;0;18;344;0.05;0.0;0.0
6622_1.txt;6;0;0;6;170;0.04;0.0;0.0
1131_1.txt;7;3;0;10;149;0.05;0.02;0.0
982_3.txt;6;0;0;6;171;0.04;0.0;0.0
554_1.txt;8;0;0;8;161;0.05;0.0;0.0
8565_1.txt;0;0;0;0;139;0.0;0.0;0.0
12107_4.txt;21;0;0;21;791;0.03;0.0;0.0
2311_1.txt;0;0;0;0;53;0.0;0.0;0.0
3517_1.txt;1;0;0;1;146;0.01;0.0;0.0
8636_4.txt;0;0;0;0;74;0.0;0.0;0.0
11264_1.txt;1;0;0;1;245;0.0;0.0;0.0
2530_2.txt;0;0;1;1;185;0.0;0.0;0.01
12302_4.txt;41;0;1;42;497;0.08;0.0;0.0
6813_3.txt;2;0;0;2;150;0.01;0.0;0.0
10067_3.txt;25;5;10;40;1181;0.02;0.0;0.01
5270_2.txt;0;0;0;0;58;0.0;0.0;0.0
4992_4.txt;2;0;0;2;142;0.01;0.0;0.0
227_1.txt;0;0;0;0;192;0.0;0.0;0.0
3980_1.txt;1;0;0;1;196;0.01;0.0;0.0
7493_3.txt;0;2;0;2;200;0.0;0.01;0.0
826_3.txt;4;0;0;4;72;0.06;0.0;0.0
2861_1.txt;0;0;0;0;142;0.0;0.0;0.0
9144_1.txt;1;0;0;1;219;0.0;0.0;0.0
5560_2.txt;3;0;0;3;89;0.03;0.0;0.0
10451_1.txt;5;0;0;5;319;0.02;0.0;0.0
7721_4.txt;6;0;0;6;120;0.05;0.0;0.0
5890_4.txt;0;0;0;0;128;0.0;0.0;0.0
7919_4.txt;3;0;0;3;186;0.02;0.0;0.0
8620_2.txt;8;1;4;13;278;0.03;0.0;0.01
7243_2.txt;0;0;0;0;21;0.0;0.0;0.0
11769_1.txt;51;3;0;54;931;0.05;0.0;0.0
2494_1.txt;7;0;0;7;188;0.04;0.0;0.0
10149_1.txt;7;0;0;7;318;0.02;0.0;0.0
11605_1.txt;0;0;0;0;308;0.0;0.0;0.0
863_2.txt;6;0;0;6;255;0.02;0.0;0.0
4066_3.txt;8;1;1;10;360;0.02;0.0;0.0
8728_4.txt;0;0;0;0;91;0.0;0.0;0.0
10069_1.txt;3;0;0;3;362;0.01;0.0;0.0
6446_2.txt;4;4;0;8;166;0.02;0.02;0.0
74_3.txt;16;0;2;18;275;0.06;0.0;0.01
3336_1.txt;0;0;0;0;61;0.0;0.0;0.0
1102_3.txt;3;1;0;4;243;0.01;0.0;0.0
10992_1.txt;1;2;0;3;230;0.0;0.01;0.0
8098_3.txt;1;0;0;1;144;0.01;0.0;0.0
10842_4.txt;39;3;1;43;847;0.05;0.0;0.0
6351_3.txt;7;0;0;7;199;0.04;0.0;0.0
3171_3.txt;2;0;0;2;190;0.01;0.0;0.0
2420_1.txt;0;2;0;2;224;0.0;0.01;0.0
7280_1.txt;14;0;2;16;563;0.02;0.0;0.0
5612_1.txt;1;0;0;1;215;0.0;0.0;0.0
845_1.txt;4;0;0;4;309;0.01;0.0;0.0
10083_1.txt;0;0;0;0;109;0.0;0.0;0.0
977_1.txt;77;2;1;80;1174;0.07;0.0;0.0
7939_2.txt;2;0;0;2;152;0.01;0.0;0.0
611_4.txt;8;2;2;12;155;0.05;0.01;0.01
10279_3.txt;3;0;2;5;140;0.02;0.0;0.01
6242_1.txt;9;5;12;26;552;0.02;0.01;0.02
1079_3.txt;3;1;0;4;180;0.02;0.01;0.0
2482_1.txt;2;3;1;6;389;0.01;0.01;0.0
3765_1.txt;1;0;0;1;177;0.01;0.0;0.0
9314_4.txt;7;0;0;7;388;0.02;0.0;0.0
9313_1.txt;0;0;0;0;149;0.0;0.0;0.0
6073_1.txt;18;0;0;18;479;0.04;0.0;0.0
2205_2.txt;0;0;0;0;188;0.0;0.0;0.0
1058_1.txt;2;1;0;3;269;0.01;0.0;0.0
748_1.txt;2;0;0;2;327;0.01;0.0;0.0
1884_3.txt;2;1;0;3;94;0.02;0.01;0.0
8993_2.txt;0;0;4;4;124;0.0;0.0;0.03
5717_4.txt;3;1;0;4;421;0.01;0.0;0.0
9654_1.txt;14;1;0;15;220;0.06;0.0;0.0
5716_1.txt;0;1;0;1;224;0.0;0.0;0.0
9091_1.txt;6;2;0;8;143;0.04;0.01;0.0
5008_1.txt;3;0;0;3;155;0.02;0.0;0.0
7359_4.txt;6;0;3;9;251;0.02;0.0;0.01
4686_3.txt;3;0;0;3;95;0.03;0.0;0.0
369_1.txt;0;0;1;1;159;0.0;0.0;0.01
5926_4.txt;9;0;0;9;296;0.03;0.0;0.0
8178_1.txt;0;0;0;0;278;0.0;0.0;0.0
5436_2.txt;6;0;0;6;369;0.02;0.0;0.0
3634_1.txt;4;0;1;5;78;0.05;0.0;0.01
5061_4.txt;16;2;0;18;250;0.06;0.01;0.0
1326_3.txt;39;9;0;48;653;0.06;0.01;0.0
5355_1.txt;2;0;0;2;143;0.01;0.0;0.0
198_2.txt;6;1;0;7;268;0.02;0.0;0.0
1849_1.txt;0;0;0;0;154;0.0;0.0;0.0
6485_1.txt;15;1;4;20;598;0.03;0.0;0.01
9658_3.txt;8;9;4;21;272;0.03;0.03;0.01
7151_2.txt;0;1;0;1;265;0.0;0.0;0.0
11490_1.txt;9;0;1;10;315;0.03;0.0;0.0
12381_1.txt;2;0;0;2;186;0.01;0.0;0.0
6388_4.txt;0;0;9;9;150;0.0;0.0;0.06
9595_1.txt;4;3;0;7;387;0.01;0.01;0.0
8077_1.txt;0;0;0;0;140;0.0;0.0;0.0
2120_2.txt;5;0;0;5;330;0.02;0.0;0.0
1264_3.txt;4;0;0;4;453;0.01;0.0;0.0
4895_2.txt;0;0;0;0;126;0.0;0.0;0.0
11620_4.txt;1;0;1;2;133;0.01;0.0;0.01
5639_1.txt;5;1;0;6;200;0.03;0.01;0.0
3498_1.txt;2;0;0;2;133;0.02;0.0;0.0
52_1.txt;3;2;0;5;139;0.02;0.01;0.0
2350_1.txt;2;0;0;2;177;0.01;0.0;0.0
50_4.txt;0;0;0;0;219;0.0;0.0;0.0
5517_3.txt;2;3;0;5;404;0.0;0.01;0.0
951_2.txt;0;3;0;3;309;0.0;0.01;0.0
5326_2.txt;1;0;1;2;102;0.01;0.0;0.01
11865_1.txt;3;3;0;6;126;0.02;0.02;0.0
4476_2.txt;13;1;2;16;318;0.04;0.0;0.01
11370_1.txt;0;0;2;2;184;0.0;0.0;0.01
4357_3.txt;4;0;3;7;279;0.01;0.0;0.01
7458_3.txt;23;0;0;23;617;0.04;0.0;0.0
5710_1.txt;17;0;4;21;175;0.1;0.0;0.02
1562_1.txt;3;0;0;3;56;0.05;0.0;0.0
9911_3.txt;9;0;1;10;141;0.06;0.0;0.01
7907_3.txt;2;0;1;3;190;0.01;0.0;0.01
6000_1.txt;21;5;21;47;1104;0.02;0.0;0.02
12433_3.txt;2;0;0;2;138;0.01;0.0;0.0
10753_2.txt;8;0;0;8;156;0.05;0.0;0.0
6113_1.txt;0;0;0;0;76;0.0;0.0;0.0
8966_1.txt;0;0;0;0;237;0.0;0.0;0.0
7108_3.txt;2;0;0;2;134;0.01;0.0;0.0
8120_3.txt;3;0;1;4;155;0.02;0.0;0.01
3446_1.txt;0;0;0;0;139;0.0;0.0;0.0
12026_1.txt;0;0;0;0;101;0.0;0.0;0.0
7339_3.txt;3;0;0;3;150;0.02;0.0;0.0
1489_1.txt;4;0;0;4;189;0.02;0.0;0.0
3028_1.txt;9;3;2;14;592;0.02;0.01;0.0
57_4.txt;9;0;1;10;231;0.04;0.0;0.0
273_1.txt;7;5;4;16;245;0.03;0.02;0.02
9565_3.txt;0;0;0;0;135;0.0;0.0;0.0
10274_4.txt;2;2;0;4;238;0.01;0.01;0.0
5025_2.txt;8;1;0;9;478;0.02;0.0;0.0
12124_1.txt;1;0;0;1;46;0.02;0.0;0.0
9437_2.txt;1;0;0;1;162;0.01;0.0;0.0
8109_2.txt;18;5;0;23;955;0.02;0.01;0.0
7061_1.txt;2;0;0;2;193;0.01;0.0;0.0
7627_4.txt;0;0;0;0;56;0.0;0.0;0.0
9901_2.txt;2;0;0;2;204;0.01;0.0;0.0
6608_1.txt;0;0;0;0;135;0.0;0.0;0.0
2059_4.txt;6;0;2;8;191;0.03;0.0;0.01
8697_2.txt;17;0;0;17;119;0.14;0.0;0.0
5774_1.txt;6;0;0;6;197;0.03;0.0;0.0
4225_2.txt;0;0;0;0;180;0.0;0.0;0.0
10043_1.txt;5;2;1;8;497;0.01;0.0;0.0
1360_4.txt;3;0;0;3;157;0.02;0.0;0.0
4496_4.txt;2;0;0;2;360;0.01;0.0;0.0
590_3.txt;5;0;0;5;194;0.03;0.0;0.0
8622_1.txt;6;3;1;10;202;0.03;0.01;0.0
9848_3.txt;0;5;1;6;272;0.0;0.02;0.0
145_2.txt;14;2;0;16;626;0.02;0.0;0.0
1207_4.txt;10;0;0;10;332;0.03;0.0;0.0
10224_4.txt;11;0;0;11;221;0.05;0.0;0.0
4868_4.txt;5;0;0;5;80;0.06;0.0;0.0
4459_1.txt;0;0;0;0;191;0.0;0.0;0.0
9587_3.txt;4;4;0;8;185;0.02;0.02;0.0
11381_1.txt;4;1;0;5;229;0.02;0.0;0.0
8568_4.txt;8;0;0;8;95;0.08;0.0;0.0
6078_1.txt;0;0;0;0;136;0.0;0.0;0.0
1649_1.txt;2;0;1;3;301;0.01;0.0;0.0
176_4.txt;4;0;0;4;230;0.02;0.0;0.0
6345_1.txt;1;0;0;1;165;0.01;0.0;0.0
11250_1.txt;0;0;1;1;167;0.0;0.0;0.01
6442_1.txt;20;5;1;26;396;0.05;0.01;0.0
4351_3.txt;0;2;0;2;148;0.0;0.01;0.0
742_1.txt;2;0;2;4;287;0.01;0.0;0.01
10761_4.txt;5;0;0;5;212;0.02;0.0;0.0
1868_1.txt;2;0;0;2;222;0.01;0.0;0.0
8326_1.txt;18;0;0;18;494;0.04;0.0;0.0
6025_1.txt;1;0;0;1;453;0.0;0.0;0.0
9449_3.txt;9;0;0;9;350;0.03;0.0;0.0
10170_2.txt;8;5;1;14;375;0.02;0.01;0.0
5674_1.txt;14;0;2;16;746;0.02;0.0;0.0
12351_4.txt;1;6;2;9;204;0.0;0.03;0.01
7328_2.txt;9;0;1;10;879;0.01;0.0;0.0
3273_3.txt;23;0;0;23;278;0.08;0.0;0.0
1698_3.txt;1;0;0;1;131;0.01;0.0;0.0
10091_1.txt;0;0;0;0;144;0.0;0.0;0.0
8547_3.txt;1;0;0;1;148;0.01;0.0;0.0
7423_4.txt;5;14;0;19;265;0.02;0.05;0.0
8642_1.txt;0;0;0;0;193;0.0;0.0;0.0
5960_4.txt;0;0;1;1;301;0.0;0.0;0.0
8906_3.txt;0;0;0;0;59;0.0;0.0;0.0
10278_1.txt;0;0;0;0;303;0.0;0.0;0.0
9504_2.txt;5;0;0;5;199;0.03;0.0;0.0
65_4.txt;0;1;2;3;193;0.0;0.01;0.01
3306_4.txt;4;3;0;7;276;0.01;0.01;0.0
3759_1.txt;2;0;0;2;210;0.01;0.0;0.0
5071_1.txt;9;9;1;19;378;0.02;0.02;0.0
4240_1.txt;0;5;2;7;156;0.0;0.03;0.01
10421_2.txt;0;0;0;0;237;0.0;0.0;0.0
5327_1.txt;0;0;0;0;22;0.0;0.0;0.0
5417_3.txt;9;4;0;13;220;0.04;0.02;0.0
485_3.txt;0;0;0;0;123;0.0;0.0;0.0
7092_1.txt;6;0;0;6;191;0.03;0.0;0.0
10484_2.txt;8;0;0;8;149;0.05;0.0;0.0
876_4.txt;4;0;0;4;184;0.02;0.0;0.0
5788_1.txt;17;0;2;19;329;0.05;0.0;0.01
5924_4.txt;4;1;0;5;213;0.02;0.0;0.0
8698_3.txt;0;0;0;0;163;0.0;0.0;0.0
7664_2.txt;4;1;0;5;187;0.02;0.01;0.0
1620_2.txt;3;0;0;3;218;0.01;0.0;0.0
679_3.txt;3;0;0;3;43;0.07;0.0;0.0
10316_3.txt;3;2;1;6;309;0.01;0.01;0.0
2947_1.txt;2;3;1;6;149;0.01;0.02;0.01
12234_1.txt;4;0;0;4;86;0.05;0.0;0.0
7718_4.txt;8;0;2;10;437;0.02;0.0;0.0
11920_3.txt;11;1;0;12;172;0.06;0.01;0.0
8107_3.txt;4;0;0;4;91;0.04;0.0;0.0
9409_4.txt;5;0;0;5;216;0.02;0.0;0.0
3353_4.txt;9;0;0;9;120;0.07;0.0;0.0
11847_1.txt;13;1;6;20;184;0.07;0.01;0.03
5454_1.txt;4;0;0;4;253;0.02;0.0;0.0
12076_4.txt;8;0;0;8;564;0.01;0.0;0.0
11864_3.txt;2;0;0;2;219;0.01;0.0;0.0
9031_3.txt;13;0;0;13;196;0.07;0.0;0.0
4579_1.txt;2;0;0;2;298;0.01;0.0;0.0
9095_1.txt;9;2;0;11;928;0.01;0.0;0.0
9117_1.txt;0;0;0;0;246;0.0;0.0;0.0
7571_3.txt;23;1;0;24;150;0.15;0.01;0.0
5174_2.txt;0;1;1;2;467;0.0;0.0;0.0
1891_3.txt;1;0;1;2;114;0.01;0.0;0.01
5039_3.txt;4;0;0;4;148;0.03;0.0;0.0
2413_1.txt;7;0;2;9;828;0.01;0.0;0.0
4249_3.txt;6;0;3;9;475;0.01;0.0;0.01
4665_2.txt;9;0;0;9;217;0.04;0.0;0.0
12443_1.txt;0;0;0;0;247;0.0;0.0;0.0
938_1.txt;4;0;0;4;63;0.06;0.0;0.0
6792_3.txt;4;0;0;4;154;0.03;0.0;0.0
12350_4.txt;12;0;2;14;175;0.07;0.0;0.01
3012_1.txt;0;0;0;0;178;0.0;0.0;0.0
11542_2.txt;20;2;0;22;335;0.06;0.01;0.0
2432_4.txt;0;0;0;0;125;0.0;0.0;0.0
1200_1.txt;3;0;0;3;87;0.03;0.0;0.0
6996_4.txt;10;0;0;10;696;0.01;0.0;0.0
3100_1.txt;2;1;1;4;176;0.01;0.01;0.01
12485_1.txt;8;0;0;8;88;0.09;0.0;0.0
3136_2.txt;3;0;0;3;298;0.01;0.0;0.0
5167_3.txt;0;0;0;0;170;0.0;0.0;0.0
9803_1.txt;0;2;0;2;101;0.0;0.02;0.0
8733_1.txt;15;0;0;15;737;0.02;0.0;0.0
8699_1.txt;0;0;0;0;457;0.0;0.0;0.0
914_3.txt;4;0;0;4;170;0.02;0.0;0.0
3607_1.txt;0;0;0;0;198;0.0;0.0;0.0
9464_1.txt;1;0;0;1;182;0.01;0.0;0.0
1185_4.txt;3;0;0;3;380;0.01;0.0;0.0
6558_2.txt;4;0;0;4;83;0.05;0.0;0.0
10958_4.txt;18;3;1;22;479;0.04;0.01;0.0
7037_1.txt;0;0;0;0;155;0.0;0.0;0.0
9995_1.txt;4;0;1;5;58;0.07;0.0;0.02
11105_1.txt;2;1;0;3;170;0.01;0.01;0.0
1831_2.txt;3;0;0;3;133;0.02;0.0;0.0
5081_4.txt;2;0;0;2;370;0.01;0.0;0.0
3249_2.txt;11;0;0;11;509;0.02;0.0;0.0
5019_1.txt;2;0;0;2;92;0.02;0.0;0.0
8139_1.txt;7;0;1;8;306;0.02;0.0;0.0
10329_1.txt;3;1;0;4;160;0.02;0.01;0.0
136_4.txt;6;0;0;6;362;0.02;0.0;0.0
1593_4.txt;33;11;5;49;873;0.04;0.01;0.01
8082_3.txt;4;0;0;4;210;0.02;0.0;0.0
8179_3.txt;21;2;0;23;185;0.11;0.01;0.0
1395_3.txt;0;0;0;0;118;0.0;0.0;0.0
4085_2.txt;5;0;1;6;181;0.03;0.0;0.01
4286_1.txt;10;0;0;10;383;0.03;0.0;0.0
6994_1.txt;0;0;0;0;163;0.0;0.0;0.0
7845_2.txt;11;4;1;16;787;0.01;0.01;0.0
2064_1.txt;0;3;2;5;138;0.0;0.02;0.01
4097_2.txt;1;0;0;1;175;0.01;0.0;0.0
8395_3.txt;0;0;8;8;413;0.0;0.0;0.02
4233_1.txt;0;0;0;0;103;0.0;0.0;0.0
6083_3.txt;3;0;1;4;187;0.02;0.0;0.01
11301_3.txt;12;0;0;12;218;0.06;0.0;0.0
6170_4.txt;0;0;0;0;197;0.0;0.0;0.0
5941_1.txt;16;0;0;16;225;0.07;0.0;0.0
12278_1.txt;0;0;0;0;298;0.0;0.0;0.0
534_4.txt;2;0;1;3;177;0.01;0.0;0.01
1060_4.txt;0;2;1;3;281;0.0;0.01;0.0
7662_3.txt;21;0;0;21;823;0.03;0.0;0.0
10330_1.txt;0;1;0;1;210;0.0;0.0;0.0
8930_1.txt;23;0;0;23;668;0.03;0.0;0.0
11344_3.txt;10;0;0;10;216;0.05;0.0;0.0
3883_1.txt;4;0;0;4;651;0.01;0.0;0.0
2917_4.txt;0;1;1;2;491;0.0;0.0;0.0
1237_1.txt;0;1;0;1;78;0.0;0.01;0.0
8134_3.txt;0;0;0;0;372;0.0;0.0;0.0
9461_1.txt;8;0;2;10;141;0.06;0.0;0.01
7043_1.txt;7;0;0;7;269;0.03;0.0;0.0
589_1.txt;2;2;0;4;407;0.0;0.0;0.0
6280_4.txt;0;0;0;0;746;0.0;0.0;0.0
3379_2.txt;2;0;0;2;129;0.02;0.0;0.0
6702_1.txt;0;0;0;0;64;0.0;0.0;0.0
12199_1.txt;3;4;0;7;360;0.01;0.01;0.0
2131_2.txt;13;0;0;13;157;0.08;0.0;0.0
1909_1.txt;2;0;0;2;89;0.02;0.0;0.0
1048_4.txt;90;4;2;96;1451;0.06;0.0;0.0
5726_1.txt;0;0;0;0;160;0.0;0.0;0.0
1424_3.txt;6;0;0;6;187;0.03;0.0;0.0
1084_2.txt;8;0;0;8;163;0.05;0.0;0.0
8784_3.txt;0;0;0;0;165;0.0;0.0;0.0
1886_1.txt;5;0;0;5;283;0.02;0.0;0.0
7487_1.txt;9;2;0;11;204;0.04;0.01;0.0
3828_3.txt;10;0;0;10;287;0.03;0.0;0.0
2016_2.txt;0;0;0;0;161;0.0;0.0;0.0
3110_1.txt;1;0;0;1;220;0.0;0.0;0.0
6102_3.txt;2;0;0;2;40;0.05;0.0;0.0
9943_1.txt;1;1;0;2;260;0.0;0.0;0.0
1624_1.txt;9;0;0;9;186;0.05;0.0;0.0
11962_4.txt;14;1;1;16;579;0.02;0.0;0.0
11053_1.txt;0;0;1;1;120;0.0;0.0;0.01
9338_3.txt;20;0;0;20;331;0.06;0.0;0.0
11712_1.txt;0;0;2;2;238;0.0;0.0;0.01
5625_4.txt;33;20;0;53;693;0.05;0.03;0.0
10632_1.txt;3;0;0;3;195;0.02;0.0;0.0
6084_4.txt;26;1;0;27;464;0.06;0.0;0.0
11218_1.txt;0;0;0;0;241;0.0;0.0;0.0
4658_1.txt;18;0;5;23;371;0.05;0.0;0.01
231_1.txt;2;0;0;2;177;0.01;0.0;0.0
10134_1.txt;4;0;2;6;244;0.02;0.0;0.01
5583_4.txt;27;3;6;36;517;0.05;0.01;0.01
623_3.txt;18;2;5;25;957;0.02;0.0;0.01
7952_4.txt;38;5;2;45;544;0.07;0.01;0.0
7684_3.txt;22;2;0;24;410;0.05;0.0;0.0
6023_1.txt;0;0;0;0;178;0.0;0.0;0.0
3357_1.txt;20;0;1;21;1100;0.02;0.0;0.0
10804_1.txt;12;0;0;12;961;0.01;0.0;0.0
1453_2.txt;4;1;2;7;166;0.02;0.01;0.01
2452_3.txt;17;3;0;20;612;0.03;0.0;0.0
11900_1.txt;9;6;1;16;206;0.04;0.03;0.0
4057_1.txt;9;3;0;12;161;0.06;0.02;0.0
7133_3.txt;6;1;0;7;239;0.03;0.0;0.0
512_1.txt;15;1;1;17;410;0.04;0.0;0.0
10159_3.txt;10;2;0;12;826;0.01;0.0;0.0
765_4.txt;5;0;0;5;409;0.01;0.0;0.0
4859_1.txt;4;0;0;4;250;0.02;0.0;0.0
1750_4.txt;15;2;0;17;201;0.07;0.01;0.0
11735_1.txt;0;1;0;1;195;0.0;0.01;0.0
8328_1.txt;0;0;0;0;199;0.0;0.0;0.0
133_2.txt;1;0;0;1;181;0.01;0.0;0.0
7197_2.txt;1;0;2;3;209;0.0;0.0;0.01
5645_2.txt;4;0;0;4;142;0.03;0.0;0.0
3743_1.txt;3;5;0;8;334;0.01;0.01;0.0
3079_1.txt;1;0;0;1;79;0.01;0.0;0.0
9156_1.txt;11;0;0;11;191;0.06;0.0;0.0
3507_1.txt;3;1;2;6;234;0.01;0.0;0.01
8431_4.txt;6;0;0;6;440;0.01;0.0;0.0
1801_4.txt;19;7;2;28;254;0.07;0.03;0.01
3131_2.txt;28;1;3;32;676;0.04;0.0;0.0
2154_1.txt;1;0;0;1;155;0.01;0.0;0.0
12115_4.txt;29;0;1;30;463;0.06;0.0;0.0
4064_2.txt;0;1;0;1;143;0.0;0.01;0.0
10526_3.txt;5;0;0;5;101;0.05;0.0;0.0
9277_1.txt;2;0;0;2;151;0.01;0.0;0.0
2135_1.txt;0;3;4;7;159;0.0;0.02;0.03
10440_1.txt;9;2;0;11;347;0.03;0.01;0.0
5023_3.txt;16;0;5;21;358;0.04;0.0;0.01
4460_1.txt;0;0;0;0;142;0.0;0.0;0.0
1832_4.txt;20;1;0;21;531;0.04;0.0;0.0
11451_3.txt;2;0;0;2;201;0.01;0.0;0.0
8793_1.txt;2;6;3;11;300;0.01;0.02;0.01
7278_3.txt;0;0;2;2;84;0.0;0.0;0.02
6107_1.txt;0;0;0;0;60;0.0;0.0;0.0
3982_1.txt;0;1;0;1;145;0.0;0.01;0.0
7495_2.txt;43;0;4;47;391;0.11;0.0;0.01
8618_1.txt;2;1;0;3;140;0.01;0.01;0.0
5303_4.txt;42;0;0;42;459;0.09;0.0;0.0
8630_4.txt;6;3;2;11;379;0.02;0.01;0.01
10636_4.txt;4;3;3;10;262;0.02;0.01;0.01
7899_1.txt;12;1;2;15;509;0.02;0.0;0.0
11623_2.txt;0;0;0;0;134;0.0;0.0;0.0
12491_2.txt;0;0;0;0;133;0.0;0.0;0.0
7036_4.txt;0;0;0;0;200;0.0;0.0;0.0
7032_3.txt;11;0;2;13;251;0.04;0.0;0.01
12181_1.txt;36;0;0;36;250;0.14;0.0;0.0
3610_1.txt;0;0;1;1;183;0.0;0.0;0.01
4742_1.txt;9;1;4;14;287;0.03;0.0;0.01
10605_1.txt;5;0;2;7;141;0.04;0.0;0.01
5776_3.txt;0;0;0;0;64;0.0;0.0;0.0
9940_3.txt;15;1;6;22;220;0.07;0.0;0.03
580_3.txt;32;1;0;33;314;0.1;0.0;0.0
2906_1.txt;4;0;0;4;480;0.01;0.0;0.0
12347_1.txt;8;0;0;8;166;0.05;0.0;0.0
10568_1.txt;1;3;2;6;386;0.0;0.01;0.01
2423_4.txt;0;0;0;0;179;0.0;0.0;0.0
2269_1.txt;8;0;0;8;337;0.02;0.0;0.0
7893_4.txt;2;0;0;2;327;0.01;0.0;0.0
570_1.txt;30;2;2;34;570;0.05;0.0;0.0
647_3.txt;0;0;0;0;123;0.0;0.0;0.0
9884_1.txt;0;0;0;0;122;0.0;0.0;0.0
10502_4.txt;8;0;0;8;321;0.02;0.0;0.0
7309_1.txt;46;0;0;46;1245;0.04;0.0;0.0
8908_4.txt;2;4;4;10;162;0.01;0.02;0.02
2638_1.txt;4;0;2;6;157;0.03;0.0;0.01
869_3.txt;5;0;1;6;187;0.03;0.0;0.01
10364_4.txt;3;0;0;3;137;0.02;0.0;0.0
9819_1.txt;0;0;3;3;165;0.0;0.0;0.02
3504_4.txt;1;2;0;3;143;0.01;0.01;0.0
2964_1.txt;0;0;0;0;148;0.0;0.0;0.0
3185_3.txt;5;0;0;5;101;0.05;0.0;0.0
2499_1.txt;0;6;0;6;197;0.0;0.03;0.0
7054_2.txt;9;0;0;9;142;0.06;0.0;0.0
5277_1.txt;10;0;1;11;135;0.07;0.0;0.01
5711_3.txt;4;4;6;14;457;0.01;0.01;0.01
1510_3.txt;0;0;1;1;174;0.0;0.0;0.01
3222_4.txt;20;1;0;21;301;0.07;0.0;0.0
2459_4.txt;12;0;1;13;1152;0.01;0.0;0.0
8196_1.txt;18;0;0;18;454;0.04;0.0;0.0
11668_3.txt;0;0;0;0;220;0.0;0.0;0.0
2572_1.txt;0;0;0;0;114;0.0;0.0;0.0
6633_1.txt;11;0;0;11;251;0.04;0.0;0.0
10151_1.txt;39;26;2;67;693;0.06;0.04;0.0
10312_4.txt;27;0;1;28;353;0.08;0.0;0.0
2033_1.txt;2;0;1;3;242;0.01;0.0;0.0
5283_3.txt;27;1;0;28;581;0.05;0.0;0.0
9709_1.txt;0;0;0;0;194;0.0;0.0;0.0
2068_2.txt;1;0;0;1;185;0.01;0.0;0.0
9374_4.txt;0;2;0;2;169;0.0;0.01;0.0
10238_4.txt;2;0;0;2;142;0.01;0.0;0.0
2735_4.txt;9;0;1;10;156;0.06;0.0;0.01
10582_3.txt;3;0;0;3;139;0.02;0.0;0.0
3385_1.txt;8;4;5;17;701;0.01;0.01;0.01
3437_1.txt;0;0;0;0;204;0.0;0.0;0.0
5095_3.txt;10;4;0;14;184;0.05;0.02;0.0
4011_3.txt;13;0;0;13;448;0.03;0.0;0.0
2373_3.txt;37;1;0;38;763;0.05;0.0;0.0
8163_3.txt;1;0;0;1;276;0.0;0.0;0.0
9057_3.txt;3;2;0;5;61;0.05;0.03;0.0
8253_4.txt;0;0;0;0;166;0.0;0.0;0.0
10351_1.txt;4;0;1;5;154;0.03;0.0;0.01
12168_1.txt;7;0;0;7;161;0.04;0.0;0.0
1723_1.txt;6;0;0;6;284;0.02;0.0;0.0
11567_2.txt;2;0;1;3;161;0.01;0.0;0.01
528_1.txt;6;2;0;8;206;0.03;0.01;0.0
7499_3.txt;3;6;1;10;169;0.02;0.04;0.01
9222_4.txt;13;1;0;14;259;0.05;0.0;0.0
2096_3.txt;4;3;2;9;330;0.01;0.01;0.01
10293_4.txt;0;1;0;1;204;0.0;0.0;0.0
8106_1.txt;2;1;0;3;197;0.01;0.01;0.0
1609_3.txt;26;6;3;35;472;0.06;0.01;0.01
3112_2.txt;5;1;0;6;276;0.02;0.0;0.0
4140_1.txt;0;0;0;0;253;0.0;0.0;0.0
1071_4.txt;13;0;0;13;469;0.03;0.0;0.0
1125_3.txt;3;0;0;3;160;0.02;0.0;0.0
6631_3.txt;12;0;0;12;173;0.07;0.0;0.0
4887_2.txt;1;0;0;1;153;0.01;0.0;0.0
685_1.txt;4;1;1;6;171;0.02;0.01;0.01
3508_4.txt;6;0;0;6;410;0.01;0.0;0.0
4102_4.txt;0;0;0;0;196;0.0;0.0;0.0
275_3.txt;7;0;0;7;324;0.02;0.0;0.0
5892_2.txt;10;0;0;10;153;0.07;0.0;0.0
740_1.txt;38;5;20;63;1123;0.03;0.0;0.02
11087_4.txt;7;0;0;7;153;0.05;0.0;0.0
3692_1.txt;7;1;0;8;471;0.01;0.0;0.0
7395_2.txt;5;0;7;12;571;0.01;0.0;0.01
2711_1.txt;3;1;2;6;109;0.03;0.01;0.02
9472_1.txt;19;1;3;23;400;0.05;0.0;0.01
7422_3.txt;2;0;0;2;119;0.02;0.0;0.0
6946_3.txt;2;1;0;3;258;0.01;0.0;0.0
10678_4.txt;0;0;0;0;173;0.0;0.0;0.0
3747_2.txt;4;0;0;4;41;0.1;0.0;0.0
2197_4.txt;1;0;0;1;244;0.0;0.0;0.0
6601_4.txt;6;0;0;6;64;0.09;0.0;0.0
913_4.txt;1;0;0;1;166;0.01;0.0;0.0
6335_4.txt;8;0;1;9;433;0.02;0.0;0.0
4008_1.txt;5;0;0;5;143;0.03;0.0;0.0
5575_3.txt;14;13;4;31;953;0.01;0.01;0.0
6602_2.txt;1;0;0;1;109;0.01;0.0;0.0
4669_4.txt;4;2;0;6;209;0.02;0.01;0.0
3062_1.txt;2;3;0;5;250;0.01;0.01;0.0
2677_3.txt;4;0;0;4;218;0.02;0.0;0.0
5300_4.txt;2;0;3;5;191;0.01;0.0;0.02
10494_1.txt;8;0;0;8;161;0.05;0.0;0.0
12120_2.txt;8;0;0;8;143;0.06;0.0;0.0
11644_4.txt;10;0;0;10;412;0.02;0.0;0.0
9335_1.txt;10;2;1;13;191;0.05;0.01;0.01
968_1.txt;3;0;0;3;80;0.04;0.0;0.0
9655_1.txt;0;0;0;0;261;0.0;0.0;0.0
2179_1.txt;3;0;0;3;220;0.01;0.0;0.0
224_4.txt;0;0;0;0;166;0.0;0.0;0.0
809_3.txt;8;0;0;8;195;0.04;0.0;0.0
9589_4.txt;5;1;0;6;261;0.02;0.0;0.0
411_2.txt;3;0;0;3;205;0.01;0.0;0.0
6425_4.txt;1;0;0;1;61;0.02;0.0;0.0
8145_1.txt;0;0;0;0;231;0.0;0.0;0.0
6604_3.txt;8;0;0;8;151;0.05;0.0;0.0
12094_3.txt;4;0;0;4;91;0.04;0.0;0.0
12072_2.txt;48;0;0;48;788;0.06;0.0;0.0
3948_4.txt;6;1;0;7;282;0.02;0.0;0.0
474_4.txt;17;4;1;22;892;0.02;0.0;0.0
3714_1.txt;13;4;1;18;209;0.06;0.02;0.0
10616_2.txt;3;1;0;4;178;0.02;0.01;0.0
2795_1.txt;15;0;0;15;209;0.07;0.0;0.0
8347_1.txt;0;0;0;0;140;0.0;0.0;0.0
6052_2.txt;6;0;0;6;180;0.03;0.0;0.0
8632_4.txt;5;0;0;5;153;0.03;0.0;0.0
1595_1.txt;1;0;0;1;154;0.01;0.0;0.0
1670_1.txt;0;0;0;0;121;0.0;0.0;0.0
9391_2.txt;2;0;0;2;48;0.04;0.0;0.0
631_3.txt;11;0;1;12;721;0.02;0.0;0.0
1823_1.txt;5;0;0;5;138;0.04;0.0;0.0
5356_1.txt;0;0;0;0;124;0.0;0.0;0.0
10909_1.txt;2;0;0;2;189;0.01;0.0;0.0
8288_1.txt;11;0;1;12;270;0.04;0.0;0.0
12438_1.txt;3;0;0;3;175;0.02;0.0;0.0
2888_1.txt;1;0;0;1;197;0.01;0.0;0.0
6544_1.txt;3;0;0;3;155;0.02;0.0;0.0
2284_3.txt;1;0;2;3;163;0.01;0.0;0.01
3061_1.txt;2;1;0;3;89;0.02;0.01;0.0
8583_4.txt;0;0;0;0;143;0.0;0.0;0.0
7541_4.txt;2;0;0;2;155;0.01;0.0;0.0
6527_1.txt;5;0;1;6;199;0.03;0.0;0.01
9608_3.txt;10;0;0;10;380;0.03;0.0;0.0
5885_1.txt;14;2;0;16;464;0.03;0.0;0.0
1989_1.txt;2;0;0;2;171;0.01;0.0;0.0
8962_2.txt;2;0;0;2;157;0.01;0.0;0.0
6888_2.txt;8;0;0;8;109;0.07;0.0;0.0
10156_1.txt;1;0;1;2;142;0.01;0.0;0.01
600_1.txt;3;0;0;3;145;0.02;0.0;0.0
2483_1.txt;19;2;2;23;325;0.06;0.01;0.01
11076_4.txt;18;3;2;23;625;0.03;0.0;0.0
11349_4.txt;0;1;2;3;146;0.0;0.01;0.01
9680_1.txt;2;0;0;2;67;0.03;0.0;0.0
5640_1.txt;8;0;0;8;201;0.04;0.0;0.0
8853_3.txt;2;0;0;2;236;0.01;0.0;0.0
7028_2.txt;10;0;4;14;600;0.02;0.0;0.01
10272_1.txt;0;0;0;0;256;0.0;0.0;0.0
5557_4.txt;2;0;0;2;185;0.01;0.0;0.0
8263_4.txt;6;1;0;7;202;0.03;0.0;0.0
5285_3.txt;20;1;0;21;390;0.05;0.0;0.0
6470_3.txt;11;0;7;18;249;0.04;0.0;0.03
5852_3.txt;17;1;1;19;318;0.05;0.0;0.0
9558_1.txt;0;0;0;0;161;0.0;0.0;0.0
11286_1.txt;10;2;0;12;363;0.03;0.01;0.0
11649_1.txt;0;0;0;0;120;0.0;0.0;0.0
6761_2.txt;2;0;0;2;369;0.01;0.0;0.0
11500_1.txt;0;2;0;2;123;0.0;0.02;0.0
3996_1.txt;6;0;0;6;282;0.02;0.0;0.0
5177_1.txt;0;0;0;0;188;0.0;0.0;0.0
12074_1.txt;10;0;0;10;288;0.03;0.0;0.0
10987_4.txt;10;0;0;10;338;0.03;0.0;0.0
11460_3.txt;6;0;0;6;181;0.03;0.0;0.0
5861_1.txt;4;0;0;4;157;0.03;0.0;0.0
7294_1.txt;4;0;0;4;52;0.08;0.0;0.0
5452_4.txt;1;2;0;3;164;0.01;0.01;0.0
5993_2.txt;8;0;0;8;173;0.05;0.0;0.0
4171_4.txt;4;0;1;5;385;0.01;0.0;0.0
2529_2.txt;3;0;0;3;138;0.02;0.0;0.0
7235_2.txt;20;3;0;23;276;0.07;0.01;0.0
1718_3.txt;6;1;0;7;174;0.03;0.01;0.0
10016_4.txt;2;0;0;2;150;0.01;0.0;0.0
1307_1.txt;5;0;0;5;154;0.03;0.0;0.0
6464_3.txt;6;0;0;6;199;0.03;0.0;0.0
10482_1.txt;12;2;3;17;284;0.04;0.01;0.01
9024_4.txt;0;0;0;0;310;0.0;0.0;0.0
3113_1.txt;2;0;0;2;139;0.01;0.0;0.0
2300_1.txt;18;11;6;35;1028;0.02;0.01;0.01
5367_3.txt;6;3;0;9;130;0.05;0.02;0.0
10049_1.txt;0;0;0;0;217;0.0;0.0;0.0
1853_1.txt;0;0;0;0;200;0.0;0.0;0.0
11073_2.txt;6;2;2;10;212;0.03;0.01;0.01
6913_1.txt;0;0;0;0;414;0.0;0.0;0.0
11582_1.txt;0;4;0;4;114;0.0;0.04;0.0
1216_3.txt;0;0;0;0;129;0.0;0.0;0.0
942_2.txt;4;3;0;7;252;0.02;0.01;0.0
4437_1.txt;9;0;0;9;198;0.05;0.0;0.0
10192_2.txt;4;0;0;4;133;0.03;0.0;0.0
8234_1.txt;0;0;0;0;376;0.0;0.0;0.0
682_3.txt;11;0;2;13;470;0.02;0.0;0.0
1284_4.txt;4;1;0;5;193;0.02;0.01;0.0
10300_3.txt;0;0;0;0;132;0.0;0.0;0.0
4482_2.txt;12;1;1;14;239;0.05;0.0;0.0
49_4.txt;2;0;0;2;136;0.01;0.0;0.0
2292_2.txt;8;0;0;8;287;0.03;0.0;0.0
7609_4.txt;6;1;0;7;262;0.02;0.0;0.0
10113_1.txt;0;1;0;1;164;0.0;0.01;0.0
5353_1.txt;6;1;0;7;248;0.02;0.0;0.0
9596_1.txt;2;0;0;2;150;0.01;0.0;0.0
4212_4.txt;1;0;0;1;158;0.01;0.0;0.0
11339_1.txt;15;1;0;16;555;0.03;0.0;0.0
7948_4.txt;9;0;0;9;207;0.04;0.0;0.0
12195_4.txt;3;1;0;4;232;0.01;0.0;0.0
11552_4.txt;15;1;0;16;676;0.02;0.0;0.0
3142_1.txt;6;3;5;14;556;0.01;0.01;0.01
7598_1.txt;10;0;2;12;496;0.02;0.0;0.0
10758_1.txt;0;0;2;2;157;0.0;0.0;0.01
2655_3.txt;22;0;0;22;361;0.06;0.0;0.0
12211_2.txt;4;5;0;9;207;0.02;0.02;0.0
11143_1.txt;2;0;1;3;421;0.0;0.0;0.0
9164_1.txt;3;1;0;4;249;0.01;0.0;0.0
6705_1.txt;2;8;4;14;327;0.01;0.02;0.01
1629_1.txt;1;0;0;1;69;0.01;0.0;0.0
1598_2.txt;0;1;0;1;58;0.0;0.02;0.0
3003_2.txt;0;0;0;0;165;0.0;0.0;0.0
561_1.txt;15;0;2;17;368;0.04;0.0;0.01
2895_4.txt;4;0;0;4;234;0.02;0.0;0.0
4919_3.txt;18;0;0;18;265;0.07;0.0;0.0
3239_3.txt;0;0;0;0;255;0.0;0.0;0.0
251_3.txt;9;0;0;9;246;0.04;0.0;0.0
11983_4.txt;7;0;2;9;176;0.04;0.0;0.01
11612_3.txt;8;3;3;14;266;0.03;0.01;0.01
3506_1.txt;3;0;0;3;255;0.01;0.0;0.0
2410_1.txt;0;0;2;2;126;0.0;0.0;0.02
2843_2.txt;7;1;6;14;244;0.03;0.0;0.02
9634_4.txt;14;2;0;16;228;0.06;0.01;0.0
11696_4.txt;0;0;0;0;138;0.0;0.0;0.0
9745_2.txt;0;0;1;1;134;0.0;0.0;0.01
8687_2.txt;17;0;0;17;135;0.13;0.0;0.0
12232_1.txt;0;0;0;0;62;0.0;0.0;0.0
5257_3.txt;0;0;0;0;155;0.0;0.0;0.0
9876_1.txt;2;0;0;2;172;0.01;0.0;0.0
3422_1.txt;0;0;0;0;97;0.0;0.0;0.0
7659_2.txt;3;3;1;7;244;0.01;0.01;0.0
4728_1.txt;22;0;1;23;686;0.03;0.0;0.0
10959_4.txt;4;1;0;5;238;0.02;0.0;0.0
6564_1.txt;17;0;0;17;177;0.1;0.0;0.0
9615_1.txt;6;0;1;7;151;0.04;0.0;0.01
5619_3.txt;17;0;0;17;391;0.04;0.0;0.0
12012_2.txt;0;0;0;0;100;0.0;0.0;0.0
1980_4.txt;26;2;2;30;568;0.05;0.0;0.0
3859_4.txt;9;1;2;12;179;0.05;0.01;0.01
6890_4.txt;9;0;0;9;175;0.05;0.0;0.0
3681_1.txt;11;1;0;12;515;0.02;0.0;0.0
5985_3.txt;1;3;0;4;130;0.01;0.02;0.0
2619_4.txt;6;0;1;7;112;0.05;0.0;0.01
3400_1.txt;0;1;0;1;175;0.0;0.01;0.0
11543_1.txt;8;0;1;9;231;0.03;0.0;0.0
6805_1.txt;0;0;0;0;188;0.0;0.0;0.0
429_3.txt;0;2;0;2;136;0.0;0.01;0.0
1308_1.txt;1;0;2;3;240;0.0;0.0;0.01
3640_3.txt;4;0;0;4;298;0.01;0.0;0.0
11887_1.txt;4;2;0;6;139;0.03;0.01;0.0
7838_1.txt;2;0;0;2;114;0.02;0.0;0.0
4440_1.txt;8;3;1;12;404;0.02;0.01;0.0
2705_1.txt;0;0;0;0;146;0.0;0.0;0.0
11047_2.txt;4;0;0;4;138;0.03;0.0;0.0
6317_1.txt;2;8;0;10;229;0.01;0.03;0.0
118_2.txt;11;1;0;12;268;0.04;0.0;0.0
11192_4.txt;3;0;0;3;132;0.02;0.0;0.0
7850_3.txt;5;0;0;5;256;0.02;0.0;0.0
4109_1.txt;0;0;0;0;174;0.0;0.0;0.0
4411_4.txt;21;0;0;21;328;0.06;0.0;0.0
12205_3.txt;27;4;4;35;574;0.05;0.01;0.01
4765_2.txt;7;0;0;7;181;0.04;0.0;0.0
7650_1.txt;9;0;0;9;223;0.04;0.0;0.0
11352_1.txt;0;0;0;0;157;0.0;0.0;0.0
8385_1.txt;1;0;0;1;111;0.01;0.0;0.0
7661_1.txt;21;2;2;25;734;0.03;0.0;0.0
4792_3.txt;2;0;0;2;210;0.01;0.0;0.0
5416_4.txt;10;2;2;14;321;0.03;0.01;0.01
5879_1.txt;4;2;0;6;122;0.03;0.02;0.0
5812_4.txt;35;2;0;37;332;0.11;0.01;0.0
7908_2.txt;0;5;0;5;180;0.0;0.03;0.0
582_3.txt;0;0;0;0;116;0.0;0.0;0.0
3174_4.txt;12;2;0;14;113;0.11;0.02;0.0
8700_3.txt;0;0;0;0;78;0.0;0.0;0.0
349_4.txt;5;2;0;7;285;0.02;0.01;0.0
10697_4.txt;10;1;0;11;283;0.04;0.0;0.0
9343_1.txt;5;0;0;5;495;0.01;0.0;0.0
6065_2.txt;4;2;0;6;822;0.0;0.0;0.0
4671_4.txt;4;0;0;4;50;0.08;0.0;0.0
5563_1.txt;3;0;0;3;87;0.03;0.0;0.0
1478_4.txt;2;0;0;2;145;0.01;0.0;0.0
1668_1.txt;13;0;0;13;518;0.03;0.0;0.0
10847_4.txt;0;0;0;0;159;0.0;0.0;0.0
8000_4.txt;2;0;2;4;376;0.01;0.0;0.01
4116_2.txt;6;1;0;7;176;0.03;0.01;0.0
9554_1.txt;0;0;0;0;178;0.0;0.0;0.0
7124_2.txt;0;0;0;0;282;0.0;0.0;0.0
5729_1.txt;0;1;0;1;173;0.0;0.01;0.0
1173_1.txt;2;0;0;2;274;0.01;0.0;0.0
2342_1.txt;0;0;0;0;142;0.0;0.0;0.0
9648_4.txt;28;4;4;36;409;0.07;0.01;0.01
5221_1.txt;0;2;0;2;97;0.0;0.02;0.0
9883_3.txt;8;0;0;8;138;0.06;0.0;0.0
7831_1.txt;15;3;0;18;800;0.02;0.0;0.0
9950_2.txt;11;0;0;11;243;0.05;0.0;0.0
10496_4.txt;5;2;0;7;242;0.02;0.01;0.0
5180_2.txt;0;0;0;0;129;0.0;0.0;0.0
8217_1.txt;6;0;3;9;944;0.01;0.0;0.0
8589_4.txt;1;1;0;2;308;0.0;0.0;0.0
12479_1.txt;0;0;0;0;254;0.0;0.0;0.0
4111_2.txt;2;1;0;3;328;0.01;0.0;0.0
674_3.txt;0;0;0;0;125;0.0;0.0;0.0
5389_3.txt;0;0;0;0;212;0.0;0.0;0.0
5721_4.txt;0;0;4;4;229;0.0;0.0;0.02
11571_1.txt;4;6;0;10;690;0.01;0.01;0.0
4444_2.txt;28;0;0;28;293;0.1;0.0;0.0
11798_3.txt;2;6;0;8;312;0.01;0.02;0.0
8555_4.txt;18;0;0;18;416;0.04;0.0;0.0
9846_1.txt;2;0;0;2;158;0.01;0.0;0.0
1791_2.txt;5;0;0;5;143;0.03;0.0;0.0
10479_2.txt;5;6;0;11;459;0.01;0.01;0.0
8210_4.txt;0;1;1;2;435;0.0;0.0;0.0
4879_3.txt;10;0;0;10;167;0.06;0.0;0.0
8052_1.txt;0;2;0;2;132;0.0;0.02;0.0
4380_1.txt;2;0;0;2;158;0.01;0.0;0.0
7170_2.txt;3;0;0;3;100;0.03;0.0;0.0
7097_4.txt;2;0;0;2;120;0.02;0.0;0.0
8225_1.txt;0;0;0;0;162;0.0;0.0;0.0
11584_4.txt;0;0;0;0;103;0.0;0.0;0.0
9008_1.txt;0;0;0;0;109;0.0;0.0;0.0
2931_4.txt;20;0;0;20;536;0.04;0.0;0.0
8988_1.txt;9;0;0;9;276;0.03;0.0;0.0
7157_4.txt;7;0;0;7;193;0.04;0.0;0.0
6504_2.txt;0;0;0;0;173;0.0;0.0;0.0
5868_1.txt;2;0;0;2;112;0.02;0.0;0.0
5292_4.txt;13;3;0;16;196;0.07;0.02;0.0
10869_1.txt;3;0;0;3;98;0.03;0.0;0.0
4717_1.txt;4;0;1;5;170;0.02;0.0;0.01
12291_2.txt;4;0;0;4;126;0.03;0.0;0.0
11807_2.txt;39;0;0;39;705;0.06;0.0;0.0
8860_3.txt;2;0;0;2;355;0.01;0.0;0.0
4710_1.txt;8;0;0;8;274;0.03;0.0;0.0
5855_1.txt;18;0;1;19;225;0.08;0.0;0.0
1246_3.txt;4;0;0;4;137;0.03;0.0;0.0
1987_4.txt;0;0;0;0;147;0.0;0.0;0.0
9038_1.txt;2;0;0;2;166;0.01;0.0;0.0
8059_1.txt;8;0;0;8;203;0.04;0.0;0.0
1114_3.txt;0;1;0;1;107;0.0;0.01;0.0
7452_4.txt;2;0;0;2;88;0.02;0.0;0.0
6150_3.txt;4;0;0;4;160;0.03;0.0;0.0
7547_1.txt;16;3;0;19;1106;0.01;0.0;0.0
4387_3.txt;3;0;0;3;872;0.0;0.0;0.0
6141_1.txt;0;0;0;0;94;0.0;0.0;0.0
5112_1.txt;0;1;3;4;261;0.0;0.0;0.01
4976_1.txt;21;10;5;36;914;0.02;0.01;0.01
4762_1.txt;6;0;0;6;184;0.03;0.0;0.0
1585_3.txt;7;0;0;7;318;0.02;0.0;0.0
1196_1.txt;3;0;0;3;142;0.02;0.0;0.0
11501_2.txt;2;0;0;2;135;0.01;0.0;0.0
7148_1.txt;0;0;2;2;168;0.0;0.0;0.01
7131_1.txt;11;0;0;11;384;0.03;0.0;0.0
154_3.txt;0;0;0;0;133;0.0;0.0;0.0
2020_2.txt;6;0;0;6;216;0.03;0.0;0.0
4010_2.txt;12;0;1;13;440;0.03;0.0;0.0
6611_4.txt;41;4;2;47;571;0.07;0.01;0.0
1579_1.txt;0;0;0;0;61;0.0;0.0;0.0
1027_1.txt;10;0;1;11;284;0.04;0.0;0.0
130_1.txt;16;2;0;18;845;0.02;0.0;0.0
10741_4.txt;33;2;7;42;518;0.06;0.0;0.01
3030_1.txt;2;0;1;3;206;0.01;0.0;0.0
4982_4.txt;13;0;1;14;486;0.03;0.0;0.0
7150_1.txt;3;0;1;4;338;0.01;0.0;0.0
10280_3.txt;3;0;0;3;143;0.02;0.0;0.0
7918_3.txt;6;0;0;6;149;0.04;0.0;0.0
751_1.txt;3;0;0;3;410;0.01;0.0;0.0
10429_1.txt;0;0;0;0;153;0.0;0.0;0.0
8578_2.txt;12;1;0;13;160;0.07;0.01;0.0
4385_3.txt;0;0;1;1;614;0.0;0.0;0.0
8916_2.txt;5;0;0;5;191;0.03;0.0;0.0
5587_4.txt;15;0;0;15;324;0.05;0.0;0.0
5695_1.txt;2;0;2;4;133;0.02;0.0;0.02
2128_3.txt;6;0;0;6;135;0.04;0.0;0.0
3749_1.txt;7;0;0;7;161;0.04;0.0;0.0
4683_1.txt;2;0;6;8;260;0.01;0.0;0.02
5143_1.txt;3;0;1;4;206;0.01;0.0;0.0
5658_4.txt;22;0;0;22;247;0.09;0.0;0.0
5451_1.txt;0;4;1;5;317;0.0;0.01;0.0
1295_1.txt;0;0;0;0;219;0.0;0.0;0.0
4705_1.txt;1;0;1;2;189;0.01;0.0;0.01
11328_3.txt;10;0;0;10;391;0.03;0.0;0.0
9160_1.txt;1;0;1;2;212;0.0;0.0;0.0
1406_4.txt;23;0;0;23;442;0.05;0.0;0.0
8146_2.txt;4;1;0;5;180;0.02;0.01;0.0
6680_2.txt;0;0;0;0;97;0.0;0.0;0.0
2542_3.txt;0;2;1;3;230;0.0;0.01;0.0
2876_1.txt;0;0;0;0;120;0.0;0.0;0.0
3184_2.txt;11;1;0;12;251;0.04;0.0;0.0
1499_4.txt;4;2;0;6;606;0.01;0.0;0.0
9388_4.txt;11;1;0;12;208;0.05;0.0;0.0
4172_4.txt;10;0;0;10;427;0.02;0.0;0.0
2110_3.txt;21;0;0;21;797;0.03;0.0;0.0
7321_2.txt;6;0;0;6;76;0.08;0.0;0.0
11764_3.txt;10;0;0;10;388;0.03;0.0;0.0
6291_3.txt;15;1;4;20;371;0.04;0.0;0.01
11602_1.txt;8;0;0;8;527;0.02;0.0;0.0
5135_3.txt;2;0;0;2;136;0.01;0.0;0.0
252_4.txt;9;0;0;9;137;0.07;0.0;0.0
5847_1.txt;2;0;0;2;173;0.01;0.0;0.0
851_1.txt;21;0;0;21;513;0.04;0.0;0.0
7826_4.txt;6;1;0;7;217;0.03;0.0;0.0
4373_1.txt;3;2;0;5;384;0.01;0.01;0.0
5586_4.txt;7;0;0;7;254;0.03;0.0;0.0
7611_4.txt;8;1;2;11;221;0.04;0.0;0.01
2125_2.txt;8;0;0;8;278;0.03;0.0;0.0
4589_1.txt;0;0;2;2;156;0.0;0.0;0.01
7258_3.txt;4;6;0;10;177;0.02;0.03;0.0
6790_3.txt;0;0;0;0;159;0.0;0.0;0.0
2220_1.txt;0;0;0;0;140;0.0;0.0;0.0
6457_4.txt;0;0;0;0;170;0.0;0.0;0.0
3494_4.txt;1;0;0;1;157;0.01;0.0;0.0
2642_1.txt;0;0;2;2;178;0.0;0.0;0.01
957_2.txt;7;0;0;7;116;0.06;0.0;0.0
1755_3.txt;3;0;0;3;170;0.02;0.0;0.0
1671_3.txt;4;0;3;7;106;0.04;0.0;0.03
6927_2.txt;0;0;0;0;168;0.0;0.0;0.0
2421_3.txt;0;0;1;1;127;0.0;0.0;0.01
2196_4.txt;2;0;2;4;347;0.01;0.0;0.01
8854_3.txt;13;0;1;14;137;0.09;0.0;0.01
9347_3.txt;0;0;0;0;146;0.0;0.0;0.0
4013_1.txt;8;1;2;11;617;0.01;0.0;0.0
5244_3.txt;40;0;2;42;573;0.07;0.0;0.0
11687_3.txt;16;0;2;18;319;0.05;0.0;0.01
6941_1.txt;0;0;0;0;83;0.0;0.0;0.0
7665_1.txt;1;0;0;1;132;0.01;0.0;0.0
1134_2.txt;8;1;0;9;563;0.01;0.0;0.0
11853_1.txt;5;1;0;6;243;0.02;0.0;0.0
791_1.txt;0;0;0;0;208;0.0;0.0;0.0
584_3.txt;12;1;2;15;198;0.06;0.01;0.01
2214_4.txt;1;0;0;1;274;0.0;0.0;0.0
3198_3.txt;4;0;0;4;457;0.01;0.0;0.0
1283_1.txt;7;2;0;9;235;0.03;0.01;0.0
10403_2.txt;0;0;0;0;54;0.0;0.0;0.0
2043_1.txt;1;0;0;1;124;0.01;0.0;0.0
559_1.txt;6;1;0;7;412;0.01;0.0;0.0
8540_2.txt;5;0;0;5;206;0.02;0.0;0.0
1047_2.txt;3;0;0;3;343;0.01;0.0;0.0
48_4.txt;7;0;0;7;401;0.02;0.0;0.0
319_1.txt;14;0;0;14;184;0.08;0.0;0.0
8318_4.txt;10;0;0;10;197;0.05;0.0;0.0
10600_2.txt;4;0;0;4;141;0.03;0.0;0.0
146_2.txt;0;0;0;0;63;0.0;0.0;0.0
2007_2.txt;1;0;0;1;154;0.01;0.0;0.0
2106_4.txt;4;0;0;4;77;0.05;0.0;0.0
10528_3.txt;6;2;0;8;262;0.02;0.01;0.0
1475_4.txt;2;0;0;2;132;0.02;0.0;0.0
12249_2.txt;2;0;0;2;84;0.02;0.0;0.0
9211_2.txt;4;0;0;4;217;0.02;0.0;0.0
5779_3.txt;3;0;0;3;131;0.02;0.0;0.0
1653_1.txt;4;0;0;4;283;0.01;0.0;0.0
895_3.txt;10;1;1;12;521;0.02;0.0;0.0
7884_1.txt;7;0;0;7;179;0.04;0.0;0.0
223_1.txt;2;0;0;2;85;0.02;0.0;0.0
5206_4.txt;5;0;0;5;240;0.02;0.0;0.0
7973_1.txt;4;0;0;4;210;0.02;0.0;0.0
9534_1.txt;5;0;0;5;94;0.05;0.0;0.0
1818_1.txt;2;0;1;3;116;0.02;0.0;0.01
4974_2.txt;7;0;0;7;195;0.04;0.0;0.0
5973_1.txt;2;0;0;2;99;0.02;0.0;0.0
2275_1.txt;6;0;0;6;139;0.04;0.0;0.0
83_3.txt;46;0;0;46;551;0.08;0.0;0.0
6314_2.txt;10;3;0;13;232;0.04;0.01;0.0
12439_1.txt;1;0;0;1;194;0.01;0.0;0.0
9694_4.txt;43;4;0;47;283;0.15;0.01;0.0
5727_1.txt;2;1;1;4;405;0.0;0.0;0.0
2312_1.txt;0;0;0;0;163;0.0;0.0;0.0
7818_1.txt;2;2;0;4;146;0.01;0.01;0.0
1300_1.txt;0;1;0;1;214;0.0;0.0;0.0
1398_3.txt;2;0;0;2;242;0.01;0.0;0.0
12014_2.txt;15;0;0;15;189;0.08;0.0;0.0
2488_3.txt;9;1;0;10;204;0.04;0.0;0.0
2703_2.txt;1;0;0;1;286;0.0;0.0;0.0
11234_3.txt;4;0;0;4;182;0.02;0.0;0.0
5598_4.txt;0;1;0;1;130;0.0;0.01;0.0
2035_1.txt;2;0;0;2;204;0.01;0.0;0.0
6419_1.txt;4;0;0;4;123;0.03;0.0;0.0
7376_1.txt;4;0;0;4;189;0.02;0.0;0.0
708_4.txt;10;0;2;12;190;0.05;0.0;0.01
1393_2.txt;6;0;0;6;213;0.03;0.0;0.0
7833_1.txt;8;0;3;11;648;0.01;0.0;0.0
11903_2.txt;2;2;3;7;284;0.01;0.01;0.01
10791_2.txt;0;0;0;0;145;0.0;0.0;0.0
8111_3.txt;1;19;2;22;265;0.0;0.07;0.01
1191_1.txt;0;0;1;1;98;0.0;0.0;0.01
2976_1.txt;2;0;0;2;188;0.01;0.0;0.0
7760_3.txt;0;2;4;6;195;0.0;0.01;0.02
3754_3.txt;6;0;0;6;158;0.04;0.0;0.0
6016_1.txt;0;4;0;4;191;0.0;0.02;0.0
10961_2.txt;13;1;5;19;727;0.02;0.0;0.01
5463_1.txt;7;0;0;7;201;0.03;0.0;0.0
12220_1.txt;0;0;0;0;160;0.0;0.0;0.0
5543_2.txt;0;0;0;0;145;0.0;0.0;0.0
8133_1.txt;3;0;0;3;161;0.02;0.0;0.0
3713_3.txt;52;7;2;61;800;0.07;0.01;0.0
2527_2.txt;0;0;0;0;88;0.0;0.0;0.0
3595_4.txt;3;3;0;6;241;0.01;0.01;0.0
9821_1.txt;0;0;0;0;142;0.0;0.0;0.0
9866_1.txt;0;0;0;0;163;0.0;0.0;0.0
8544_3.txt;0;0;0;0;175;0.0;0.0;0.0
3117_2.txt;3;0;0;3;201;0.01;0.0;0.0
10750_3.txt;22;13;5;40;965;0.02;0.01;0.01
3407_2.txt;0;0;0;0;186;0.0;0.0;0.0
2829_1.txt;8;1;0;9;135;0.06;0.01;0.0
10227_1.txt;5;1;0;6;435;0.01;0.0;0.0
11288_1.txt;0;1;0;1;210;0.0;0.0;0.0
5728_4.txt;24;2;0;26;791;0.03;0.0;0.0
8341_1.txt;3;0;0;3;160;0.02;0.0;0.0
9678_1.txt;3;0;0;3;87;0.03;0.0;0.0
9378_4.txt;4;9;0;13;95;0.04;0.09;0.0
4777_3.txt;7;0;1;8;157;0.04;0.0;0.01
10356_2.txt;6;3;1;10;443;0.01;0.01;0.0
7790_2.txt;7;0;0;7;170;0.04;0.0;0.0
7788_2.txt;7;0;0;7;207;0.03;0.0;0.0
2383_1.txt;2;0;0;2;125;0.02;0.0;0.0
12371_1.txt;0;0;0;0;144;0.0;0.0;0.0
587_2.txt;0;0;0;0;145;0.0;0.0;0.0
5555_1.txt;5;0;0;5;174;0.03;0.0;0.0
7018_3.txt;11;0;0;11;186;0.06;0.0;0.0
5021_1.txt;0;0;0;0;88;0.0;0.0;0.0
3834_1.txt;4;0;0;4;164;0.02;0.0;0.0
197_3.txt;4;0;0;4;100;0.04;0.0;0.0
1280_4.txt;8;1;0;9;305;0.03;0.0;0.0
11345_2.txt;4;2;0;6;175;0.02;0.01;0.0
3844_1.txt;2;0;0;2;175;0.01;0.0;0.0
6026_3.txt;0;0;1;1;129;0.0;0.0;0.01
11081_1.txt;0;0;0;0;463;0.0;0.0;0.0
9512_1.txt;0;0;0;0;82;0.0;0.0;0.0
5097_1.txt;4;0;0;4;417;0.01;0.0;0.0
8037_1.txt;0;0;1;1;147;0.0;0.0;0.01
4495_2.txt;8;4;0;12;892;0.01;0.0;0.0
8629_1.txt;12;0;2;14;196;0.06;0.0;0.01
8509_2.txt;11;2;0;13;368;0.03;0.01;0.0
6307_3.txt;0;2;0;2;174;0.0;0.01;0.0
1582_1.txt;0;0;2;2;176;0.0;0.0;0.01
9630_1.txt;25;0;0;25;314;0.08;0.0;0.0
2921_2.txt;6;7;0;13;295;0.02;0.02;0.0
8317_3.txt;2;1;0;3;133;0.02;0.01;0.0
5449_1.txt;9;1;0;10;556;0.02;0.0;0.0
1110_4.txt;6;0;3;9;203;0.03;0.0;0.01
115_2.txt;11;2;0;13;153;0.07;0.01;0.0
12413_3.txt;3;1;0;4;487;0.01;0.0;0.0
688_4.txt;24;6;0;30;311;0.08;0.02;0.0
5204_1.txt;0;0;1;1;136;0.0;0.0;0.01
2513_4.txt;13;0;0;13;198;0.07;0.0;0.0
724_3.txt;2;0;0;2;143;0.01;0.0;0.0
4492_1.txt;3;0;1;4;540;0.01;0.0;0.0
11797_1.txt;0;0;0;0;234;0.0;0.0;0.0
6999_3.txt;19;4;0;23;603;0.03;0.01;0.0
8833_4.txt;0;0;0;0;186;0.0;0.0;0.0
10068_4.txt;5;0;0;5;175;0.03;0.0;0.0
11443_2.txt;23;3;2;28;408;0.06;0.01;0.0
5296_1.txt;2;0;0;2;341;0.01;0.0;0.0
7208_3.txt;18;0;0;18;436;0.04;0.0;0.0
10374_1.txt;7;1;0;8;227;0.03;0.0;0.0
11249_4.txt;10;4;0;14;389;0.03;0.01;0.0
7714_1.txt;1;1;3;5;269;0.0;0.0;0.01
9905_2.txt;26;2;0;28;437;0.06;0.0;0.0
3369_4.txt;8;1;2;11;322;0.02;0.0;0.01
8807_2.txt;0;0;0;0;92;0.0;0.0;0.0
7647_1.txt;1;0;0;1;115;0.01;0.0;0.0
5931_4.txt;8;1;0;9;324;0.02;0.0;0.0
160_2.txt;14;0;0;14;162;0.09;0.0;0.0
9359_4.txt;0;0;0;0;150;0.0;0.0;0.0
3823_4.txt;24;5;2;31;693;0.03;0.01;0.0
7336_2.txt;21;0;0;21;250;0.08;0.0;0.0
2644_1.txt;11;1;3;15;345;0.03;0.0;0.01
7342_2.txt;17;0;1;18;263;0.06;0.0;0.0
5403_1.txt;0;3;0;3;227;0.0;0.01;0.0
2701_1.txt;0;0;0;0;211;0.0;0.0;0.0
7503_4.txt;34;1;0;35;560;0.06;0.0;0.0
4405_2.txt;4;2;0;6;194;0.02;0.01;0.0
6877_1.txt;7;22;3;32;366;0.02;0.06;0.01
1944_1.txt;11;0;2;13;147;0.07;0.0;0.01
8251_3.txt;38;1;2;41;451;0.08;0.0;0.0
2549_1.txt;0;0;0;0;150;0.0;0.0;0.0
1420_3.txt;4;0;0;4;211;0.02;0.0;0.0
5077_1.txt;10;0;0;10;182;0.05;0.0;0.0
804_4.txt;0;0;0;0;249;0.0;0.0;0.0
8373_1.txt;2;1;2;5;209;0.01;0.0;0.01
1968_4.txt;27;2;6;35;678;0.04;0.0;0.01
10820_1.txt;12;3;1;16;240;0.05;0.01;0.0
3951_2.txt;7;0;0;7;539;0.01;0.0;0.0
3781_1.txt;4;0;2;6;449;0.01;0.0;0.0
11024_4.txt;2;3;0;5;212;0.01;0.01;0.0
5394_4.txt;9;0;5;14;304;0.03;0.0;0.02
11417_3.txt;2;0;2;4;129;0.02;0.0;0.02
3708_4.txt;11;2;0;13;151;0.07;0.01;0.0
2475_3.txt;0;0;0;0;126;0.0;0.0;0.0
1245_2.txt;13;0;0;13;434;0.03;0.0;0.0
2256_1.txt;9;0;0;9;303;0.03;0.0;0.0
3501_1.txt;0;0;0;0;230;0.0;0.0;0.0
2992_4.txt;12;2;0;14;438;0.03;0.0;0.0
4272_2.txt;17;4;0;21;385;0.04;0.01;0.0
6341_4.txt;4;6;0;10;230;0.02;0.03;0.0
5181_3.txt;2;0;0;2;240;0.01;0.0;0.0
4619_4.txt;33;2;1;36;513;0.06;0.0;0.0
1879_1.txt;19;0;1;20;230;0.08;0.0;0.0
1063_3.txt;0;3;0;3;139;0.0;0.02;0.0
7791_1.txt;0;2;1;3;139;0.0;0.01;0.01
9097_1.txt;0;0;0;0;149;0.0;0.0;0.0
6690_1.txt;0;0;0;0;197;0.0;0.0;0.0
6905_1.txt;0;0;1;1;159;0.0;0.0;0.01
10952_2.txt;4;0;3;7;250;0.02;0.0;0.01
6395_3.txt;31;0;0;31;822;0.04;0.0;0.0
12307_3.txt;19;0;0;19;136;0.14;0.0;0.0
2916_1.txt;2;3;0;5;439;0.0;0.01;0.0
547_1.txt;2;0;0;2;178;0.01;0.0;0.0
1973_1.txt;14;3;0;17;134;0.1;0.02;0.0
3944_3.txt;9;0;0;9;189;0.05;0.0;0.0
8594_4.txt;31;1;0;32;654;0.05;0.0;0.0
281_1.txt;3;0;0;3;167;0.02;0.0;0.0
12280_1.txt;0;1;0;1;169;0.0;0.01;0.0
614_2.txt;1;0;0;1;144;0.01;0.0;0.0
1889_1.txt;0;1;0;1;158;0.0;0.01;0.0
2238_1.txt;0;0;0;0;74;0.0;0.0;0.0
66_4.txt;45;0;2;47;215;0.21;0.0;0.01
8829_1.txt;0;0;0;0;148;0.0;0.0;0.0
8181_1.txt;0;1;0;1;280;0.0;0.0;0.0
8020_3.txt;0;0;0;0;209;0.0;0.0;0.0
10846_1.txt;1;0;0;1;157;0.01;0.0;0.0
1503_2.txt;13;0;1;14;220;0.06;0.0;0.0
6185_4.txt;9;0;0;9;302;0.03;0.0;0.0
3309_3.txt;0;0;0;0;125;0.0;0.0;0.0
4308_1.txt;0;0;0;0;49;0.0;0.0;0.0
11132_3.txt;8;0;8;16;221;0.04;0.0;0.04
3238_1.txt;2;0;0;2;213;0.01;0.0;0.0
8841_4.txt;6;1;0;7;164;0.04;0.01;0.0
3275_1.txt;31;4;0;35;352;0.09;0.01;0.0
2932_4.txt;14;6;1;21;307;0.05;0.02;0.0
9429_1.txt;0;0;0;0;489;0.0;0.0;0.0
3393_1.txt;0;4;0;4;343;0.0;0.01;0.0
8273_2.txt;4;1;0;5;179;0.02;0.01;0.0
8304_1.txt;5;1;3;9;284;0.02;0.0;0.01
2011_1.txt;10;0;0;10;205;0.05;0.0;0.0
11927_1.txt;4;0;1;5;188;0.02;0.0;0.01
2551_2.txt;0;0;0;0;227;0.0;0.0;0.0
4642_3.txt;6;1;0;7;202;0.03;0.0;0.0
9624_3.txt;4;0;0;4;133;0.03;0.0;0.0
4073_1.txt;0;0;0;0;95;0.0;0.0;0.0
5870_1.txt;8;0;0;8;283;0.03;0.0;0.0
7687_1.txt;3;0;1;4;198;0.02;0.0;0.01
10116_1.txt;2;0;0;2;119;0.02;0.0;0.0
9339_1.txt;2;0;0;2;183;0.01;0.0;0.0
2476_3.txt;0;1;0;1;111;0.0;0.01;0.0
2855_4.txt;8;0;1;9;229;0.03;0.0;0.0
798_1.txt;0;0;0;0;172;0.0;0.0;0.0
1697_2.txt;4;0;0;4;178;0.02;0.0;0.0
2126_1.txt;5;0;0;5;171;0.03;0.0;0.0
10780_4.txt;2;0;0;2;50;0.04;0.0;0.0
3052_1.txt;11;16;4;31;746;0.01;0.02;0.01
5510_1.txt;12;0;0;12;196;0.06;0.0;0.0
950_1.txt;6;3;1;10;314;0.02;0.01;0.0
7967_4.txt;18;4;1;23;884;0.02;0.0;0.0
6556_3.txt;18;1;0;19;282;0.06;0.0;0.0
7403_3.txt;1;0;0;1;280;0.0;0.0;0.0
8705_1.txt;0;0;0;0;164;0.0;0.0;0.0
538_1.txt;0;0;0;0;133;0.0;0.0;0.0
11107_1.txt;4;0;0;4;184;0.02;0.0;0.0
6088_3.txt;3;2;0;5;469;0.01;0.0;0.0
2241_4.txt;2;0;0;2;186;0.01;0.0;0.0
9333_1.txt;3;0;0;3;157;0.02;0.0;0.0
3730_2.txt;4;0;0;4;289;0.01;0.0;0.0
8440_3.txt;13;2;6;21;534;0.02;0.0;0.01
1860_4.txt;4;0;0;4;100;0.04;0.0;0.0
11380_1.txt;1;0;0;1;144;0.01;0.0;0.0
6744_1.txt;5;0;0;5;236;0.02;0.0;0.0
4028_4.txt;28;18;5;51;1057;0.03;0.02;0.0
11985_3.txt;0;0;0;0;281;0.0;0.0;0.0
9543_4.txt;4;0;0;4;317;0.01;0.0;0.0
5657_3.txt;7;2;0;9;264;0.03;0.01;0.0
10606_2.txt;14;0;4;18;410;0.03;0.0;0.01
6373_2.txt;8;0;1;9;136;0.06;0.0;0.01
1176_4.txt;0;1;0;1;200;0.0;0.01;0.0
11771_1.txt;1;1;0;2;380;0.0;0.0;0.0
9110_3.txt;0;0;2;2;239;0.0;0.0;0.01
11274_1.txt;4;0;0;4;119;0.03;0.0;0.0
676_4.txt;11;0;4;15;226;0.05;0.0;0.02
627_2.txt;0;0;0;0;167;0.0;0.0;0.0
11040_2.txt;5;0;0;5;286;0.02;0.0;0.0
5333_4.txt;10;1;0;11;215;0.05;0.0;0.0
7597_3.txt;5;0;0;5;111;0.05;0.0;0.0
4035_1.txt;8;0;0;8;370;0.02;0.0;0.0
2104_2.txt;11;0;1;12;395;0.03;0.0;0.0
11951_1.txt;0;0;0;0;46;0.0;0.0;0.0
9340_4.txt;3;0;0;3;102;0.03;0.0;0.0
11402_4.txt;2;0;0;2;220;0.01;0.0;0.0
8277_3.txt;2;2;2;6;158;0.01;0.01;0.01
6938_4.txt;5;0;3;8;238;0.02;0.0;0.01
7726_1.txt;52;2;2;56;1600;0.03;0.0;0.0
8764_1.txt;0;1;0;1;330;0.0;0.0;0.0
3961_3.txt;7;0;0;7;328;0.02;0.0;0.0
7104_1.txt;0;0;0;0;84;0.0;0.0;0.0
11711_4.txt;4;0;1;5;227;0.02;0.0;0.0
11970_4.txt;2;2;0;4;186;0.01;0.01;0.0
7815_4.txt;8;0;3;11;222;0.04;0.0;0.01
3216_2.txt;23;2;0;25;1096;0.02;0.0;0.0
6535_2.txt;5;2;0;7;513;0.01;0.0;0.0
5462_3.txt;2;0;4;6;172;0.01;0.0;0.02
1101_3.txt;1;0;0;1;213;0.0;0.0;0.0
5056_2.txt;16;0;2;18;300;0.05;0.0;0.01
4489_1.txt;9;0;1;10;465;0.02;0.0;0.0
6679_3.txt;19;0;2;21;280;0.07;0.0;0.01
11757_2.txt;14;0;1;15;326;0.04;0.0;0.0
4143_1.txt;3;1;0;4;158;0.02;0.01;0.0
6028_1.txt;12;1;0;13;523;0.02;0.0;0.0
6697_2.txt;5;2;1;8;481;0.01;0.0;0.0
2147_4.txt;13;0;1;14;399;0.03;0.0;0.0
4508_2.txt;4;1;0;5;265;0.02;0.0;0.0
5113_3.txt;5;0;5;10;52;0.1;0.0;0.1
8608_1.txt;15;0;0;15;254;0.06;0.0;0.0
9022_3.txt;6;1;0;7;556;0.01;0.0;0.0
4731_4.txt;10;0;0;10;155;0.06;0.0;0.0
2506_3.txt;3;0;0;3;58;0.05;0.0;0.0
5385_1.txt;2;0;0;2;153;0.01;0.0;0.0
11156_2.txt;9;0;0;9;246;0.04;0.0;0.0
4077_1.txt;1;0;1;2;228;0.0;0.0;0.0
3527_2.txt;0;1;0;1;209;0.0;0.0;0.0
219_2.txt;1;1;0;2;181;0.01;0.01;0.0
10075_2.txt;9;0;1;10;196;0.05;0.0;0.01
2799_1.txt;0;1;0;1;124;0.0;0.01;0.0
4355_1.txt;0;1;0;1;142;0.0;0.01;0.0
8526_4.txt;15;0;0;15;630;0.02;0.0;0.0
2182_2.txt;0;0;1;1;220;0.0;0.0;0.0
12130_4.txt;6;0;0;6;303;0.02;0.0;0.0
10884_2.txt;13;1;0;14;290;0.04;0.0;0.0
11091_2.txt;0;0;1;1;131;0.0;0.0;0.01
10131_1.txt;4;1;0;5;172;0.02;0.01;0.0
2132_4.txt;0;0;1;1;162;0.0;0.0;0.01
6768_3.txt;29;0;2;31;381;0.08;0.0;0.01
11304_4.txt;36;2;2;40;195;0.18;0.01;0.01
9691_2.txt;10;1;0;11;298;0.03;0.0;0.0
2338_1.txt;13;0;2;15;200;0.07;0.0;0.01
4968_1.txt;3;1;0;4;141;0.02;0.01;0.0
11256_1.txt;6;1;5;12;260;0.02;0.0;0.02
5884_1.txt;0;0;0;0;143;0.0;0.0;0.0
6011_1.txt;0;1;7;8;261;0.0;0.0;0.03
11827_3.txt;2;0;0;2;230;0.01;0.0;0.0
11611_3.txt;7;2;0;9;158;0.04;0.01;0.0
10122_4.txt;10;1;0;11;223;0.04;0.0;0.0
10066_4.txt;3;0;0;3;156;0.02;0.0;0.0
4548_2.txt;0;0;0;0;156;0.0;0.0;0.0
11996_1.txt;54;3;2;59;577;0.09;0.01;0.0
2414_3.txt;0;1;7;8;432;0.0;0.0;0.02
10788_2.txt;10;0;0;10;353;0.03;0.0;0.0
4198_1.txt;19;2;12;33;503;0.04;0.0;0.02
2439_2.txt;5;0;0;5;138;0.04;0.0;0.0
1163_3.txt;20;0;0;20;405;0.05;0.0;0.0
8024_4.txt;15;6;0;21;909;0.02;0.01;0.0
5957_3.txt;11;0;0;11;401;0.03;0.0;0.0
1949_1.txt;8;0;2;10;227;0.04;0.0;0.01
4694_1.txt;0;4;0;4;301;0.0;0.01;0.0
11391_2.txt;0;0;0;0;155;0.0;0.0;0.0
6319_1.txt;0;7;0;7;158;0.0;0.04;0.0
7481_1.txt;4;0;0;4;122;0.03;0.0;0.0
5633_3.txt;15;0;0;15;473;0.03;0.0;0.0
4306_4.txt;6;1;0;7;169;0.04;0.01;0.0
9137_1.txt;11;2;2;15;312;0.04;0.01;0.01
4196_2.txt;0;0;0;0;170;0.0;0.0;0.0
12377_1.txt;4;0;0;4;220;0.02;0.0;0.0
10438_4.txt;0;0;0;0;132;0.0;0.0;0.0
9735_1.txt;4;0;0;4;109;0.04;0.0;0.0
7492_1.txt;4;24;0;28;265;0.02;0.09;0.0
537_3.txt;34;0;2;36;831;0.04;0.0;0.0
1834_3.txt;9;0;0;9;192;0.05;0.0;0.0
962_2.txt;10;0;0;10;123;0.08;0.0;0.0
9837_4.txt;24;0;0;24;440;0.05;0.0;0.0
12238_3.txt;7;1;0;8;219;0.03;0.0;0.0
7591_1.txt;14;3;0;17;327;0.04;0.01;0.0
12400_4.txt;10;0;0;10;162;0.06;0.0;0.0
5229_1.txt;0;0;0;0;128;0.0;0.0;0.0
1197_3.txt;0;0;0;0;119;0.0;0.0;0.0
9260_1.txt;0;0;0;0;158;0.0;0.0;0.0
7865_3.txt;12;0;0;12;494;0.02;0.0;0.0
2963_1.txt;4;0;2;6;284;0.01;0.0;0.01
6266_2.txt;0;0;3;3;367;0.0;0.0;0.01
6586_2.txt;2;0;1;3;167;0.01;0.0;0.01
9470_1.txt;9;0;2;11;467;0.02;0.0;0.0
1037_1.txt;0;0;0;0;208;0.0;0.0;0.0
8105_1.txt;3;0;0;3;185;0.02;0.0;0.0
6047_2.txt;10;2;0;12;193;0.05;0.01;0.0
6503_3.txt;4;0;0;4;379;0.01;0.0;0.0
2268_1.txt;1;0;0;1;86;0.01;0.0;0.0
10348_1.txt;4;0;0;4;193;0.02;0.0;0.0
2111_2.txt;11;0;0;11;135;0.08;0.0;0.0
4337_1.txt;16;6;0;22;294;0.05;0.02;0.0
4571_1.txt;0;0;0;0;235;0.0;0.0;0.0
4505_2.txt;2;5;0;7;331;0.01;0.02;0.0
12043_2.txt;13;0;0;13;209;0.06;0.0;0.0
535_1.txt;16;0;0;16;325;0.05;0.0;0.0
10428_4.txt;0;0;0;0;156;0.0;0.0;0.0
10543_3.txt;21;0;5;26;221;0.1;0.0;0.02
10648_4.txt;13;1;0;14;253;0.05;0.0;0.0
10621_3.txt;9;2;0;11;121;0.07;0.02;0.0
1521_1.txt;0;0;0;0;53;0.0;0.0;0.0
2429_1.txt;0;2;0;2;144;0.0;0.01;0.0
326_1.txt;8;0;0;8;244;0.03;0.0;0.0
8646_1.txt;5;1;0;6;152;0.03;0.01;0.0
5346_3.txt;6;0;0;6;238;0.03;0.0;0.0
8045_1.txt;1;0;0;1;220;0.0;0.0;0.0
5891_3.txt;2;0;0;2;65;0.03;0.0;0.0
12083_3.txt;1;0;0;1;175;0.01;0.0;0.0
7461_2.txt;29;0;4;33;584;0.05;0.0;0.01
458_1.txt;2;0;1;3;261;0.01;0.0;0.0
4612_1.txt;2;0;0;2;84;0.02;0.0;0.0
1017_1.txt;7;1;1;9;206;0.03;0.0;0.0
6059_1.txt;1;0;0;1;139;0.01;0.0;0.0
12354_2.txt;9;0;0;9;195;0.05;0.0;0.0
5950_4.txt;3;0;2;5;253;0.01;0.0;0.01
5648_2.txt;8;1;0;9;254;0.03;0.0;0.0
2712_2.txt;2;0;0;2;249;0.01;0.0;0.0
10564_4.txt;10;0;1;11;188;0.05;0.0;0.01
5755_1.txt;0;3;0;3;174;0.0;0.02;0.0
11733_1.txt;0;1;0;1;142;0.0;0.01;0.0
433_4.txt;2;0;0;2;69;0.03;0.0;0.0
1470_1.txt;15;0;1;16;283;0.05;0.0;0.0
455_4.txt;13;4;3;20;517;0.03;0.01;0.01
5185_2.txt;15;3;0;18;376;0.04;0.01;0.0
5876_1.txt;0;0;0;0;102;0.0;0.0;0.0
11638_4.txt;17;4;4;25;615;0.03;0.01;0.01
10198_4.txt;0;0;0;0;54;0.0;0.0;0.0
2935_2.txt;25;9;1;35;718;0.03;0.01;0.0
1145_1.txt;7;0;0;7;58;0.12;0.0;0.0
2846_3.txt;5;0;0;5;70;0.07;0.0;0.0
7933_4.txt;13;0;0;13;378;0.03;0.0;0.0
1533_4.txt;7;1;0;8;155;0.05;0.01;0.0
1339_2.txt;24;1;1;26;359;0.07;0.0;0.0
11228_4.txt;5;0;0;5;143;0.03;0.0;0.0
10977_1.txt;5;1;0;6;439;0.01;0.0;0.0
439_1.txt;6;0;0;6;164;0.04;0.0;0.0
6479_1.txt;11;1;3;15;510;0.02;0.0;0.01
8457_1.txt;4;0;0;4;136;0.03;0.0;0.0
2450_3.txt;3;1;9;13;268;0.01;0.0;0.03
5990_2.txt;11;2;3;16;510;0.02;0.0;0.01
1524_1.txt;0;0;0;0;95;0.0;0.0;0.0
9220_4.txt;16;1;0;17;128;0.13;0.01;0.0
8571_1.txt;0;2;0;2;99;0.0;0.02;0.0
1105_2.txt;2;0;0;2;249;0.01;0.0;0.0
5593_2.txt;4;2;0;6;328;0.01;0.01;0.0
9118_1.txt;4;0;0;4;145;0.03;0.0;0.0
7829_1.txt;2;0;0;2;194;0.01;0.0;0.0
1688_1.txt;0;0;0;0;149;0.0;0.0;0.0
10449_4.txt;16;0;0;16;889;0.02;0.0;0.0
2812_2.txt;7;0;0;7;274;0.03;0.0;0.0
4421_4.txt;0;0;0;0;281;0.0;0.0;0.0
4882_1.txt;1;3;0;4;351;0.0;0.01;0.0
11473_4.txt;1;0;0;1;49;0.02;0.0;0.0
9660_4.txt;1;2;0;3;511;0.0;0.0;0.0
8672_2.txt;9;2;0;11;162;0.06;0.01;0.0
12057_1.txt;7;1;0;8;299;0.02;0.0;0.0
8982_4.txt;4;1;0;5;166;0.02;0.01;0.0
5752_1.txt;2;0;0;2;113;0.02;0.0;0.0
8320_4.txt;8;0;0;8;171;0.05;0.0;0.0
9187_1.txt;0;0;1;1;204;0.0;0.0;0.0
7758_4.txt;0;0;0;0;154;0.0;0.0;0.0
7646_2.txt;5;0;0;5;168;0.03;0.0;0.0
12159_1.txt;2;0;0;2;271;0.01;0.0;0.0
12210_2.txt;3;0;0;3;180;0.02;0.0;0.0
4263_4.txt;6;0;0;6;139;0.04;0.0;0.0
10123_3.txt;44;2;3;49;657;0.07;0.0;0.0
11693_4.txt;12;0;0;12;260;0.05;0.0;0.0
9421_1.txt;4;0;0;4;136;0.03;0.0;0.0
7981_4.txt;12;0;0;12;190;0.06;0.0;0.0
11936_2.txt;0;0;0;0;73;0.0;0.0;0.0
1260_4.txt;17;2;0;19;268;0.06;0.01;0.0
1788_3.txt;14;0;1;15;177;0.08;0.0;0.01
6301_4.txt;7;0;0;7;167;0.04;0.0;0.0
6901_3.txt;1;1;0;2;181;0.01;0.01;0.0
9598_4.txt;18;4;1;23;544;0.03;0.01;0.0
11498_1.txt;8;0;0;8;251;0.03;0.0;0.0
9789_1.txt;1;1;0;2;195;0.01;0.01;0.0
8999_4.txt;11;0;2;13;231;0.05;0.0;0.01
7968_1.txt;2;2;3;7;861;0.0;0.0;0.0
2412_1.txt;0;0;0;0;149;0.0;0.0;0.0
8535_2.txt;8;2;0;10;177;0.05;0.01;0.0
5054_1.txt;0;0;0;0;114;0.0;0.0;0.0
3857_3.txt;2;0;1;3;165;0.01;0.0;0.01
5325_2.txt;3;5;0;8;208;0.01;0.02;0.0
6763_1.txt;5;0;0;5;138;0.04;0.0;0.0
1449_1.txt;9;0;0;9;332;0.03;0.0;0.0
26_3.txt;2;1;1;4;193;0.01;0.01;0.01
6304_1.txt;4;0;0;4;242;0.02;0.0;0.0
1129_1.txt;0;0;0;0;69;0.0;0.0;0.0
7934_3.txt;0;0;0;0;118;0.0;0.0;0.0
1888_4.txt;2;1;0;3;204;0.01;0.0;0.0
6147_1.txt;4;0;1;5;145;0.03;0.0;0.01
10084_4.txt;4;0;0;4;245;0.02;0.0;0.0
3406_4.txt;11;0;0;11;261;0.04;0.0;0.0
9446_1.txt;0;0;0;0;85;0.0;0.0;0.0
5334_4.txt;16;2;0;18;294;0.05;0.01;0.0
8126_3.txt;11;0;0;11;439;0.03;0.0;0.0
10732_3.txt;0;1;0;1;196;0.0;0.01;0.0
4311_3.txt;2;1;0;3;265;0.01;0.0;0.0
4546_2.txt;13;2;0;15;402;0.03;0.0;0.0
2056_1.txt;2;0;0;2;88;0.02;0.0;0.0
5971_3.txt;0;0;0;0;79;0.0;0.0;0.0
3653_1.txt;0;0;0;0;139;0.0;0.0;0.0
9716_1.txt;3;0;2;5;118;0.03;0.0;0.02
406_2.txt;8;0;0;8;332;0.02;0.0;0.0
5120_1.txt;4;3;7;14;373;0.01;0.01;0.02
5496_4.txt;0;0;2;2;58;0.0;0.0;0.03
8131_1.txt;0;0;0;0;85;0.0;0.0;0.0
6071_4.txt;2;0;0;2;54;0.04;0.0;0.0
5069_2.txt;9;1;0;10;596;0.02;0.0;0.0
10093_1.txt;0;0;0;0;224;0.0;0.0;0.0
12432_1.txt;1;0;0;1;128;0.01;0.0;0.0
6099_4.txt;12;0;0;12;196;0.06;0.0;0.0
9139_1.txt;2;0;0;2;125;0.02;0.0;0.0
6187_2.txt;21;2;1;24;222;0.09;0.01;0.0
9921_3.txt;7;0;0;7;157;0.04;0.0;0.0
5063_1.txt;5;0;0;5;175;0.03;0.0;0.0
6216_2.txt;2;0;0;2;229;0.01;0.0;0.0
10333_1.txt;6;1;0;7;172;0.03;0.01;0.0
3252_1.txt;0;1;0;1;61;0.0;0.02;0.0
12286_3.txt;5;0;0;5;257;0.02;0.0;0.0
3724_1.txt;1;1;0;2;240;0.0;0.0;0.0
3540_2.txt;13;0;1;14;209;0.06;0.0;0.0
7905_1.txt;37;4;0;41;680;0.05;0.01;0.0
12254_2.txt;0;0;0;0;103;0.0;0.0;0.0
166_1.txt;4;0;0;4;235;0.02;0.0;0.0
1714_1.txt;4;0;0;4;177;0.02;0.0;0.0
10931_1.txt;2;0;0;2;170;0.01;0.0;0.0
12037_1.txt;5;0;0;5;175;0.03;0.0;0.0
4348_2.txt;4;0;0;4;201;0.02;0.0;0.0
8903_3.txt;2;0;0;2;87;0.02;0.0;0.0
11052_1.txt;0;0;0;0;276;0.0;0.0;0.0
11232_1.txt;0;2;0;2;139;0.0;0.01;0.0
5643_1.txt;9;0;0;9;185;0.05;0.0;0.0
2049_1.txt;0;0;0;0;269;0.0;0.0;0.0
7813_1.txt;10;0;0;10;228;0.04;0.0;0.0
5578_1.txt;3;1;2;6;109;0.03;0.01;0.02
2424_3.txt;8;0;1;9;582;0.01;0.0;0.0
8907_4.txt;0;0;0;0;240;0.0;0.0;0.0
4795_2.txt;2;0;0;2;255;0.01;0.0;0.0
10239_3.txt;7;0;0;7;121;0.06;0.0;0.0
11737_4.txt;15;1;0;16;479;0.03;0.0;0.0
8019_1.txt;0;2;0;2;344;0.0;0.01;0.0
446_3.txt;9;0;0;9;382;0.02;0.0;0.0
12407_1.txt;6;0;0;6;206;0.03;0.0;0.0
2305_1.txt;6;0;0;6;214;0.03;0.0;0.0
410_4.txt;4;0;0;4;267;0.01;0.0;0.0
9750_1.txt;26;0;0;26;284;0.09;0.0;0.0
11189_1.txt;8;1;0;9;173;0.05;0.01;0.0
6921_1.txt;1;0;0;1;219;0.0;0.0;0.0
11758_1.txt;1;0;0;1;154;0.01;0.0;0.0
4789_4.txt;14;1;0;15;371;0.04;0.0;0.0
7107_2.txt;0;1;0;1;208;0.0;0.0;0.0
9004_1.txt;0;0;0;0;84;0.0;0.0;0.0
8883_2.txt;8;1;0;9;181;0.04;0.01;0.0
3799_3.txt;2;1;0;3;64;0.03;0.02;0.0
7041_1.txt;8;0;0;8;160;0.05;0.0;0.0
6942_1.txt;0;0;0;0;169;0.0;0.0;0.0
11527_1.txt;3;0;0;3;177;0.02;0.0;0.0
11785_1.txt;0;0;0;0;52;0.0;0.0;0.0
6101_4.txt;3;0;0;3;354;0.01;0.0;0.0
8284_1.txt;18;6;0;24;447;0.04;0.01;0.0
7172_2.txt;2;0;0;2;236;0.01;0.0;0.0
10955_1.txt;21;0;2;23;305;0.07;0.0;0.01
81_1.txt;0;0;0;0;143;0.0;0.0;0.0
5086_4.txt;2;1;0;3;115;0.02;0.01;0.0
3130_4.txt;0;0;0;0;150;0.0;0.0;0.0
2955_1.txt;5;0;0;5;149;0.03;0.0;0.0
6766_3.txt;4;0;0;4;242;0.02;0.0;0.0
7103_1.txt;0;0;0;0;242;0.0;0.0;0.0
10023_1.txt;12;0;0;12;244;0.05;0.0;0.0
4828_1.txt;4;6;5;15;257;0.02;0.02;0.02
10594_1.txt;4;0;0;4;52;0.08;0.0;0.0
12245_1.txt;0;2;0;2;125;0.0;0.02;0.0
5992_2.txt;2;0;1;3;166;0.01;0.0;0.01
5437_4.txt;11;1;3;15;169;0.07;0.01;0.02
3668_1.txt;4;0;0;4;249;0.02;0.0;0.0
5956_3.txt;3;1;0;4;138;0.02;0.01;0.0
4447_2.txt;1;0;0;1;256;0.0;0.0;0.0
6593_1.txt;10;0;0;10;130;0.08;0.0;0.0
112_1.txt;10;0;0;10;240;0.04;0.0;0.0
9810_2.txt;4;0;1;5;144;0.03;0.0;0.01
8446_1.txt;3;1;0;4;141;0.02;0.01;0.0
9531_1.txt;1;0;0;1;157;0.01;0.0;0.0
7675_1.txt;4;0;0;4;232;0.02;0.0;0.0
993_2.txt;12;0;0;12;1190;0.01;0.0;0.0
2054_4.txt;4;1;1;6;412;0.01;0.0;0.0
3140_1.txt;4;0;3;7;521;0.01;0.0;0.01
8310_1.txt;2;2;4;8;194;0.01;0.01;0.02
1652_3.txt;2;0;0;2;168;0.01;0.0;0.0
9102_1.txt;2;0;0;2;171;0.01;0.0;0.0
8176_3.txt;4;4;0;8;537;0.01;0.01;0.0
3562_4.txt;3;1;0;4;226;0.01;0.0;0.0
2493_1.txt;0;2;1;3;203;0.0;0.01;0.0
9818_1.txt;2;0;0;2;231;0.01;0.0;0.0
6208_1.txt;19;1;7;27;411;0.05;0.0;0.02
10707_1.txt;2;0;0;2;189;0.01;0.0;0.0
5907_1.txt;0;0;0;0;223;0.0;0.0;0.0
10706_4.txt;2;0;0;2;167;0.01;0.0;0.0
949_1.txt;3;0;0;3;167;0.02;0.0;0.0
12178_1.txt;9;0;0;9;147;0.06;0.0;0.0
9828_3.txt;0;0;0;0;215;0.0;0.0;0.0
8531_3.txt;9;2;0;11;117;0.08;0.02;0.0
193_1.txt;14;0;0;14;145;0.1;0.0;0.0
12366_1.txt;2;0;0;2;134;0.01;0.0;0.0
6034_1.txt;0;0;0;0;185;0.0;0.0;0.0
1828_3.txt;6;0;0;6;171;0.04;0.0;0.0
11802_1.txt;12;0;0;12;264;0.05;0.0;0.0
10052_4.txt;18;1;3;22;220;0.08;0.0;0.01
6350_2.txt;19;4;0;23;382;0.05;0.01;0.0
2315_3.txt;27;0;0;27;438;0.06;0.0;0.0
9507_3.txt;2;0;0;2;144;0.01;0.0;0.0
976_3.txt;13;0;0;13;395;0.03;0.0;0.0
11608_1.txt;0;0;0;0;284;0.0;0.0;0.0
6361_1.txt;0;0;2;2;78;0.0;0.0;0.03
211_4.txt;1;1;0;2;303;0.0;0.0;0.0
3866_2.txt;4;0;0;4;210;0.02;0.0;0.0
8042_3.txt;10;0;0;10;151;0.07;0.0;0.0
5052_1.txt;2;13;3;18;214;0.01;0.06;0.01
7621_4.txt;12;1;0;13;273;0.04;0.0;0.0
5430_3.txt;17;2;0;19;417;0.04;0.0;0.0
11654_4.txt;0;0;0;0;69;0.0;0.0;0.0
3670_3.txt;0;0;0;0;163;0.0;0.0;0.0
6053_1.txt;2;0;0;2;155;0.01;0.0;0.0
5932_2.txt;4;0;0;4;163;0.02;0.0;0.0
4782_4.txt;5;4;1;10;249;0.02;0.02;0.0
6522_1.txt;0;2;0;2;303;0.0;0.01;0.0
7632_3.txt;20;4;2;26;401;0.05;0.01;0.0
7600_1.txt;4;0;0;4;139;0.03;0.0;0.0
6233_4.txt;0;0;0;0;66;0.0;0.0;0.0
5860_1.txt;8;2;0;10;325;0.02;0.01;0.0
11010_1.txt;3;0;0;3;194;0.02;0.0;0.0
4083_3.txt;1;0;0;1;127;0.01;0.0;0.0
4367_4.txt;6;2;0;8;257;0.02;0.01;0.0
10082_4.txt;2;0;0;2;197;0.01;0.0;0.0
3326_4.txt;88;3;0;91;922;0.1;0.0;0.0
7728_3.txt;6;0;0;6;267;0.02;0.0;0.0
7561_2.txt;0;2;0;2;164;0.0;0.01;0.0
8065_3.txt;6;0;3;9;197;0.03;0.0;0.02
10246_2.txt;5;1;0;6;310;0.02;0.0;0.0
7162_1.txt;4;1;0;5;147;0.03;0.01;0.0
5629_2.txt;1;1;0;2;241;0.0;0.0;0.0
9713_2.txt;0;0;0;0;217;0.0;0.0;0.0
8508_1.txt;0;0;0;0;142;0.0;0.0;0.0
11651_3.txt;7;0;4;11;242;0.03;0.0;0.02
11077_2.txt;3;0;2;5;166;0.02;0.0;0.01
11877_1.txt;1;0;1;2;279;0.0;0.0;0.0
8581_1.txt;4;0;0;4;84;0.05;0.0;0.0
8760_2.txt;7;0;0;7;107;0.07;0.0;0.0
9305_1.txt;0;0;0;0;178;0.0;0.0;0.0
4865_3.txt;4;0;0;4;83;0.05;0.0;0.0
7637_4.txt;0;2;0;2;147;0.0;0.01;0.0
6227_2.txt;2;0;0;2;60;0.03;0.0;0.0
10603_1.txt;0;0;1;1;221;0.0;0.0;0.0
5083_1.txt;2;1;0;3;238;0.01;0.0;0.0
6082_4.txt;16;0;0;16;403;0.04;0.0;0.0
4908_3.txt;1;8;0;9;186;0.01;0.04;0.0
6180_3.txt;14;0;3;17;605;0.02;0.0;0.0
10370_4.txt;6;0;0;6;192;0.03;0.0;0.0
4205_1.txt;2;0;0;2;95;0.02;0.0;0.0
499_1.txt;1;0;0;1;377;0.0;0.0;0.0
5989_1.txt;1;0;0;1;153;0.01;0.0;0.0
8367_1.txt;0;0;0;0;126;0.0;0.0;0.0
4537_3.txt;0;0;0;0;177;0.0;0.0;0.0
9127_1.txt;9;2;0;11;310;0.03;0.01;0.0
618_2.txt;2;0;0;2;290;0.01;0.0;0.0
985_4.txt;0;0;0;0;196;0.0;0.0;0.0
7505_3.txt;13;2;1;16;222;0.06;0.01;0.0
3487_1.txt;36;0;0;36;585;0.06;0.0;0.0
7073_3.txt;2;0;0;2;195;0.01;0.0;0.0
1022_1.txt;8;0;0;8;212;0.04;0.0;0.0
5441_1.txt;3;1;1;5;209;0.01;0.0;0.0
736_4.txt;39;2;0;41;391;0.1;0.01;0.0
11523_2.txt;10;0;1;11;294;0.03;0.0;0.0
5671_1.txt;0;0;0;0;214;0.0;0.0;0.0
10774_2.txt;6;0;0;6;155;0.04;0.0;0.0
10336_4.txt;0;0;0;0;53;0.0;0.0;0.0
10445_1.txt;0;0;0;0;165;0.0;0.0;0.0
4533_3.txt;4;6;0;10;541;0.01;0.01;0.0
8500_1.txt;50;4;1;55;617;0.08;0.01;0.0
149_1.txt;4;0;0;4;170;0.02;0.0;0.0
9309_1.txt;2;0;0;2;289;0.01;0.0;0.0
2280_4.txt;46;0;0;46;509;0.09;0.0;0.0
12206_2.txt;13;5;2;20;606;0.02;0.01;0.0
9600_4.txt;6;0;0;6;216;0.03;0.0;0.0
9967_1.txt;2;0;0;2;59;0.03;0.0;0.0
3797_2.txt;24;0;0;24;302;0.08;0.0;0.0
10748_4.txt;0;0;0;0;266;0.0;0.0;0.0
9690_4.txt;34;5;0;39;603;0.06;0.01;0.0
9577_1.txt;2;0;0;2;44;0.05;0.0;0.0
8910_3.txt;0;0;0;0;220;0.0;0.0;0.0
1466_1.txt;13;6;2;21;858;0.02;0.01;0.0
9207_1.txt;9;0;4;13;218;0.04;0.0;0.02
667_2.txt;3;0;0;3;505;0.01;0.0;0.0
10708_3.txt;5;2;0;7;234;0.02;0.01;0.0
9728_3.txt;3;0;0;3;346;0.01;0.0;0.0
1669_2.txt;12;0;0;12;425;0.03;0.0;0.0
9755_2.txt;7;0;0;7;124;0.06;0.0;0.0
1584_1.txt;3;0;0;3;140;0.02;0.0;0.0
5828_2.txt;7;0;0;7;361;0.02;0.0;0.0
11601_3.txt;9;0;0;9;373;0.02;0.0;0.0
10654_1.txt;0;0;0;0;213;0.0;0.0;0.0
11531_2.txt;0;0;0;0;205;0.0;0.0;0.0
5806_4.txt;4;0;0;4;159;0.03;0.0;0.0
833_2.txt;2;1;0;3;160;0.01;0.01;0.0
553_1.txt;1;1;0;2;179;0.01;0.01;0.0
5248_3.txt;4;2;1;7;295;0.01;0.01;0.0
939_2.txt;14;1;0;15;275;0.05;0.0;0.0
5011_1.txt;4;0;0;4;139;0.03;0.0;0.0
3029_1.txt;7;2;2;11;358;0.02;0.01;0.01
11580_2.txt;2;0;0;2;91;0.02;0.0;0.0
10079_1.txt;8;0;0;8;626;0.01;0.0;0.0
11134_1.txt;2;0;0;2;119;0.02;0.0;0.0
12292_1.txt;1;0;0;1;81;0.01;0.0;0.0
3871_3.txt;4;0;0;4;153;0.03;0.0;0.0
7508_2.txt;15;0;0;15;303;0.05;0.0;0.0
556_1.txt;5;0;0;5;318;0.02;0.0;0.0
380_4.txt;4;0;1;5;165;0.02;0.0;0.01
47_2.txt;14;3;0;17;724;0.02;0.0;0.0
7518_2.txt;1;2;2;5;561;0.0;0.0;0.0
6461_4.txt;0;0;0;0;51;0.0;0.0;0.0
2279_2.txt;16;0;0;16;428;0.04;0.0;0.0
6360_1.txt;2;2;5;9;144;0.01;0.01;0.03
11859_4.txt;0;1;0;1;174;0.0;0.01;0.0
7195_2.txt;5;2;1;8;401;0.01;0.0;0.0
1303_2.txt;6;5;0;11;225;0.03;0.02;0.0
9997_2.txt;22;3;3;28;303;0.07;0.01;0.01
7080_4.txt;5;0;0;5;386;0.01;0.0;0.0
12448_4.txt;23;2;2;27;501;0.05;0.0;0.0
304_4.txt;3;0;0;3;139;0.02;0.0;0.0
7323_1.txt;2;0;0;2;173;0.01;0.0;0.0
11561_4.txt;13;1;0;14;554;0.02;0.0;0.0
10010_3.txt;0;0;0;0;118;0.0;0.0;0.0
6202_1.txt;0;1;0;1;100;0.0;0.01;0.0
8921_4.txt;5;0;0;5;196;0.03;0.0;0.0
11372_1.txt;1;10;6;17;676;0.0;0.01;0.01
11760_2.txt;5;0;0;5;157;0.03;0.0;0.0
2892_3.txt;3;0;0;3;178;0.02;0.0;0.0
6428_3.txt;7;0;0;7;414;0.02;0.0;0.0
272_2.txt;7;0;0;7;294;0.02;0.0;0.0
12152_2.txt;2;0;0;2;170;0.01;0.0;0.0
10018_3.txt;2;0;0;2;22;0.09;0.0;0.0
11845_1.txt;13;0;0;13;141;0.09;0.0;0.0
2997_1.txt;2;0;0;2;167;0.01;0.0;0.0
3151_2.txt;12;1;0;13;162;0.07;0.01;0.0
10213_1.txt;0;0;0;0;251;0.0;0.0;0.0
2447_1.txt;5;1;4;10;222;0.02;0.0;0.02
8005_4.txt;0;6;2;8;704;0.0;0.01;0.0
2090_2.txt;0;1;3;4;139;0.0;0.01;0.02
10928_1.txt;6;0;0;6;124;0.05;0.0;0.0
8789_1.txt;2;1;0;3;165;0.01;0.01;0.0
1384_2.txt;11;2;0;13;381;0.03;0.01;0.0
5233_4.txt;7;5;0;12;484;0.01;0.01;0.0
6926_4.txt;4;0;0;4;495;0.01;0.0;0.0
9208_1.txt;2;0;0;2;137;0.01;0.0;0.0
11702_4.txt;45;2;0;47;577;0.08;0.0;0.0
1545_3.txt;30;0;1;31;644;0.05;0.0;0.0
9295_1.txt;0;1;0;1;395;0.0;0.0;0.0
126_1.txt;4;0;0;4;253;0.02;0.0;0.0
4210_2.txt;4;0;0;4;113;0.04;0.0;0.0
1394_4.txt;5;0;0;5;389;0.01;0.0;0.0
10620_4.txt;4;0;1;5;153;0.03;0.0;0.01
6673_2.txt;0;1;3;4;146;0.0;0.01;0.02
7114_4.txt;0;0;0;0;196;0.0;0.0;0.0
12416_3.txt;38;0;9;47;508;0.07;0.0;0.02
3751_2.txt;4;0;0;4;149;0.03;0.0;0.0
2875_1.txt;0;0;2;2;239;0.0;0.0;0.01
5372_1.txt;0;0;0;0;165;0.0;0.0;0.0
8205_1.txt;0;0;0;0;95;0.0;0.0;0.0
8859_3.txt;16;1;0;17;406;0.04;0.0;0.0
7988_1.txt;9;0;2;11;444;0.02;0.0;0.0
9471_1.txt;4;0;0;4;282;0.01;0.0;0.0
10647_2.txt;19;6;0;25;300;0.06;0.02;0.0
1639_1.txt;4;0;3;7;110;0.04;0.0;0.03
8523_4.txt;1;0;0;1;48;0.02;0.0;0.0
4063_2.txt;12;0;0;12;422;0.03;0.0;0.0
9005_4.txt;6;2;0;8;190;0.03;0.01;0.0
4876_4.txt;6;0;0;6;219;0.03;0.0;0.0
7398_4.txt;3;0;1;4;446;0.01;0.0;0.0
4920_4.txt;41;2;0;43;370;0.11;0.01;0.0
9379_1.txt;6;0;0;6;181;0.03;0.0;0.0
6226_1.txt;5;0;1;6;249;0.02;0.0;0.0
2899_1.txt;2;0;0;2;163;0.01;0.0;0.0
7224_3.txt;1;0;0;1;459;0.0;0.0;0.0
4550_3.txt;0;0;0;0;304;0.0;0.0;0.0
12098_4.txt;15;0;1;16;797;0.02;0.0;0.0
4800_3.txt;24;0;0;24;282;0.09;0.0;0.0
11949_3.txt;4;0;0;4;91;0.04;0.0;0.0
10872_3.txt;2;0;0;2;210;0.01;0.0;0.0
7722_3.txt;11;0;0;11;237;0.05;0.0;0.0
9839_1.txt;0;0;0;0;148;0.0;0.0;0.0
8967_4.txt;2;0;0;2;141;0.01;0.0;0.0
10275_3.txt;4;0;0;4;143;0.03;0.0;0.0
8463_1.txt;2;2;0;4;134;0.01;0.01;0.0
3196_1.txt;5;2;0;7;143;0.03;0.01;0.0
6453_2.txt;4;0;0;4;170;0.02;0.0;0.0
5209_1.txt;0;0;0;0;111;0.0;0.0;0.0
4912_4.txt;4;0;0;4;320;0.01;0.0;0.0
1314_1.txt;10;2;0;12;171;0.06;0.01;0.0
5371_3.txt;3;0;0;3;185;0.02;0.0;0.0
2577_2.txt;15;1;0;16;259;0.06;0.0;0.0
9774_1.txt;13;1;0;14;324;0.04;0.0;0.0
1137_4.txt;5;0;0;5;155;0.03;0.0;0.0
10830_1.txt;1;0;0;1;144;0.01;0.0;0.0
11773_1.txt;1;0;3;4;414;0.0;0.0;0.01
1013_2.txt;21;0;3;24;247;0.09;0.0;0.01
3448_1.txt;0;0;0;0;185;0.0;0.0;0.0
2399_1.txt;0;0;0;0;112;0.0;0.0;0.0
11347_3.txt;19;3;0;22;681;0.03;0.0;0.0
7802_1.txt;2;0;0;2;180;0.01;0.0;0.0
10548_3.txt;22;2;0;24;629;0.03;0.0;0.0
3203_1.txt;42;7;14;63;588;0.07;0.01;0.02
5753_1.txt;15;2;0;17;960;0.02;0.0;0.0
2904_2.txt;3;1;0;4;137;0.02;0.01;0.0
9609_3.txt;0;1;0;1;149;0.0;0.01;0.0
10186_1.txt;15;2;2;19;228;0.07;0.01;0.01
11379_3.txt;6;0;0;6;150;0.04;0.0;0.0
994_3.txt;0;0;0;0;139;0.0;0.0;0.0
7564_1.txt;3;1;2;6;182;0.02;0.01;0.01
7937_2.txt;1;1;0;2;168;0.01;0.01;0.0
5722_1.txt;3;0;0;3;238;0.01;0.0;0.0
1657_1.txt;0;1;0;1;97;0.0;0.01;0.0
5423_4.txt;5;0;0;5;473;0.01;0.0;0.0
2707_1.txt;14;0;2;16;540;0.03;0.0;0.0
12452_1.txt;2;0;0;2;166;0.01;0.0;0.0
10039_1.txt;10;1;0;11;262;0.04;0.0;0.0
8456_2.txt;0;0;0;0;124;0.0;0.0;0.0
12050_2.txt;16;0;0;16;349;0.05;0.0;0.0
5651_1.txt;0;0;0;0;143;0.0;0.0;0.0
399_2.txt;8;1;0;9;110;0.07;0.01;0.0
4091_1.txt;3;0;0;3;380;0.01;0.0;0.0
11112_1.txt;2;2;0;4;234;0.01;0.01;0.0
12213_4.txt;4;2;0;6;166;0.02;0.01;0.0
844_1.txt;1;0;0;1;67;0.01;0.0;0.0
9146_1.txt;10;0;0;10;374;0.03;0.0;0.0
3303_4.txt;0;0;0;0;46;0.0;0.0;0.0
11930_2.txt;6;9;2;17;494;0.01;0.02;0.0
4650_2.txt;10;1;0;11;274;0.04;0.0;0.0
8635_4.txt;4;0;0;4;178;0.02;0.0;0.0
9536_4.txt;6;1;1;8;189;0.03;0.01;0.01
11780_3.txt;47;0;0;47;1039;0.05;0.0;0.0
7345_1.txt;0;0;0;0;130;0.0;0.0;0.0
6746_1.txt;0;0;2;2;515;0.0;0.0;0.0
917_1.txt;6;9;5;20;370;0.02;0.02;0.01
4680_4.txt;2;4;1;7;364;0.01;0.01;0.0
5359_1.txt;22;5;1;28;482;0.05;0.01;0.0
1762_1.txt;8;0;0;8;165;0.05;0.0;0.0
2477_2.txt;4;0;0;4;146;0.03;0.0;0.0
2546_1.txt;0;2;0;2;92;0.0;0.02;0.0
5287_1.txt;7;0;0;7;203;0.03;0.0;0.0
4849_1.txt;0;1;0;1;281;0.0;0.0;0.0
11889_1.txt;6;0;0;6;113;0.05;0.0;0.0
2374_1.txt;17;2;0;19;679;0.03;0.0;0.0
3118_1.txt;0;0;2;2;175;0.0;0.0;0.01
8204_4.txt;7;2;3;12;463;0.02;0.0;0.01
5478_4.txt;2;1;0;3;143;0.01;0.01;0.0
8972_3.txt;0;0;0;0;62;0.0;0.0;0.0
10277_1.txt;1;0;0;1;148;0.01;0.0;0.0
9752_1.txt;2;0;2;4;340;0.01;0.0;0.01
10908_1.txt;4;0;0;4;249;0.02;0.0;0.0
1309_1.txt;0;0;0;0;142;0.0;0.0;0.0
7169_3.txt;11;0;0;11;77;0.14;0.0;0.0
6781_4.txt;9;2;0;11;207;0.04;0.01;0.0
3737_3.txt;18;0;0;18;460;0.04;0.0;0.0
11549_2.txt;0;0;0;0;158;0.0;0.0;0.0
10919_4.txt;27;3;5;35;296;0.09;0.01;0.02
10046_1.txt;1;0;0;1;170;0.01;0.0;0.0
1181_3.txt;0;0;0;0;170;0.0;0.0;0.0
11340_4.txt;3;0;1;4;150;0.02;0.0;0.01
11243_1.txt;24;0;2;26;765;0.03;0.0;0.0
3795_1.txt;12;5;3;20;1148;0.01;0.0;0.0
8844_4.txt;0;0;0;0;203;0.0;0.0;0.0
371_1.txt;0;0;0;0;60;0.0;0.0;0.0
6489_1.txt;0;0;0;0;135;0.0;0.0;0.0
5159_2.txt;4;0;0;4;159;0.03;0.0;0.0
9601_4.txt;3;0;0;3;464;0.01;0.0;0.0
5922_1.txt;0;0;0;0;101;0.0;0.0;0.0
6735_4.txt;9;0;0;9;311;0.03;0.0;0.0
2343_4.txt;2;5;0;7;555;0.0;0.01;0.0
6649_1.txt;0;1;0;1;217;0.0;0.0;0.0
5530_1.txt;3;3;2;8;345;0.01;0.01;0.01
6548_1.txt;0;1;0;1;341;0.0;0.0;0.0
9976_1.txt;6;0;0;6;170;0.04;0.0;0.0
2160_1.txt;7;0;1;8;497;0.01;0.0;0.0
7459_1.txt;0;0;0;0;109;0.0;0.0;0.0
1056_3.txt;5;0;0;5;209;0.02;0.0;0.0
7864_4.txt;0;0;2;2;228;0.0;0.0;0.01
12112_2.txt;0;0;0;0;147;0.0;0.0;0.0
6111_1.txt;23;2;2;27;383;0.06;0.01;0.01
322_1.txt;2;0;0;2;331;0.01;0.0;0.0
5883_1.txt;0;0;0;0;149;0.0;0.0;0.0
733_4.txt;23;0;0;23;535;0.04;0.0;0.0
7168_4.txt;2;0;0;2;119;0.02;0.0;0.0
656_3.txt;15;1;0;16;919;0.02;0.0;0.0
1833_1.txt;11;2;0;13;240;0.05;0.01;0.0
6236_1.txt;1;0;4;5;130;0.01;0.0;0.03
7379_2.txt;11;0;2;13;219;0.05;0.0;0.01
1650_4.txt;1;0;0;1;142;0.01;0.0;0.0
7795_1.txt;0;0;0;0;190;0.0;0.0;0.0
10911_1.txt;2;0;0;2;83;0.02;0.0;0.0
2567_3.txt;2;0;0;2;58;0.03;0.0;0.0
4696_1.txt;3;0;1;4;141;0.02;0.0;0.01
3350_3.txt;2;0;0;2;42;0.05;0.0;0.0
4791_3.txt;8;0;2;10;296;0.03;0.0;0.01
12185_3.txt;5;0;1;6;101;0.05;0.0;0.01
5289_3.txt;31;2;2;35;986;0.03;0.0;0.0
10030_1.txt;29;1;0;30;553;0.05;0.0;0.0
1920_4.txt;6;0;0;6;180;0.03;0.0;0.0
6924_1.txt;5;0;0;5;145;0.03;0.0;0.0
3758_3.txt;3;2;0;5;169;0.02;0.01;0.0
11597_4.txt;17;0;0;17;257;0.07;0.0;0.0
8922_4.txt;8;0;0;8;240;0.03;0.0;0.0
3826_1.txt;4;0;3;7;96;0.04;0.0;0.03
3410_3.txt;6;0;0;6;270;0.02;0.0;0.0
8614_2.txt;10;1;0;11;150;0.07;0.01;0.0
207_1.txt;0;0;1;1;105;0.0;0.0;0.01
12097_4.txt;2;0;0;2;142;0.01;0.0;0.0
6396_2.txt;0;0;0;0;63;0.0;0.0;0.0
2952_2.txt;22;0;0;22;585;0.04;0.0;0.0
297_4.txt;7;0;0;7;245;0.03;0.0;0.0
8113_4.txt;7;0;0;7;254;0.03;0.0;0.0
7378_4.txt;6;0;0;6;700;0.01;0.0;0.0
8840_3.txt;2;0;0;2;288;0.01;0.0;0.0
5295_1.txt;3;0;0;3;220;0.01;0.0;0.0
3053_1.txt;6;0;2;8;164;0.04;0.0;0.01
6618_2.txt;14;3;7;24;556;0.03;0.01;0.01
10737_3.txt;2;2;0;4;633;0.0;0.0;0.0
1116_3.txt;25;0;5;30;357;0.07;0.0;0.01
4370_3.txt;20;0;1;21;445;0.04;0.0;0.0
9036_3.txt;3;0;0;3;165;0.02;0.0;0.0
5107_1.txt;1;3;0;4;229;0.0;0.01;0.0
6847_3.txt;12;2;0;14;172;0.07;0.01;0.0
2649_2.txt;2;1;0;3;138;0.01;0.01;0.0
3416_4.txt;3;0;0;3;52;0.06;0.0;0.0
240_1.txt;13;0;0;13;179;0.07;0.0;0.0
4552_4.txt;8;13;3;24;831;0.01;0.02;0.0
5080_2.txt;2;1;5;8;309;0.01;0.0;0.02
7816_1.txt;11;1;1;13;572;0.02;0.0;0.0
8720_3.txt;2;0;1;3;162;0.01;0.0;0.01
4873_1.txt;2;0;0;2;77;0.03;0.0;0.0
3725_4.txt;4;4;0;8;317;0.01;0.01;0.0
7955_2.txt;14;0;0;14;374;0.04;0.0;0.0
6316_2.txt;12;4;3;19;539;0.02;0.01;0.01
4509_3.txt;28;3;0;31;445;0.06;0.01;0.0
10724_2.txt;0;0;0;0;172;0.0;0.0;0.0
12164_1.txt;0;5;0;5;236;0.0;0.02;0.0
5831_1.txt;7;0;1;8;303;0.02;0.0;0.0
2168_1.txt;0;0;0;0;137;0.0;0.0;0.0
2164_2.txt;11;0;0;11;152;0.07;0.0;0.0
4170_1.txt;5;0;1;6;234;0.02;0.0;0.0
6973_3.txt;3;0;0;3;416;0.01;0.0;0.0
237_1.txt;1;2;0;3;140;0.01;0.01;0.0
1111_2.txt;3;2;0;5;190;0.02;0.01;0.0
2329_3.txt;27;1;0;28;595;0.05;0.0;0.0
3109_4.txt;10;0;0;10;148;0.07;0.0;0.0
2405_2.txt;7;1;2;10;276;0.03;0.0;0.01
121_4.txt;10;2;0;12;129;0.08;0.02;0.0
12186_1.txt;18;1;0;19;300;0.06;0.0;0.0
8302_2.txt;8;0;0;8;209;0.04;0.0;0.0
5746_1.txt;0;0;0;0;247;0.0;0.0;0.0
11408_1.txt;2;0;0;2;158;0.01;0.0;0.0
3010_1.txt;0;0;0;0;152;0.0;0.0;0.0
2133_4.txt;19;4;6;29;614;0.03;0.01;0.01
11110_3.txt;0;0;1;1;294;0.0;0.0;0.0
6139_1.txt;8;0;1;9;181;0.04;0.0;0.01
10789_3.txt;0;0;0;0;164;0.0;0.0;0.0
10518_1.txt;2;0;0;2;144;0.01;0.0;0.0
5900_4.txt;9;0;0;9;388;0.02;0.0;0.0
7052_4.txt;2;0;0;2;147;0.01;0.0;0.0
2019_2.txt;2;1;3;6;106;0.02;0.01;0.03
2195_2.txt;2;0;0;2;173;0.01;0.0;0.0
11314_1.txt;11;0;0;11;281;0.04;0.0;0.0
1415_4.txt;20;1;0;21;409;0.05;0.0;0.0
250_3.txt;7;0;0;7;128;0.05;0.0;0.0
866_2.txt;17;0;0;17;467;0.04;0.0;0.0
2942_1.txt;3;0;0;3;59;0.05;0.0;0.0
1523_1.txt;0;0;0;0;122;0.0;0.0;0.0
8416_1.txt;7;2;0;9;143;0.05;0.01;0.0
1514_1.txt;9;3;0;12;350;0.03;0.01;0.0
10937_1.txt;2;0;0;2;199;0.01;0.0;0.0
7068_3.txt;52;1;3;56;802;0.06;0.0;0.0
1078_4.txt;20;0;0;20;199;0.1;0.0;0.0
2804_4.txt;8;1;0;9;168;0.05;0.01;0.0
634_2.txt;5;1;0;6;704;0.01;0.0;0.0
8303_2.txt;8;0;0;8;235;0.03;0.0;0.0
2949_1.txt;2;0;0;2;229;0.01;0.0;0.0
8706_2.txt;0;1;1;2;229;0.0;0.0;0.0
4009_3.txt;18;0;3;21;504;0.04;0.0;0.01
5328_2.txt;12;2;0;14;253;0.05;0.01;0.0
5833_1.txt;3;0;1;4;142;0.02;0.0;0.01
2223_3.txt;5;0;0;5;127;0.04;0.0;0.0
6285_1.txt;2;0;0;2;196;0.01;0.0;0.0
4409_2.txt;11;2;1;14;159;0.07;0.01;0.01
6824_4.txt;3;0;2;5;130;0.02;0.0;0.02
9194_1.txt;9;0;0;9;254;0.04;0.0;0.0
2966_1.txt;0;0;0;0;169;0.0;0.0;0.0
10311_3.txt;7;0;1;8;172;0.04;0.0;0.01
6965_1.txt;0;0;0;0;52;0.0;0.0;0.0
889_3.txt;0;4;0;4;152;0.0;0.03;0.0
5582_3.txt;0;0;0;0;224;0.0;0.0;0.0
8268_1.txt;2;0;0;2;190;0.01;0.0;0.0
11479_3.txt;14;3;1;18;584;0.02;0.01;0.0
117_3.txt;18;0;0;18;303;0.06;0.0;0.0
9861_3.txt;9;0;1;10;149;0.06;0.0;0.01
2260_1.txt;9;0;1;10;178;0.05;0.0;0.01
5520_1.txt;0;0;0;0;176;0.0;0.0;0.0
3741_1.txt;0;0;0;0;55;0.0;0.0;0.0
4431_4.txt;17;0;3;20;235;0.07;0.0;0.01
3598_3.txt;2;0;0;2;382;0.01;0.0;0.0
5794_2.txt;8;0;0;8;187;0.04;0.0;0.0
3808_1.txt;38;1;0;39;770;0.05;0.0;0.0
3770_4.txt;20;0;0;20;211;0.09;0.0;0.0
8485_3.txt;0;0;0;0;142;0.0;0.0;0.0
2688_1.txt;21;20;2;43;801;0.03;0.02;0.0
1219_1.txt;13;0;0;13;590;0.02;0.0;0.0
9218_4.txt;9;0;0;9;646;0.01;0.0;0.0
1914_4.txt;0;0;0;0;75;0.0;0.0;0.0
11242_1.txt;0;0;0;0;205;0.0;0.0;0.0
11375_2.txt;5;0;0;5;206;0.02;0.0;0.0
6874_4.txt;6;1;0;7;193;0.03;0.01;0.0
9912_4.txt;0;0;0;0;166;0.0;0.0;0.0
3535_1.txt;9;0;6;15;849;0.01;0.0;0.01
2626_4.txt;0;0;0;0;152;0.0;0.0;0.0
772_4.txt;8;1;1;10;223;0.04;0.0;0.0
3789_3.txt;24;3;0;27;936;0.03;0.0;0.0
10701_4.txt;13;1;0;14;148;0.09;0.01;0.0
11823_4.txt;20;5;3;28;280;0.07;0.02;0.01
5297_4.txt;2;2;0;4;317;0.01;0.01;0.0
8016_2.txt;4;2;0;6;621;0.01;0.0;0.0
3514_4.txt;4;0;0;4;168;0.02;0.0;0.0
9793_1.txt;1;0;3;4;125;0.01;0.0;0.02
5494_3.txt;11;0;0;11;105;0.1;0.0;0.0
4956_1.txt;17;0;0;17;271;0.06;0.0;0.0
421_4.txt;0;0;3;3;325;0.0;0.0;0.01
7656_1.txt;5;1;0;6;365;0.01;0.0;0.0
276_2.txt;3;0;0;3;88;0.03;0.0;0.0
6292_3.txt;2;0;0;2;243;0.01;0.0;0.0
268_1.txt;2;0;0;2;325;0.01;0.0;0.0
5804_1.txt;18;0;1;19;548;0.03;0.0;0.0
3649_4.txt;10;0;0;10;218;0.05;0.0;0.0
5571_1.txt;0;0;0;0;44;0.0;0.0;0.0
11296_3.txt;5;0;0;5;571;0.01;0.0;0.0
7048_2.txt;5;0;0;5;131;0.04;0.0;0.0
7736_2.txt;3;9;0;12;491;0.01;0.02;0.0
6480_3.txt;5;0;0;5;80;0.06;0.0;0.0
2037_1.txt;0;0;0;0;147;0.0;0.0;0.0
620_1.txt;1;0;0;1;463;0.0;0.0;0.0
12129_4.txt;6;0;0;6;253;0.02;0.0;0.0
1289_2.txt;2;0;0;2;97;0.02;0.0;0.0
6574_4.txt;12;11;2;25;365;0.03;0.03;0.01
9490_1.txt;0;0;0;0;156;0.0;0.0;0.0
12127_1.txt;1;0;0;1;162;0.01;0.0;0.0
8990_3.txt;35;0;0;35;487;0.07;0.0;0.0
7331_2.txt;0;0;0;0;220;0.0;0.0;0.0
6046_2.txt;5;0;0;5;203;0.02;0.0;0.0
8837_1.txt;1;0;0;1;634;0.0;0.0;0.0
2026_2.txt;8;0;0;8;327;0.02;0.0;0.0
9986_2.txt;3;0;0;3;148;0.02;0.0;0.0
9916_2.txt;11;0;0;11;287;0.04;0.0;0.0
7232_4.txt;5;2;0;7;241;0.02;0.01;0.0
1036_3.txt;12;0;1;13;104;0.12;0.0;0.01
3144_1.txt;4;0;0;4;48;0.08;0.0;0.0
7901_3.txt;48;5;5;58;1132;0.04;0.0;0.0
3019_2.txt;0;0;0;0;162;0.0;0.0;0.0
4945_4.txt;3;0;0;3;153;0.02;0.0;0.0
6415_3.txt;3;0;0;3;144;0.02;0.0;0.0
6961_2.txt;9;0;4;13;165;0.05;0.0;0.02
11645_2.txt;10;1;2;13;359;0.03;0.0;0.01
4785_2.txt;4;0;0;4;615;0.01;0.0;0.0
3637_1.txt;0;2;0;2;236;0.0;0.01;0.0
4184_4.txt;5;0;2;7;512;0.01;0.0;0.0
2523_1.txt;5;0;3;8;153;0.03;0.0;0.02
5679_1.txt;0;0;1;1;143;0.0;0.0;0.01
9975_3.txt;2;0;0;2;235;0.01;0.0;0.0
5780_4.txt;5;0;0;5;194;0.03;0.0;0.0
9856_4.txt;12;2;0;14;255;0.05;0.01;0.0
245_1.txt;0;0;0;0;198;0.0;0.0;0.0
10347_4.txt;34;1;2;37;450;0.08;0.0;0.0
375_2.txt;6;0;0;6;447;0.01;0.0;0.0
7260_1.txt;29;2;0;31;563;0.05;0.0;0.0
4516_2.txt;0;0;0;0;267;0.0;0.0;0.0
3787_1.txt;0;1;0;1;127;0.0;0.01;0.0
10200_4.txt;0;0;0;0;62;0.0;0.0;0.0
6831_4.txt;0;0;0;0;139;0.0;0.0;0.0
6238_1.txt;8;1;0;9;362;0.02;0.0;0.0
5962_4.txt;7;0;0;7;255;0.03;0.0;0.0
5396_3.txt;1;0;0;1;242;0.0;0.0;0.0
152_4.txt;15;0;0;15;355;0.04;0.0;0.0
1877_3.txt;14;1;4;19;446;0.03;0.0;0.01
6978_3.txt;30;2;0;32;695;0.04;0.0;0.0
3984_1.txt;11;0;1;12;160;0.07;0.0;0.01
10391_3.txt;0;0;0;0;628;0.0;0.0;0.0
9991_4.txt;3;7;4;14;577;0.01;0.01;0.01
5049_3.txt;5;0;0;5;214;0.02;0.0;0.0
12054_2.txt;1;1;0;2;241;0.0;0.0;0.0
4869_3.txt;2;0;0;2;120;0.02;0.0;0.0
6039_3.txt;16;1;9;26;1055;0.02;0.0;0.01
2631_1.txt;0;3;4;7;140;0.0;0.02;0.03
5910_2.txt;0;0;0;0;53;0.0;0.0;0.0
6878_1.txt;2;4;0;6;198;0.01;0.02;0.0
9162_1.txt;1;0;1;2;205;0.0;0.0;0.0
10509_3.txt;6;1;0;7;205;0.03;0.0;0.0
2175_1.txt;4;0;0;4;221;0.02;0.0;0.0
2582_2.txt;1;0;4;5;206;0.0;0.0;0.02
2996_4.txt;0;0;3;3;160;0.0;0.0;0.02
10803_3.txt;0;1;0;1;173;0.0;0.01;0.0
9826_1.txt;0;0;0;0;176;0.0;0.0;0.0
11842_4.txt;3;0;0;3;116;0.03;0.0;0.0
6173_1.txt;3;1;0;4;77;0.04;0.01;0.0
1847_3.txt;4;0;0;4;394;0.01;0.0;0.0
1767_1.txt;0;0;0;0;199;0.0;0.0;0.0
451_2.txt;0;0;0;0;104;0.0;0.0;0.0
4866_1.txt;1;0;0;1;52;0.02;0.0;0.0
8719_2.txt;0;0;0;0;120;0.0;0.0;0.0
9010_3.txt;1;1;0;2;627;0.0;0.0;0.0
880_4.txt;16;2;0;18;235;0.07;0.01;0.0
12089_4.txt;13;1;0;14;464;0.03;0.0;0.0
3135_2.txt;0;1;0;1;148;0.0;0.01;0.0
8769_4.txt;0;0;1;1;214;0.0;0.0;0.0
6883_4.txt;7;1;0;8;114;0.06;0.01;0.0
1730_1.txt;0;0;1;1;158;0.0;0.0;0.01
11459_4.txt;11;0;0;11;190;0.06;0.0;0.0
8717_2.txt;5;0;3;8;250;0.02;0.0;0.01
9250_4.txt;6;0;0;6;60;0.1;0.0;0.0
3579_1.txt;4;1;0;5;211;0.02;0.0;0.0
7588_1.txt;6;1;0;7;248;0.02;0.0;0.0
7909_2.txt;0;0;0;0;132;0.0;0.0;0.0
9302_1.txt;0;0;0;0;205;0.0;0.0;0.0
12436_3.txt;0;0;0;0;433;0.0;0.0;0.0
2563_1.txt;4;0;0;4;176;0.02;0.0;0.0
1075_1.txt;0;0;0;0;59;0.0;0.0;0.0
6662_1.txt;4;1;3;8;422;0.01;0.0;0.01
9317_1.txt;0;2;1;3;332;0.0;0.01;0.0
3763_3.txt;0;0;0;0;153;0.0;0.0;0.0
6165_4.txt;4;0;0;4;172;0.02;0.0;0.0
8289_4.txt;3;0;1;4;166;0.02;0.0;0.01
3803_4.txt;7;0;4;11;521;0.01;0.0;0.01
11334_1.txt;0;1;0;1;201;0.0;0.0;0.0
11636_3.txt;1;0;0;1;210;0.0;0.0;0.0
302_4.txt;2;0;0;2;142;0.01;0.0;0.0
558_3.txt;25;0;0;25;455;0.05;0.0;0.0
11002_1.txt;0;0;0;0;253;0.0;0.0;0.0
2856_1.txt;28;0;1;29;639;0.04;0.0;0.0
1764_2.txt;2;0;1;3;150;0.01;0.0;0.01
7566_1.txt;46;1;1;48;1194;0.04;0.0;0.0
7649_4.txt;15;1;6;22;204;0.07;0.0;0.03
4697_1.txt;0;0;0;0;146;0.0;0.0;0.0
4206_1.txt;4;0;0;4;170;0.02;0.0;0.0
1566_3.txt;1;1;0;2;170;0.01;0.01;0.0
3049_2.txt;0;4;0;4;251;0.0;0.02;0.0
6390_2.txt;0;0;0;0;90;0.0;0.0;0.0
4649_3.txt;9;0;3;12;177;0.05;0.0;0.02
2063_3.txt;0;2;3;5;140;0.0;0.01;0.02
8893_4.txt;25;3;3;31;341;0.07;0.01;0.01
8224_1.txt;0;0;0;0;134;0.0;0.0;0.0
1765_4.txt;10;1;1;12;142;0.07;0.01;0.01
6298_2.txt;2;0;0;2;114;0.02;0.0;0.0
11199_1.txt;0;0;0;0;101;0.0;0.0;0.0
1599_1.txt;0;0;2;2;107;0.0;0.0;0.02
9836_4.txt;43;2;1;46;350;0.12;0.01;0.0
1045_2.txt;7;0;0;7;193;0.04;0.0;0.0
3785_3.txt;5;0;0;5;142;0.04;0.0;0.0
11899_2.txt;2;2;0;4;128;0.02;0.02;0.0
4379_1.txt;0;0;0;0;171;0.0;0.0;0.0
6912_1.txt;0;0;0;0;223;0.0;0.0;0.0
10141_2.txt;30;8;3;41;480;0.06;0.02;0.01
4313_4.txt;8;0;0;8;241;0.03;0.0;0.0
9851_1.txt;7;0;0;7;132;0.05;0.0;0.0
1247_4.txt;0;0;0;0;40;0.0;0.0;0.0
9937_3.txt;7;0;1;8;340;0.02;0.0;0.0
8880_3.txt;0;0;0;0;81;0.0;0.0;0.0
9367_2.txt;3;0;0;3;529;0.01;0.0;0.0
11425_1.txt;2;0;0;2;148;0.01;0.0;0.0
12081_1.txt;4;0;0;4;141;0.03;0.0;0.0
5104_1.txt;4;1;0;5;173;0.02;0.01;0.0
1908_3.txt;1;1;0;2;154;0.01;0.01;0.0
4020_1.txt;24;0;2;26;429;0.06;0.0;0.0
5723_1.txt;0;0;0;0;267;0.0;0.0;0.0
6483_1.txt;2;0;3;5;237;0.01;0.0;0.01
11624_4.txt;13;0;0;13;196;0.07;0.0;0.0
2757_1.txt;0;0;0;0;202;0.0;0.0;0.0
2621_4.txt;1;0;1;2;126;0.01;0.0;0.01
3279_2.txt;1;0;3;4;231;0.0;0.0;0.01
9214_3.txt;7;0;0;7;143;0.05;0.0;0.0
8272_3.txt;27;4;0;31;519;0.05;0.01;0.0
11585_1.txt;20;0;3;23;867;0.02;0.0;0.0
10177_1.txt;0;0;0;0;50;0.0;0.0;0.0
8574_4.txt;46;2;3;51;895;0.05;0.0;0.0
8267_1.txt;4;0;0;4;326;0.01;0.0;0.0
11953_1.txt;4;0;0;4;219;0.02;0.0;0.0
5203_1.txt;0;2;0;2;341;0.0;0.01;0.0
10763_3.txt;2;0;0;2;173;0.01;0.0;0.0
4987_1.txt;2;0;0;2;334;0.01;0.0;0.0
10243_1.txt;0;0;2;2;157;0.0;0.0;0.01
6423_3.txt;7;3;0;10;355;0.02;0.01;0.0
9619_4.txt;0;0;0;0;146;0.0;0.0;0.0
7188_4.txt;2;0;0;2;223;0.01;0.0;0.0
5072_3.txt;8;5;0;13;442;0.02;0.01;0.0
7284_1.txt;32;9;6;47;764;0.04;0.01;0.01
7094_1.txt;26;0;2;28;656;0.04;0.0;0.0
6678_2.txt;5;1;0;6;163;0.03;0.01;0.0
2620_3.txt;10;0;0;10;258;0.04;0.0;0.0
8491_4.txt;12;0;0;12;161;0.07;0.0;0.0
12468_1.txt;0;0;1;1;212;0.0;0.0;0.0
9259_3.txt;0;0;0;0;131;0.0;0.0;0.0
6041_1.txt;18;2;0;20;177;0.1;0.01;0.0
8305_3.txt;5;0;0;5;172;0.03;0.0;0.0
8730_3.txt;24;4;1;29;519;0.05;0.01;0.0
2854_3.txt;18;0;0;18;265;0.07;0.0;0.0
11829_3.txt;5;0;3;8;227;0.02;0.0;0.01
9072_1.txt;0;0;0;0;133;0.0;0.0;0.0
650_1.txt;16;3;11;30;584;0.03;0.01;0.02
4241_2.txt;1;0;2;3;176;0.01;0.0;0.01
8601_1.txt;4;2;1;7;244;0.02;0.01;0.0
377_1.txt;8;0;0;8;135;0.06;0.0;0.0
9149_1.txt;0;0;1;1;172;0.0;0.0;0.01
8655_1.txt;5;0;0;5;141;0.04;0.0;0.0
10307_2.txt;6;0;0;6;380;0.02;0.0;0.0
12040_4.txt;2;0;0;2;188;0.01;0.0;0.0
11433_4.txt;2;1;0;3;173;0.01;0.01;0.0
11048_4.txt;2;0;0;2;28;0.07;0.0;0.0
7744_1.txt;10;2;11;23;686;0.01;0.0;0.02
9840_3.txt;7;0;0;7;170;0.04;0.0;0.0
6299_1.txt;10;0;0;10;179;0.06;0.0;0.0
6829_1.txt;0;0;0;0;79;0.0;0.0;0.0
3972_4.txt;24;1;0;25;592;0.04;0.0;0.0
7709_1.txt;0;0;0;0;88;0.0;0.0;0.0
7205_1.txt;0;0;0;0;117;0.0;0.0;0.0
7009_4.txt;16;5;3;24;538;0.03;0.01;0.01
12419_1.txt;1;0;0;1;636;0.0;0.0;0.0
723_2.txt;2;0;0;2;112;0.02;0.0;0.0
12191_4.txt;54;10;0;64;852;0.06;0.01;0.0
11944_4.txt;0;0;0;0;82;0.0;0.0;0.0
6832_2.txt;10;0;0;10;159;0.06;0.0;0.0
7740_3.txt;17;1;0;18;568;0.03;0.0;0.0
10994_1.txt;3;0;0;3;64;0.05;0.0;0.0
510_1.txt;4;2;0;6;172;0.02;0.01;0.0
6822_2.txt;2;6;0;8;202;0.01;0.03;0.0
8250_1.txt;0;1;1;2;188;0.0;0.01;0.01
10476_1.txt;1;0;0;1;169;0.01;0.0;0.0
4455_3.txt;6;2;2;10;369;0.02;0.01;0.01
7648_1.txt;0;0;0;0;198;0.0;0.0;0.0
8170_2.txt;0;0;0;0;147;0.0;0.0;0.0
5480_4.txt;0;0;0;0;135;0.0;0.0;0.0
1342_1.txt;8;0;0;8;218;0.04;0.0;0.0
3282_3.txt;3;0;0;3;171;0.02;0.0;0.0
6264_2.txt;13;2;0;15;353;0.04;0.01;0.0
3343_4.txt;4;0;0;4;173;0.02;0.0;0.0
10318_2.txt;2;2;8;12;301;0.01;0.01;0.03
8757_2.txt;5;0;0;5;91;0.05;0.0;0.0
189_1.txt;0;1;0;1;93;0.0;0.01;0.0
6432_1.txt;1;0;1;2;253;0.0;0.0;0.0
5732_1.txt;0;2;0;2;146;0.0;0.01;0.0
1647_1.txt;6;0;2;8;283;0.02;0.0;0.01
3537_1.txt;5;1;2;8;519;0.01;0.0;0.0
11856_1.txt;6;1;0;7;163;0.04;0.01;0.0
3723_1.txt;3;0;0;3;164;0.02;0.0;0.0
11820_4.txt;11;0;0;11;340;0.03;0.0;0.0
11145_1.txt;0;0;0;0;114;0.0;0.0;0.0
8071_3.txt;6;0;0;6;294;0.02;0.0;0.0
6509_4.txt;5;0;0;5;150;0.03;0.0;0.0
3903_1.txt;22;0;0;22;411;0.05;0.0;0.0
1542_4.txt;0;0;0;0;316;0.0;0.0;0.0
12420_3.txt;0;0;0;0;174;0.0;0.0;0.0
9915_2.txt;17;0;0;17;421;0.04;0.0;0.0
1896_4.txt;4;0;0;4;99;0.04;0.0;0.0
3188_1.txt;12;1;0;13;110;0.11;0.01;0.0
11506_2.txt;1;0;0;1;112;0.01;0.0;0.0
961_1.txt;26;0;0;26;479;0.05;0.0;0.0
875_4.txt;0;1;0;1;526;0.0;0.0;0.0
799_2.txt;8;0;1;9;308;0.03;0.0;0.0
12000_3.txt;9;3;0;12;240;0.04;0.01;0.0
1682_2.txt;10;0;0;10;546;0.02;0.0;0.0
4139_1.txt;0;0;0;0;116;0.0;0.0;0.0
9550_1.txt;0;0;0;0;143;0.0;0.0;0.0
529_1.txt;4;0;0;4;211;0.02;0.0;0.0
6747_1.txt;0;0;2;2;234;0.0;0.0;0.01
5506_2.txt;0;0;0;0;117;0.0;0.0;0.0
2877_1.txt;12;2;2;16;487;0.02;0.0;0.0
1805_1.txt;13;2;0;15;698;0.02;0.0;0.0
125_1.txt;0;0;0;0;99;0.0;0.0;0.0
2057_3.txt;2;0;0;2;67;0.03;0.0;0.0
2521_3.txt;2;0;1;3;142;0.01;0.0;0.01
10174_4.txt;0;0;1;1;117;0.0;0.0;0.01
6006_4.txt;8;3;0;11;369;0.02;0.01;0.0
246_3.txt;8;5;0;13;265;0.03;0.02;0.0
8607_1.txt;2;0;0;2;513;0.0;0.0;0.0
2234_1.txt;2;0;0;2;178;0.01;0.0;0.0
11458_3.txt;6;1;7;14;176;0.03;0.01;0.04
10900_3.txt;9;0;0;9;305;0.03;0.0;0.0
1350_1.txt;5;1;0;6;262;0.02;0.0;0.0
12009_3.txt;4;0;0;4;199;0.02;0.0;0.0
4410_4.txt;2;0;0;2;69;0.03;0.0;0.0
3511_4.txt;6;0;2;8;238;0.03;0.0;0.01
4419_3.txt;0;1;3;4;449;0.0;0.0;0.01
1390_2.txt;2;0;0;2;210;0.01;0.0;0.0
7822_1.txt;2;0;0;2;212;0.01;0.0;0.0
11642_1.txt;5;0;0;5;490;0.01;0.0;0.0
258_4.txt;2;0;1;3;167;0.01;0.0;0.01
12303_1.txt;11;0;0;11;223;0.05;0.0;0.0
6870_4.txt;15;1;0;16;301;0.05;0.0;0.0
100_3.txt;1;0;0;1;119;0.01;0.0;0.0
2714_4.txt;25;0;1;26;143;0.17;0.0;0.01
11828_3.txt;12;1;2;15;278;0.04;0.0;0.01
1836_2.txt;15;0;0;15;148;0.1;0.0;0.0
591_4.txt;2;0;0;2;368;0.01;0.0;0.0
8952_3.txt;4;2;0;6;640;0.01;0.0;0.0
354_3.txt;10;0;1;11;95;0.11;0.0;0.01
3368_1.txt;8;0;0;8;124;0.06;0.0;0.0
7419_1.txt;4;5;0;9;198;0.02;0.03;0.0
3289_1.txt;10;0;0;10;197;0.05;0.0;0.0
3822_2.txt;76;7;6;89;1185;0.06;0.01;0.01
1249_2.txt;12;0;1;13;306;0.04;0.0;0.0
1704_1.txt;0;0;0;0;168;0.0;0.0;0.0
1001_4.txt;2;0;0;2;203;0.01;0.0;0.0
1288_4.txt;0;0;0;0;43;0.0;0.0;0.0
2108_4.txt;15;1;0;16;273;0.05;0.0;0.0
5943_3.txt;12;3;2;17;446;0.03;0.01;0.0
550_4.txt;16;0;3;19;248;0.06;0.0;0.01
8484_4.txt;10;1;0;11;188;0.05;0.01;0.0
11967_3.txt;9;1;0;10;190;0.05;0.01;0.0
7121_1.txt;4;0;1;5;264;0.02;0.0;0.0
3854_1.txt;2;0;0;2;99;0.02;0.0;0.0
9303_1.txt;5;0;3;8;268;0.02;0.0;0.01
1935_4.txt;0;0;0;0;171;0.0;0.0;0.0
7824_1.txt;53;1;0;54;812;0.07;0.0;0.0
8475_3.txt;4;1;0;5;220;0.02;0.0;0.0
11748_1.txt;0;0;0;0;163;0.0;0.0;0.0
3043_1.txt;0;3;0;3;120;0.0;0.03;0.0
3524_1.txt;0;0;0;0;171;0.0;0.0;0.0
7426_1.txt;13;0;1;14;295;0.04;0.0;0.0
3596_2.txt;0;0;0;0;203;0.0;0.0;0.0
402_2.txt;2;1;1;4;151;0.01;0.01;0.01
1358_4.txt;10;0;0;10;333;0.03;0.0;0.0
10473_3.txt;0;0;0;0;177;0.0;0.0;0.0
8276_2.txt;2;0;0;2;144;0.01;0.0;0.0
11455_1.txt;10;0;3;13;252;0.04;0.0;0.01
1261_2.txt;5;1;0;6;118;0.04;0.01;0.0
10573_3.txt;0;2;0;2;388;0.0;0.01;0.0
9270_2.txt;27;7;0;34;726;0.04;0.01;0.0
4602_3.txt;6;0;1;7;279;0.02;0.0;0.0
8314_1.txt;5;22;0;27;571;0.01;0.04;0.0
761_1.txt;0;0;1;1;174;0.0;0.0;0.01
55_1.txt;3;1;0;4;165;0.02;0.01;0.0
9396_3.txt;0;0;0;0;98;0.0;0.0;0.0
1539_3.txt;12;0;0;12;278;0.04;0.0;0.0
6158_4.txt;22;0;2;24;443;0.05;0.0;0.0
2040_1.txt;10;1;1;12;536;0.02;0.0;0.0
9698_1.txt;0;1;0;1;164;0.0;0.01;0.0
11085_4.txt;22;0;0;22;235;0.09;0.0;0.0
5699_1.txt;0;0;0;0;160;0.0;0.0;0.0
3876_4.txt;0;0;0;0;65;0.0;0.0;0.0
4740_2.txt;2;1;0;3;275;0.01;0.0;0.0
7700_2.txt;1;0;0;1;145;0.01;0.0;0.0
3975_3.txt;2;2;5;9;224;0.01;0.01;0.02
5864_1.txt;2;0;0;2;155;0.01;0.0;0.0
6463_2.txt;5;0;0;5;145;0.03;0.0;0.0
11034_1.txt;0;0;0;0;178;0.0;0.0;0.0
10011_3.txt;0;0;0;0;157;0.0;0.0;0.0
7533_3.txt;6;0;0;6;339;0.02;0.0;0.0
2485_1.txt;0;0;0;0;221;0.0;0.0;0.0
5196_4.txt;4;0;0;4;124;0.03;0.0;0.0
5383_4.txt;0;0;4;4;404;0.0;0.0;0.01
2095_3.txt;7;2;3;12;285;0.02;0.01;0.01
3378_2.txt;0;0;0;0;259;0.0;0.0;0.0
4477_4.txt;9;1;0;10;211;0.04;0.0;0.0
10209_3.txt;8;0;0;8;334;0.02;0.0;0.0
4209_3.txt;12;0;0;12;200;0.06;0.0;0.0
4358_1.txt;2;0;0;2;456;0.0;0.0;0.0
9832_3.txt;2;0;2;4;1051;0.0;0.0;0.0
1784_1.txt;10;0;0;10;230;0.04;0.0;0.0
8359_4.txt;8;0;0;8;142;0.06;0.0;0.0
6733_3.txt;23;2;2;27;304;0.08;0.01;0.01
3274_2.txt;50;2;5;57;288;0.17;0.01;0.02
2584_1.txt;5;0;2;7;253;0.02;0.0;0.01
7844_4.txt;5;0;0;5;531;0.01;0.0;0.0
2441_3.txt;8;2;0;10;149;0.05;0.01;0.0
8056_1.txt;8;1;0;9;189;0.04;0.01;0.0
6427_3.txt;0;0;0;0;197;0.0;0.0;0.0
7882_1.txt;0;0;3;3;254;0.0;0.0;0.01
9523_3.txt;0;4;1;5;161;0.0;0.02;0.01
2583_2.txt;0;0;0;0;137;0.0;0.0;0.0
8040_1.txt;20;3;0;23;352;0.06;0.01;0.0
11753_1.txt;0;0;0;0;58;0.0;0.0;0.0
6020_2.txt;0;0;0;0;162;0.0;0.0;0.0
7737_1.txt;4;0;0;4;56;0.07;0.0;0.0
11595_4.txt;14;2;0;16;217;0.06;0.01;0.0
8149_1.txt;5;0;0;5;148;0.03;0.0;0.0
11065_2.txt;3;1;0;4;213;0.01;0.0;0.0
7812_1.txt;21;1;3;25;501;0.04;0.0;0.01
2236_1.txt;0;0;0;0;155;0.0;0.0;0.0
9977_4.txt;7;0;0;7;278;0.03;0.0;0.0
10840_4.txt;1;0;0;1;238;0.0;0.0;0.0
8390_3.txt;14;0;0;14;502;0.03;0.0;0.0
5111_1.txt;0;1;0;1;158;0.0;0.01;0.0
10912_3.txt;2;0;0;2;196;0.01;0.0;0.0
5357_1.txt;2;0;6;8;397;0.01;0.0;0.02
10126_2.txt;35;0;0;35;683;0.05;0.0;0.0
955_4.txt;9;5;0;14;259;0.03;0.02;0.0
1899_1.txt;26;6;1;33;633;0.04;0.01;0.0
7655_1.txt;9;2;0;11;454;0.02;0.0;0.0
6167_4.txt;23;0;0;23;636;0.04;0.0;0.0
2490_3.txt;0;2;0;2;235;0.0;0.01;0.0
9202_1.txt;0;0;1;1;164;0.0;0.0;0.01
11723_1.txt;1;8;6;15;484;0.0;0.02;0.01
10604_2.txt;5;0;0;5;168;0.03;0.0;0.0
2782_4.txt;0;2;0;2;155;0.0;0.01;0.0
4753_3.txt;3;2;0;5;132;0.02;0.02;0.0
3564_2.txt;7;0;0;7;143;0.05;0.0;0.0
4420_1.txt;1;0;0;1;185;0.01;0.0;0.0
10812_1.txt;3;0;0;3;108;0.03;0.0;0.0
12373_2.txt;0;1;0;1;318;0.0;0.0;0.0
9249_3.txt;2;0;0;2;157;0.01;0.0;0.0
267_3.txt;4;0;0;4;170;0.02;0.0;0.0
7435_4.txt;1;0;0;1;131;0.01;0.0;0.0
6521_4.txt;1;0;0;1;266;0.0;0.0;0.0
3581_2.txt;18;1;0;19;382;0.05;0.0;0.0
2543_1.txt;3;0;0;3;205;0.01;0.0;0.0
11744_1.txt;0;1;0;1;345;0.0;0.0;0.0
2072_1.txt;0;0;0;0;167;0.0;0.0;0.0
22_1.txt;6;2;0;8;322;0.02;0.01;0.0
225_2.txt;11;0;0;11;190;0.06;0.0;0.0
12204_1.txt;7;7;1;15;857;0.01;0.01;0.0
2324_2.txt;5;0;0;5;121;0.04;0.0;0.0
6770_1.txt;4;0;2;6;166;0.02;0.0;0.01
4659_1.txt;0;1;0;1;364;0.0;0.0;0.0
4692_4.txt;8;0;1;9;118;0.07;0.0;0.01
7517_1.txt;6;0;0;6;365;0.02;0.0;0.0
7525_2.txt;34;0;0;34;552;0.06;0.0;0.0
12359_1.txt;6;0;0;6;129;0.05;0.0;0.0
7007_4.txt;6;0;0;6;163;0.04;0.0;0.0
9720_2.txt;5;0;0;5;235;0.02;0.0;0.0
633_4.txt;2;2;0;4;127;0.02;0.02;0.0
7599_3.txt;10;1;1;12;313;0.03;0.0;0.0
12237_2.txt;3;1;0;4;181;0.02;0.01;0.0
8076_1.txt;0;0;0;0;75;0.0;0.0;0.0
3591_4.txt;4;2;5;11;1155;0.0;0.0;0.0
5951_4.txt;3;0;0;3;67;0.04;0.0;0.0
3382_1.txt;7;0;0;7;152;0.05;0.0;0.0
4748_2.txt;11;3;2;16;678;0.02;0.0;0.0
3544_1.txt;1;0;0;1;394;0.0;0.0;0.0
9519_3.txt;36;2;0;38;896;0.04;0.0;0.0
8486_1.txt;0;0;9;9;197;0.0;0.0;0.05
103_1.txt;2;0;0;2;121;0.02;0.0;0.0
12013_3.txt;0;0;0;0;88;0.0;0.0;0.0
10290_1.txt;0;0;0;0;128;0.0;0.0;0.0
3383_1.txt;1;1;0;2;189;0.01;0.01;0.0
5894_4.txt;2;0;1;3;224;0.01;0.0;0.0
11776_4.txt;8;0;0;8;211;0.04;0.0;0.0
11950_2.txt;0;0;0;0;29;0.0;0.0;0.0
10733_4.txt;4;2;0;6;569;0.01;0.0;0.0
8738_3.txt;2;0;0;2;260;0.01;0.0;0.0
8050_1.txt;0;0;0;0;129;0.0;0.0;0.0
9246_3.txt;10;0;0;10;240;0.04;0.0;0.0
7535_1.txt;0;2;0;2;152;0.0;0.01;0.0
10386_4.txt;9;0;0;9;259;0.03;0.0;0.0
8713_1.txt;2;0;0;2;145;0.01;0.0;0.0
7095_2.txt;0;0;1;1;140;0.0;0.0;0.01
6645_1.txt;0;0;0;0;130;0.0;0.0;0.0
9073_3.txt;2;2;0;4;108;0.02;0.02;0.0
5867_1.txt;8;0;0;8;57;0.14;0.0;0.0
5123_2.txt;1;3;7;11;689;0.0;0.0;0.01
5968_4.txt;2;0;5;7;63;0.03;0.0;0.08
8934_3.txt;23;5;0;28;210;0.11;0.02;0.0
7694_3.txt;0;0;0;0;161;0.0;0.0;0.0
1638_3.txt;7;2;0;9;517;0.01;0.0;0.0
5053_2.txt;2;3;0;5;474;0.0;0.01;0.0
5672_1.txt;0;0;0;0;133;0.0;0.0;0.0
6400_3.txt;2;0;0;2;259;0.01;0.0;0.0
9908_3.txt;6;1;0;7;224;0.03;0.0;0.0
9788_3.txt;4;0;3;7;79;0.05;0.0;0.04
1234_2.txt;22;0;0;22;976;0.02;0.0;0.0
822_1.txt;5;0;0;5;253;0.02;0.0;0.0
9432_4.txt;0;0;0;0;411;0.0;0.0;0.0
3701_2.txt;0;0;0;0;56;0.0;0.0;0.0
7690_2.txt;0;1;0;1;156;0.0;0.01;0.0
5446_2.txt;5;1;0;6;126;0.04;0.01;0.0
6804_1.txt;0;0;0;0;209;0.0;0.0;0.0
6990_1.txt;4;0;2;6;141;0.03;0.0;0.01
6112_1.txt;3;3;0;6;123;0.02;0.02;0.0
1613_2.txt;41;7;1;49;1179;0.03;0.01;0.0
353_4.txt;3;0;0;3;155;0.02;0.0;0.0
3039_1.txt;0;0;0;0;180;0.0;0.0;0.0
5323_3.txt;3;0;0;3;133;0.02;0.0;0.0
2557_1.txt;0;0;0;0;144;0.0;0.0;0.0
3122_4.txt;28;0;0;28;349;0.08;0.0;0.0
5567_1.txt;8;0;0;8;329;0.02;0.0;0.0
5016_1.txt;2;1;0;3;277;0.01;0.0;0.0
11626_1.txt;8;2;0;10;203;0.04;0.01;0.0
6692_1.txt;5;0;0;5;197;0.03;0.0;0.0
8899_3.txt;7;1;0;8;124;0.06;0.01;0.0
10771_2.txt;11;0;1;12;322;0.03;0.0;0.0
11897_3.txt;6;0;0;6;104;0.06;0.0;0.0
7471_1.txt;12;2;1;15;921;0.01;0.0;0.0
3461_2.txt;0;0;0;0;133;0.0;0.0;0.0
9204_1.txt;2;0;0;2;156;0.01;0.0;0.0
2632_3.txt;10;3;4;17;370;0.03;0.01;0.01
10092_1.txt;0;0;0;0;380;0.0;0.0;0.0
11432_1.txt;9;0;0;9;220;0.04;0.0;0.0
812_3.txt;1;2;1;4;99;0.01;0.02;0.01
8380_1.txt;2;0;0;2;138;0.01;0.0;0.0
8240_1.txt;0;0;0;0;181;0.0;0.0;0.0
3349_2.txt;10;0;0;10;285;0.04;0.0;0.0
9357_2.txt;0;0;0;0;198;0.0;0.0;0.0
2967_1.txt;9;7;0;16;572;0.02;0.01;0.0
1404_3.txt;22;0;2;24;220;0.1;0.0;0.01
6964_1.txt;27;2;4;33;399;0.07;0.01;0.01
9284_1.txt;7;0;0;7;80;0.09;0.0;0.0
9381_2.txt;3;0;0;3;208;0.01;0.0;0.0
785_2.txt;28;1;0;29;500;0.06;0.0;0.0
7872_2.txt;11;0;0;11;369;0.03;0.0;0.0
10315_2.txt;6;0;0;6;190;0.03;0.0;0.0
10714_2.txt;2;1;0;3;177;0.01;0.01;0.0
803_4.txt;4;0;0;4;112;0.04;0.0;0.0
241_1.txt;46;8;4;58;672;0.07;0.01;0.01
10466_2.txt;19;7;5;31;607;0.03;0.01;0.01
6333_1.txt;0;0;0;0;136;0.0;0.0;0.0
877_3.txt;0;0;1;1;128;0.0;0.0;0.01
5312_2.txt;19;1;0;20;231;0.08;0.0;0.0
335_4.txt;9;2;0;11;207;0.04;0.01;0.0
4413_1.txt;0;0;2;2;95;0.0;0.0;0.02
6565_2.txt;6;1;1;8;109;0.06;0.01;0.01
9215_1.txt;2;5;0;7;196;0.01;0.03;0.0
4603_4.txt;17;0;7;24;304;0.06;0.0;0.02
7640_2.txt;2;3;0;5;261;0.01;0.01;0.0
11320_1.txt;1;0;1;2;161;0.01;0.0;0.01
2958_1.txt;2;0;0;2;180;0.01;0.0;0.0
11399_2.txt;0;0;0;0;139;0.0;0.0;0.0
11315_4.txt;4;0;0;4;58;0.07;0.0;0.0
9693_2.txt;21;0;0;21;302;0.07;0.0;0.0
8455_2.txt;12;0;2;14;177;0.07;0.0;0.01
5348_3.txt;25;0;2;27;194;0.13;0.0;0.01
489_4.txt;0;0;0;0;209;0.0;0.0;0.0
9011_4.txt;4;0;0;4;127;0.03;0.0;0.0
10353_3.txt;3;0;0;3;266;0.01;0.0;0.0
4096_2.txt;8;0;0;8;152;0.05;0.0;0.0
2367_4.txt;0;0;0;0;64;0.0;0.0;0.0
4201_1.txt;2;0;0;2;58;0.03;0.0;0.0
9206_3.txt;20;0;0;20;164;0.12;0.0;0.0
10510_1.txt;0;2;0;2;333;0.0;0.01;0.0
6957_1.txt;4;0;0;4;142;0.03;0.0;0.0
9375_4.txt;0;1;0;1;113;0.0;0.01;0.0
9124_1.txt;10;0;0;10;237;0.04;0.0;0.0
11892_4.txt;24;6;4;34;706;0.03;0.01;0.01
1435_4.txt;14;4;4;22;314;0.04;0.01;0.01
6372_2.txt;6;0;0;6;155;0.04;0.0;0.0
10373_3.txt;10;0;1;11;137;0.07;0.0;0.01
9456_1.txt;27;1;0;28;616;0.04;0.0;0.0
12392_4.txt;17;0;2;19;175;0.1;0.0;0.01
3930_4.txt;0;0;0;0;150;0.0;0.0;0.0
11658_4.txt;2;0;0;2;157;0.01;0.0;0.0
7476_4.txt;2;0;3;5;150;0.01;0.0;0.02
7854_1.txt;0;0;0;0;159;0.0;0.0;0.0
4165_2.txt;0;0;0;0;72;0.0;0.0;0.0
10545_1.txt;6;0;0;6;52;0.12;0.0;0.0
9293_1.txt;29;2;0;31;741;0.04;0.0;0.0
10953_1.txt;2;0;0;2;157;0.01;0.0;0.0
8794_1.txt;2;3;4;9;327;0.01;0.01;0.01
6300_4.txt;1;1;0;2;72;0.01;0.01;0.0
9021_2.txt;2;0;0;2;42;0.05;0.0;0.0
10602_4.txt;9;0;0;9;131;0.07;0.0;0.0
5963_3.txt;0;0;0;0;302;0.0;0.0;0.0
5616_3.txt;2;0;0;2;136;0.01;0.0;0.0
7565_1.txt;2;0;0;2;381;0.01;0.0;0.0
10138_3.txt;3;0;0;3;211;0.01;0.0;0.0
11568_4.txt;12;3;0;15;402;0.03;0.01;0.0
2501_1.txt;0;0;0;0;246;0.0;0.0;0.0
5659_4.txt;0;0;0;0;136;0.0;0.0;0.0
3276_2.txt;24;5;4;33;202;0.12;0.02;0.02
5189_2.txt;8;1;4;13;191;0.04;0.01;0.02
10414_3.txt;9;2;0;11;236;0.04;0.01;0.0
3314_1.txt;7;1;0;8;149;0.05;0.01;0.0
11966_3.txt;4;1;0;5;210;0.02;0.0;0.0
9623_4.txt;24;0;0;24;326;0.07;0.0;0.0
12267_4.txt;0;0;0;0;253;0.0;0.0;0.0
1412_2.txt;8;2;1;11;443;0.02;0.0;0.0
4952_1.txt;0;0;0;0;174;0.0;0.0;0.0
10407_4.txt;2;0;0;2;177;0.01;0.0;0.0
7445_4.txt;3;0;1;4;126;0.02;0.0;0.01
899_1.txt;43;5;4;52;740;0.06;0.01;0.01
9896_4.txt;8;0;1;9;249;0.03;0.0;0.0
6033_2.txt;3;0;0;3;130;0.02;0.0;0.0
8785_1.txt;5;2;0;7;222;0.02;0.01;0.0
1093_2.txt;17;4;0;21;326;0.05;0.01;0.0
3015_1.txt;6;0;0;6;152;0.04;0.0;0.0
2166_4.txt;25;3;7;35;485;0.05;0.01;0.01
2751_1.txt;3;0;0;3;175;0.02;0.0;0.0
11565_4.txt;0;0;1;1;133;0.0;0.0;0.01
7085_3.txt;1;0;1;2;281;0.0;0.0;0.0
743_1.txt;2;0;0;2;173;0.01;0.0;0.0
3915_2.txt;1;0;0;1;116;0.01;0.0;0.0
4582_3.txt;2;1;0;3;165;0.01;0.01;0.0
9480_4.txt;0;0;0;0;75;0.0;0.0;0.0
10480_2.txt;4;0;0;4;211;0.02;0.0;0.0
7921_1.txt;0;0;0;0;120;0.0;0.0;0.0
3919_3.txt;1;0;0;1;69;0.01;0.0;0.0
6330_1.txt;2;0;0;2;154;0.01;0.0;0.0
9539_3.txt;3;0;0;3;219;0.01;0.0;0.0
395_1.txt;3;0;0;3;489;0.01;0.0;0.0
10405_4.txt;17;1;0;18;281;0.06;0.0;0.0
12116_1.txt;3;0;0;3;54;0.06;0.0;0.0
10989_2.txt;0;0;0;0;464;0.0;0.0;0.0
3431_4.txt;2;0;0;2;118;0.02;0.0;0.0
6661_3.txt;12;0;3;15;468;0.03;0.0;0.01
1956_3.txt;4;0;0;4;260;0.02;0.0;0.0
8734_1.txt;4;0;0;4;113;0.04;0.0;0.0
2088_1.txt;0;1;0;1;132;0.0;0.01;0.0
5349_4.txt;5;0;1;6;125;0.04;0.0;0.01
6452_1.txt;2;0;0;2;126;0.02;0.0;0.0
8790_1.txt;0;1;0;1;99;0.0;0.01;0.0
7363_4.txt;10;0;0;10;184;0.05;0.0;0.0
8847_1.txt;0;0;0;0;178;0.0;0.0;0.0
7830_4.txt;7;0;0;7;251;0.03;0.0;0.0
10519_1.txt;0;0;0;0;168;0.0;0.0;0.0
7608_4.txt;11;0;0;11;264;0.04;0.0;0.0
4182_1.txt;0;3;6;9;361;0.0;0.01;0.02
1091_2.txt;12;2;0;14;476;0.03;0.0;0.0
7876_2.txt;0;0;0;0;109;0.0;0.0;0.0
4376_1.txt;3;0;0;3;157;0.02;0.0;0.0
5704_2.txt;0;4;1;5;249;0.0;0.02;0.0
7087_1.txt;0;0;0;0;214;0.0;0.0;0.0
1403_1.txt;0;0;0;0;170;0.0;0.0;0.0
11423_1.txt;18;4;4;26;657;0.03;0.01;0.01
9165_1.txt;5;0;0;5;165;0.03;0.0;0.0
11074_2.txt;0;0;0;0;66;0.0;0.0;0.0
4543_1.txt;0;1;0;1;154;0.0;0.01;0.0
8902_3.txt;10;3;0;13;510;0.02;0.01;0.0
6984_1.txt;4;1;0;5;225;0.02;0.0;0.0
7724_1.txt;22;0;0;22;404;0.05;0.0;0.0
4239_4.txt;2;0;1;3;138;0.01;0.0;0.01
5871_4.txt;36;3;0;39;904;0.04;0.0;0.0
5350_2.txt;4;0;1;5;433;0.01;0.0;0.0
2105_3.txt;2;1;0;3;107;0.02;0.01;0.0
2148_1.txt;14;2;10;26;436;0.03;0.0;0.02
9172_1.txt;0;0;2;2;169;0.0;0.0;0.01
9978_1.txt;0;0;0;0;222;0.0;0.0;0.0
4472_1.txt;24;1;0;25;653;0.04;0.0;0.0
9540_2.txt;4;0;0;4;68;0.06;0.0;0.0
824_3.txt;14;0;4;18;228;0.06;0.0;0.02
1218_4.txt;11;0;0;11;496;0.02;0.0;0.0
202_2.txt;1;0;0;1;99;0.01;0.0;0.0
9992_3.txt;5;0;3;8;328;0.02;0.0;0.01
9217_2.txt;2;1;0;3;288;0.01;0.0;0.0
6757_4.txt;5;2;0;7;239;0.02;0.01;0.0
735_1.txt;9;0;0;9;243;0.04;0.0;0.0
3160_1.txt;5;0;0;5;187;0.03;0.0;0.0
5316_2.txt;15;1;0;16;134;0.11;0.01;0.0
3715_2.txt;3;0;1;4;247;0.01;0.0;0.0
3603_1.txt;0;0;0;0;106;0.0;0.0;0.0
1221_4.txt;6;0;2;8;247;0.02;0.0;0.01
9893_4.txt;16;0;1;17;172;0.09;0.0;0.01
9886_4.txt;13;0;0;13;315;0.04;0.0;0.0
10525_4.txt;1;0;2;3;66;0.02;0.0;0.03
6551_1.txt;2;0;0;2;124;0.02;0.0;0.0
305_1.txt;1;0;0;1;95;0.01;0.0;0.0
6590_3.txt;0;0;0;0;352;0.0;0.0;0.0
2325_4.txt;0;0;1;1;153;0.0;0.0;0.01
8338_3.txt;8;0;0;8;134;0.06;0.0;0.0
33_3.txt;0;0;1;1;126;0.0;0.0;0.01
9325_1.txt;0;0;0;0;136;0.0;0.0;0.0
10157_4.txt;0;0;0;0;199;0.0;0.0;0.0
1168_4.txt;13;1;0;14;635;0.02;0.0;0.0
99_1.txt;3;0;0;3;253;0.01;0.0;0.0
7563_1.txt;2;0;0;2;172;0.01;0.0;0.0
4848_4.txt;0;0;4;4;661;0.0;0.0;0.01
11788_1.txt;0;0;0;0;193;0.0;0.0;0.0
9547_2.txt;0;1;0;1;163;0.0;0.01;0.0
6925_3.txt;1;0;0;1;160;0.01;0.0;0.0
12425_2.txt;13;0;0;13;352;0.04;0.0;0.0
8724_3.txt;9;0;1;10;444;0.02;0.0;0.0
10169_2.txt;10;2;0;12;283;0.04;0.01;0.0
4863_2.txt;2;0;0;2;87;0.02;0.0;0.0
11709_3.txt;4;0;0;4;94;0.04;0.0;0.0
5685_1.txt;15;1;0;16;791;0.02;0.0;0.0
1600_1.txt;4;0;2;6;117;0.03;0.0;0.02
11555_2.txt;0;0;0;0;220;0.0;0.0;0.0
7804_4.txt;13;0;2;15;185;0.07;0.0;0.01
1336_3.txt;2;0;0;2;80;0.03;0.0;0.0
4004_4.txt;1;3;0;4;126;0.01;0.02;0.0
7310_1.txt;6;0;0;6;691;0.01;0.0;0.0
581_4.txt;7;2;1;10;340;0.02;0.01;0.0
11526_3.txt;5;0;0;5;189;0.03;0.0;0.0
12297_1.txt;5;0;0;5;182;0.03;0.0;0.0
8283_1.txt;14;0;0;14;317;0.04;0.0;0.0
120_1.txt;39;0;5;44;343;0.11;0.0;0.01
11011_3.txt;6;0;3;9;209;0.03;0.0;0.01
3262_3.txt;11;4;3;18;498;0.02;0.01;0.01
11570_1.txt;0;0;1;1;176;0.0;0.0;0.01
6842_3.txt;4;0;0;4;131;0.03;0.0;0.0
10411_2.txt;5;0;0;5;245;0.02;0.0;0.0
1559_1.txt;0;0;0;0;151;0.0;0.0;0.0
9932_4.txt;6;0;2;8;120;0.05;0.0;0.02
3966_4.txt;0;0;1;1;113;0.0;0.0;0.01
7500_3.txt;15;1;0;16;346;0.04;0.0;0.0
11223_1.txt;0;0;0;0;116;0.0;0.0;0.0
2295_1.txt;10;2;0;12;126;0.08;0.02;0.0
3098_1.txt;2;0;2;4;108;0.02;0.0;0.02
3960_1.txt;2;0;0;2;143;0.01;0.0;0.0
9794_1.txt;0;2;0;2;123;0.0;0.02;0.0
5768_4.txt;0;0;0;0;139;0.0;0.0;0.0
2505_2.txt;12;0;1;13;198;0.06;0.0;0.01
2121_1.txt;8;0;0;8;310;0.03;0.0;0.0
11013_1.txt;0;0;0;0;180;0.0;0.0;0.0
6259_3.txt;5;0;3;8;1138;0.0;0.0;0.0
3453_3.txt;0;0;0;0;105;0.0;0.0;0.0
5620_3.txt;9;0;0;9;466;0.02;0.0;0.0
5635_1.txt;2;0;0;2;170;0.01;0.0;0.0
4898_3.txt;0;0;0;0;398;0.0;0.0;0.0
11860_4.txt;2;0;0;2;248;0.01;0.0;0.0
578_3.txt;0;0;0;0;85;0.0;0.0;0.0
3936_2.txt;3;0;0;3;269;0.01;0.0;0.0
4412_2.txt;0;0;0;0;66;0.0;0.0;0.0
3941_3.txt;0;2;0;2;136;0.0;0.01;0.0
6378_4.txt;0;0;0;0;141;0.0;0.0;0.0
9177_1.txt;0;0;0;0;136;0.0;0.0;0.0
6696_4.txt;44;7;4;55;792;0.06;0.01;0.01
2217_3.txt;7;0;0;7;519;0.01;0.0;0.0
7534_4.txt;0;0;0;0;138;0.0;0.0;0.0
4999_1.txt;2;0;0;2;157;0.01;0.0;0.0
9633_2.txt;10;1;0;11;183;0.05;0.01;0.0
1362_4.txt;19;0;0;19;171;0.11;0.0;0.0
6868_3.txt;11;5;0;16;380;0.03;0.01;0.0
11236_1.txt;0;1;0;1;130;0.0;0.01;0.0
7155_3.txt;2;0;0;2;108;0.02;0.0;0.0
2965_2.txt;0;1;0;1;165;0.0;0.01;0.0
472_1.txt;7;0;2;9;156;0.04;0.0;0.01
11210_1.txt;7;0;3;10;152;0.05;0.0;0.02
3205_1.txt;10;5;2;17;433;0.02;0.01;0.0
6500_3.txt;3;0;0;3;153;0.02;0.0;0.0
263_4.txt;4;0;0;4;127;0.03;0.0;0.0
10797_2.txt;4;0;0;4;151;0.03;0.0;0.0
11332_1.txt;15;1;2;18;239;0.06;0.0;0.01
10718_4.txt;16;0;0;16;260;0.06;0.0;0.0
12263_4.txt;17;2;0;19;221;0.08;0.01;0.0
8575_2.txt;10;0;0;10;123;0.08;0.0;0.0
6803_1.txt;0;0;2;2;286;0.0;0.0;0.01
7165_1.txt;2;0;0;2;61;0.03;0.0;0.0
3123_2.txt;12;0;0;12;251;0.05;0.0;0.0
8862_3.txt;17;1;0;18;518;0.03;0.0;0.0
11400_4.txt;8;0;0;8;230;0.03;0.0;0.0
3752_3.txt;1;0;0;1;149;0.01;0.0;0.0
2457_2.txt;0;0;1;1;187;0.0;0.0;0.01
6431_1.txt;9;2;0;11;190;0.05;0.01;0.0
8515_2.txt;0;0;0;0;141;0.0;0.0;0.0
6541_4.txt;8;0;2;10;410;0.02;0.0;0.0
7314_1.txt;9;0;0;9;434;0.02;0.0;0.0
11254_1.txt;1;0;0;1;147;0.01;0.0;0.0
11176_1.txt;6;0;0;6;242;0.02;0.0;0.0
1428_1.txt;2;0;0;2;98;0.02;0.0;0.0
3399_3.txt;0;0;0;0;102;0.0;0.0;0.0
12063_4.txt;20;0;2;22;357;0.06;0.0;0.01
9387_1.txt;11;0;1;12;300;0.04;0.0;0.0
11268_1.txt;2;0;0;2;83;0.02;0.0;0.0
4858_1.txt;2;0;0;2;252;0.01;0.0;0.0
588_2.txt;7;1;1;9;217;0.03;0.0;0.0
8421_4.txt;34;6;0;40;975;0.03;0.01;0.0
8467_1.txt;2;0;0;2;178;0.01;0.0;0.0
1931_1.txt;0;0;0;0;108;0.0;0.0;0.0
894_4.txt;0;0;2;2;219;0.0;0.0;0.01
10777_2.txt;4;0;0;4;53;0.08;0.0;0.0
5124_1.txt;5;0;3;8;897;0.01;0.0;0.0
6254_3.txt;0;2;1;3;168;0.0;0.01;0.01
11868_3.txt;0;0;0;0;196;0.0;0.0;0.0
1771_2.txt;2;0;0;2;74;0.03;0.0;0.0
1674_2.txt;2;0;0;2;108;0.02;0.0;0.0
9642_4.txt;21;0;0;21;316;0.07;0.0;0.0
7522_1.txt;3;0;0;3;181;0.02;0.0;0.0
9970_3.txt;19;0;1;20;576;0.03;0.0;0.0
12172_3.txt;0;2;4;6;86;0.0;0.02;0.05
12209_2.txt;1;0;0;1;330;0.0;0.0;0.0
11484_2.txt;0;0;0;0;189;0.0;0.0;0.0
3726_1.txt;0;0;0;0;153;0.0;0.0;0.0
7980_3.txt;14;0;2;16;161;0.09;0.0;0.01
3237_1.txt;0;1;8;9;382;0.0;0.0;0.02
387_2.txt;2;0;0;2;134;0.01;0.0;0.0
11041_4.txt;1;0;0;1;167;0.01;0.0;0.0
540_4.txt;13;1;1;15;235;0.06;0.0;0.0
1328_2.txt;4;0;0;4;165;0.02;0.0;0.0
3065_2.txt;0;0;0;0;179;0.0;0.0;0.0
3578_1.txt;1;0;0;1;176;0.01;0.0;0.0
10759_4.txt;3;1;1;5;209;0.01;0.0;0.0
10920_2.txt;0;2;0;2;199;0.0;0.01;0.0
3172_2.txt;7;2;0;9;407;0.02;0.0;0.0
1947_1.txt;13;0;0;13;320;0.04;0.0;0.0
6451_3.txt;16;2;0;18;299;0.05;0.01;0.0
7326_3.txt;0;0;0;0;105;0.0;0.0;0.0
2093_3.txt;0;0;2;2;199;0.0;0.0;0.01
5373_4.txt;3;1;0;4;201;0.01;0.0;0.0
6997_4.txt;4;2;0;6;157;0.03;0.01;0.0
1905_1.txt;8;0;0;8;276;0.03;0.0;0.0
7253_1.txt;2;0;0;2;236;0.01;0.0;0.0
2272_3.txt;9;0;0;9;387;0.02;0.0;0.0
6516_1.txt;16;1;0;17;599;0.03;0.0;0.0
3305_2.txt;0;0;0;0;125;0.0;0.0;0.0
2901_1.txt;4;0;0;4;178;0.02;0.0;0.0
8123_1.txt;4;0;0;4;273;0.01;0.0;0.0
6654_1.txt;4;3;0;7;280;0.01;0.01;0.0
10800_1.txt;1;2;1;4;152;0.01;0.01;0.01
7544_3.txt;4;1;0;5;397;0.01;0.0;0.0
1423_2.txt;18;0;0;18;779;0.02;0.0;0.0
3472_1.txt;6;2;0;8;157;0.04;0.01;0.0
4760_1.txt;29;0;0;29;351;0.08;0.0;0.0
1608_1.txt;56;4;1;61;1049;0.05;0.0;0.0
6344_2.txt;7;0;0;7;275;0.03;0.0;0.0
4061_3.txt;0;0;0;0;103;0.0;0.0;0.0
4903_3.txt;4;2;0;6;154;0.03;0.01;0.0
2974_1.txt;0;0;0;0;237;0.0;0.0;0.0
5982_1.txt;6;0;0;6;237;0.03;0.0;0.0
2445_1.txt;0;0;0;0;107;0.0;0.0;0.0
1054_3.txt;8;0;0;8;140;0.06;0.0;0.0
317_1.txt;2;0;0;2;152;0.01;0.0;0.0
11291_1.txt;4;0;1;5;161;0.02;0.0;0.01
1494_4.txt;15;3;0;18;535;0.03;0.01;0.0
3888_3.txt;0;0;1;1;298;0.0;0.0;0.0
12313_1.txt;10;1;0;11;189;0.05;0.01;0.0
2263_1.txt;5;1;0;6;218;0.02;0.0;0.0
10191_3.txt;4;0;0;4;76;0.05;0.0;0.0
7507_2.txt;2;2;0;4;240;0.01;0.01;0.0
3064_1.txt;2;0;0;2;308;0.01;0.0;0.0
1422_3.txt;2;1;2;5;201;0.01;0.0;0.01
4986_2.txt;11;0;0;11;369;0.03;0.0;0.0
6948_4.txt;22;0;0;22;207;0.11;0.0;0.0
7399_4.txt;11;1;0;12;1118;0.01;0.0;0.0
8857_1.txt;2;0;0;2;68;0.03;0.0;0.0
1171_4.txt;1;1;0;2;170;0.01;0.01;0.0
5665_4.txt;6;0;1;7;97;0.06;0.0;0.01
3969_1.txt;0;0;0;0;196;0.0;0.0;0.0
12375_4.txt;5;1;0;6;221;0.02;0.0;0.0
175_1.txt;0;4;0;4;179;0.0;0.02;0.0
5778_2.txt;0;0;0;0;270;0.0;0.0;0.0
10106_1.txt;3;0;0;3;270;0.01;0.0;0.0
407_4.txt;2;0;1;3;179;0.01;0.0;0.01
7348_3.txt;1;0;0;1;79;0.01;0.0;0.0
10357_1.txt;4;0;0;4;142;0.03;0.0;0.0
8243_1.txt;1;0;0;1;201;0.0;0.0;0.0
4677_1.txt;6;2;3;11;210;0.03;0.01;0.01
10651_1.txt;0;0;0;0;158;0.0;0.0;0.0
1970_4.txt;4;0;2;6;83;0.05;0.0;0.02
1513_1.txt;6;0;0;6;227;0.03;0.0;0.0
3679_3.txt;0;1;0;1;132;0.0;0.01;0.0
4075_1.txt;3;1;0;4;230;0.01;0.0;0.0
11999_3.txt;5;0;0;5;514;0.01;0.0;0.0
8358_4.txt;6;0;0;6;319;0.02;0.0;0.0
842_1.txt;5;0;0;5;161;0.03;0.0;0.0
1226_1.txt;9;1;0;10;340;0.03;0.0;0.0
12046_1.txt;14;4;0;18;257;0.05;0.02;0.0
3651_4.txt;11;2;0;13;180;0.06;0.01;0.0
6002_1.txt;0;0;0;0;183;0.0;0.0;0.0
3585_2.txt;6;3;0;9;318;0.02;0.01;0.0
2772_1.txt;0;0;0;0;139;0.0;0.0;0.0
12049_3.txt;5;0;0;5;158;0.03;0.0;0.0
11639_1.txt;8;0;2;10;678;0.01;0.0;0.0
12331_2.txt;23;0;0;23;202;0.11;0.0;0.0
4398_2.txt;8;0;0;8;159;0.05;0.0;0.0
2980_4.txt;25;3;0;28;760;0.03;0.0;0.0
12060_3.txt;22;2;4;28;785;0.03;0.0;0.01
313_2.txt;1;0;0;1;71;0.01;0.0;0.0
5607_1.txt;13;4;4;21;614;0.02;0.01;0.01
11230_1.txt;0;0;0;0;153;0.0;0.0;0.0
3331_1.txt;2;1;0;3;157;0.01;0.01;0.0
3280_1.txt;2;0;0;2;178;0.01;0.0;0.0
2625_2.txt;2;2;0;4;158;0.01;0.01;0.0
6812_1.txt;1;0;0;1;148;0.01;0.0;0.0
1180_4.txt;1;2;2;5;302;0.0;0.01;0.01
2326_3.txt;2;1;0;3;161;0.01;0.01;0.0
4426_1.txt;0;0;0;0;42;0.0;0.0;0.0
3204_3.txt;17;3;0;20;245;0.07;0.01;0.0
7015_4.txt;8;0;0;8;175;0.05;0.0;0.0
2908_3.txt;4;0;0;4;118;0.03;0.0;0.0
5321_4.txt;14;1;0;15;603;0.02;0.0;0.0
3991_4.txt;7;0;0;7;252;0.03;0.0;0.0
12197_2.txt;2;0;3;5;160;0.01;0.0;0.02
11283_1.txt;2;0;0;2;167;0.01;0.0;0.0
1800_2.txt;9;0;0;9;525;0.02;0.0;0.0
1293_4.txt;19;2;0;21;362;0.05;0.01;0.0
5311_1.txt;2;0;0;2;148;0.01;0.0;0.0
1725_2.txt;0;0;0;0;163;0.0;0.0;0.0
9439_3.txt;3;0;0;3;469;0.01;0.0;0.0
301_1.txt;0;1;0;1;88;0.0;0.01;0.0
3219_2.txt;11;4;1;16;369;0.03;0.01;0.0
8333_1.txt;0;0;0;0;203;0.0;0.0;0.0
4191_1.txt;1;0;0;1;178;0.01;0.0;0.0
948_3.txt;0;1;0;1;132;0.0;0.01;0.0
3512_4.txt;7;1;6;14;497;0.01;0.0;0.01
12022_2.txt;0;0;0;0;168;0.0;0.0;0.0
716_1.txt;2;0;1;3;236;0.01;0.0;0.0
9542_1.txt;0;0;0;0;181;0.0;0.0;0.0
4095_1.txt;2;0;0;2;197;0.01;0.0;0.0
3267_2.txt;52;0;6;58;711;0.07;0.0;0.01
4417_1.txt;3;0;2;5;257;0.01;0.0;0.01
4485_4.txt;1;0;0;1;187;0.01;0.0;0.0
4928_3.txt;0;0;0;0;131;0.0;0.0;0.0
6268_1.txt;2;0;0;2;76;0.03;0.0;0.0
9882_3.txt;8;0;0;8;224;0.04;0.0;0.0
11184_1.txt;2;0;0;2;135;0.01;0.0;0.0
8425_1.txt;0;0;0;0;118;0.0;0.0;0.0
5147_3.txt;23;3;0;26;336;0.07;0.01;0.0
2654_2.txt;6;0;0;6;272;0.02;0.0;0.0
5304_2.txt;6;4;2;12;574;0.01;0.01;0.0
9155_1.txt;0;0;0;0;146;0.0;0.0;0.0
9541_1.txt;5;0;0;5;406;0.01;0.0;0.0
10045_1.txt;14;1;0;15;141;0.1;0.01;0.0
9420_4.txt;7;2;0;9;131;0.05;0.02;0.0
7132_2.txt;13;1;3;17;980;0.01;0.0;0.0
2226_4.txt;7;2;0;9;116;0.06;0.02;0.0
11066_1.txt;5;0;0;5;147;0.03;0.0;0.0
1852_2.txt;0;0;0;0;85;0.0;0.0;0.0
1443_4.txt;8;1;3;12;246;0.03;0.0;0.01
11719_1.txt;4;1;0;5;128;0.03;0.01;0.0
77_4.txt;9;5;1;15;220;0.04;0.02;0.0
5551_1.txt;0;0;0;0;136;0.0;0.0;0.0
738_1.txt;3;0;0;3;303;0.01;0.0;0.0
4078_2.txt;2;0;0;2;382;0.01;0.0;0.0
6745_4.txt;5;0;0;5;132;0.04;0.0;0.0
10140_3.txt;4;0;0;4;119;0.03;0.0;0.0
2041_2.txt;0;0;3;3;444;0.0;0.0;0.01
5400_4.txt;10;0;0;10;126;0.08;0.0;0.0
1892_3.txt;7;9;0;16;159;0.04;0.06;0.0
12310_2.txt;12;0;3;15;220;0.05;0.0;0.01
6771_2.txt;4;0;0;4;203;0.02;0.0;0.0
3898_2.txt;7;1;0;8;154;0.05;0.01;0.0
6972_3.txt;2;1;0;3;154;0.01;0.01;0.0
549_1.txt;2;1;2;5;242;0.01;0.0;0.01
9150_1.txt;6;1;0;7;750;0.01;0.0;0.0
4399_4.txt;6;2;0;8;177;0.03;0.01;0.0
5570_4.txt;0;0;0;0;131;0.0;0.0;0.0
2519_2.txt;0;0;0;0;174;0.0;0.0;0.0
9902_3.txt;0;0;0;0;46;0.0;0.0;0.0
8538_4.txt;0;0;0;0;62;0.0;0.0;0.0
5641_2.txt;1;0;0;1;197;0.01;0.0;0.0
3962_4.txt;9;0;2;11;220;0.04;0.0;0.01
2463_4.txt;0;0;0;0;169;0.0;0.0;0.0
7177_1.txt;14;1;1;16;434;0.03;0.0;0.0
372_1.txt;6;0;0;6;285;0.02;0.0;0.0
10579_2.txt;30;3;0;33;828;0.04;0.0;0.0
1018_3.txt;8;0;0;8;262;0.03;0.0;0.0
928_1.txt;0;0;0;0;98;0.0;0.0;0.0
511_1.txt;0;0;0;0;153;0.0;0.0;0.0
8984_3.txt;28;4;0;32;811;0.03;0.0;0.0
2636_1.txt;10;0;2;12;223;0.04;0.0;0.01
9797_1.txt;0;0;2;2;364;0.0;0.0;0.01
12284_4.txt;9;3;0;12;680;0.01;0.0;0.0
10942_2.txt;7;0;0;7;101;0.07;0.0;0.0
10692_4.txt;12;2;2;16;409;0.03;0.0;0.0
4368_2.txt;6;1;0;7;128;0.05;0.01;0.0
967_3.txt;2;0;0;2;186;0.01;0.0;0.0
1448_1.txt;5;7;0;12;150;0.03;0.05;0.0
1581_1.txt;0;0;0;0;132;0.0;0.0;0.0
918_2.txt;38;14;11;63;820;0.05;0.02;0.01
2624_1.txt;3;0;0;3;368;0.01;0.0;0.0
8079_3.txt;5;0;0;5;137;0.04;0.0;0.0
7453_4.txt;2;0;0;2;75;0.03;0.0;0.0
7406_2.txt;1;0;2;3;251;0.0;0.0;0.01
12318_1.txt;0;0;0;0;130;0.0;0.0;0.0
2993_4.txt;0;1;0;1;140;0.0;0.01;0.0
4646_1.txt;0;0;0;0;113;0.0;0.0;0.0
11934_1.txt;0;0;0;0;107;0.0;0.0;0.0
536_4.txt;24;0;0;24;619;0.04;0.0;0.0
1936_1.txt;2;0;0;2;159;0.01;0.0;0.0
2525_2.txt;5;0;0;5;148;0.03;0.0;0.0
931_1.txt;0;0;0;0;67;0.0;0.0;0.0
4079_4.txt;0;0;0;0;145;0.0;0.0;0.0
4441_3.txt;8;0;2;10;151;0.05;0.0;0.01
8851_1.txt;18;2;0;20;657;0.03;0.0;0.0
7607_4.txt;8;2;0;10;384;0.02;0.01;0.0
3570_1.txt;0;0;0;0;45;0.0;0.0;0.0
5939_4.txt;2;1;1;4;138;0.01;0.01;0.01
11141_1.txt;0;0;0;0;156;0.0;0.0;0.0
9941_2.txt;0;0;0;0;84;0.0;0.0;0.0
9982_3.txt;2;0;0;2;67;0.03;0.0;0.0
756_1.txt;2;0;0;2;1025;0.0;0.0;0.0
2989_3.txt;1;0;5;6;539;0.0;0.0;0.01
8917_2.txt;0;1;2;3;126;0.0;0.01;0.02
9548_1.txt;0;0;0;0;182;0.0;0.0;0.0
1192_1.txt;0;0;0;0;182;0.0;0.0;0.0
8516_2.txt;5;0;1;6;165;0.03;0.0;0.01
2077_2.txt;2;0;0;2;135;0.01;0.0;0.0
628_2.txt;1;0;0;1;281;0.0;0.0;0.0
10902_1.txt;8;0;0;8;151;0.05;0.0;0.0
2950_1.txt;3;0;1;4;130;0.02;0.0;0.01
2789_1.txt;0;2;0;2;209;0.0;0.01;0.0
4149_1.txt;0;0;0;0;195;0.0;0.0;0.0
10161_2.txt;2;7;0;9;165;0.01;0.04;0.0
901_1.txt;6;0;0;6;68;0.09;0.0;0.0
2634_4.txt;16;0;0;16;371;0.04;0.0;0.0
9768_2.txt;9;2;2;13;1104;0.01;0.0;0.0
1006_1.txt;13;2;0;15;508;0.03;0.0;0.0
9042_4.txt;0;0;1;1;180;0.0;0.0;0.01
1792_1.txt;10;0;0;10;569;0.02;0.0;0.0
9195_1.txt;13;0;2;15;887;0.01;0.0;0.0
5632_1.txt;3;2;2;7;200;0.01;0.01;0.01
6126_1.txt;3;0;0;3;96;0.03;0.0;0.0
862_1.txt;3;0;0;3;186;0.02;0.0;0.0
1530_2.txt;2;0;1;3;315;0.01;0.0;0.0
5511_1.txt;8;0;0;8;231;0.03;0.0;0.0
338_4.txt;10;0;0;10;221;0.05;0.0;0.0
3087_2.txt;4;0;0;4;227;0.02;0.0;0.0
3874_3.txt;1;0;0;1;257;0.0;0.0;0.0
291_3.txt;9;0;0;9;188;0.05;0.0;0.0
4352_4.txt;0;0;0;0;323;0.0;0.0;0.0
11592_1.txt;7;0;1;8;543;0.01;0.0;0.0
2191_3.txt;1;0;0;1;264;0.0;0.0;0.0
10567_2.txt;0;0;0;0;168;0.0;0.0;0.0
6644_1.txt;4;0;0;4;231;0.02;0.0;0.0
11988_4.txt;15;0;1;16;424;0.04;0.0;0.0
3054_1.txt;0;2;7;9;171;0.0;0.01;0.04
10152_1.txt;0;0;0;0;88;0.0;0.0;0.0
494_3.txt;2;0;0;2;101;0.02;0.0;0.0
4169_2.txt;5;0;0;5;183;0.03;0.0;0.0
6444_4.txt;2;0;0;2;193;0.01;0.0;0.0
7772_2.txt;0;0;0;0;220;0.0;0.0;0.0
450_1.txt;2;0;3;5;152;0.01;0.0;0.02
9487_4.txt;0;0;0;0;176;0.0;0.0;0.0
2204_2.txt;0;0;2;2;423;0.0;0.0;0.0
5859_1.txt;2;3;0;5;108;0.02;0.03;0.0
1963_4.txt;0;1;0;1;209;0.0;0.0;0.0
1850_1.txt;13;0;0;13;147;0.09;0.0;0.0
10221_3.txt;25;7;4;36;1100;0.02;0.01;0.0
8712_4.txt;7;0;2;9;599;0.01;0.0;0.0
8060_1.txt;0;0;0;0;170;0.0;0.0;0.0
10472_1.txt;3;1;3;7;120;0.03;0.01;0.03
10687_1.txt;3;1;0;4;141;0.02;0.01;0.0
1458_3.txt;7;0;5;12;277;0.03;0.0;0.02
11185_1.txt;4;0;1;5;168;0.02;0.0;0.01
4006_4.txt;25;5;1;31;1111;0.02;0.0;0.0
11932_4.txt;10;0;1;11;321;0.03;0.0;0.0
4558_4.txt;0;1;0;1;212;0.0;0.0;0.0
873_1.txt;6;0;0;6;217;0.03;0.0;0.0
4383_1.txt;8;0;0;8;77;0.1;0.0;0.0
9686_1.txt;8;1;0;9;240;0.03;0.0;0.0
2080_1.txt;19;0;5;24;419;0.05;0.0;0.01
6572_3.txt;9;0;0;9;270;0.03;0.0;0.0
6308_1.txt;0;1;2;3;199;0.0;0.01;0.01
10924_3.txt;3;4;0;7;427;0.01;0.01;0.0
10302_1.txt;8;0;1;9;253;0.03;0.0;0.0
10663_4.txt;5;0;0;5;127;0.04;0.0;0.0
6201_1.txt;0;0;0;0;142;0.0;0.0;0.0
720_4.txt;32;1;4;37;888;0.04;0.0;0.0
5149_1.txt;2;2;2;6;244;0.01;0.01;0.01
1633_4.txt;1;0;0;1;111;0.01;0.0;0.0
4014_2.txt;4;0;0;4;79;0.05;0.0;0.0
2954_1.txt;9;2;0;11;226;0.04;0.01;0.0
10523_2.txt;2;0;0;2;199;0.01;0.0;0.0
7362_3.txt;14;0;0;14;218;0.06;0.0;0.0
2516_3.txt;4;0;0;4;145;0.03;0.0;0.0
9401_1.txt;0;0;0;0;142;0.0;0.0;0.0
7779_4.txt;1;0;0;1;134;0.01;0.0;0.0
7229_3.txt;0;5;0;5;295;0.0;0.02;0.0
8285_1.txt;12;0;0;12;258;0.05;0.0;0.0
5700_1.txt;7;1;4;12;254;0.03;0.0;0.02
10878_1.txt;0;0;0;0;76;0.0;0.0;0.0
12134_3.txt;2;1;1;4;183;0.01;0.01;0.01
2663_2.txt;4;0;0;4;83;0.05;0.0;0.0
11293_3.txt;15;0;0;15;716;0.02;0.0;0.0
10231_1.txt;2;0;0;2;155;0.01;0.0;0.0
1534_1.txt;3;0;0;3;168;0.02;0.0;0.0
9278_4.txt;3;0;0;3;287;0.01;0.0;0.0
2941_4.txt;24;2;0;26;1036;0.02;0.0;0.0
6469_3.txt;6;0;0;6;148;0.04;0.0;0.0
958_1.txt;0;1;0;1;220;0.0;0.0;0.0
10012_1.txt;8;0;0;8;188;0.04;0.0;0.0
7285_3.txt;0;0;1;1;68;0.0;0.0;0.01
9503_4.txt;12;1;2;15;505;0.02;0.0;0.0
10060_1.txt;0;0;0;0;131;0.0;0.0;0.0
8093_3.txt;7;0;2;9;144;0.05;0.0;0.01
10655_3.txt;4;0;0;4;435;0.01;0.0;0.0
5140_4.txt;16;0;1;17;187;0.09;0.0;0.01
3705_3.txt;10;0;1;11;183;0.05;0.0;0.01
3251_1.txt;0;0;0;0;96;0.0;0.0;0.0
12095_3.txt;30;4;0;34;1069;0.03;0.0;0.0
8668_4.txt;3;0;0;3;297;0.01;0.0;0.0
3097_1.txt;0;0;0;0;441;0.0;0.0;0.0
6135_2.txt;12;1;0;13;310;0.04;0.0;0.0
9113_4.txt;2;0;0;2;174;0.01;0.0;0.0
7789_3.txt;31;2;3;36;483;0.06;0.0;0.01
5154_1.txt;0;0;0;0;76;0.0;0.0;0.0
12087_1.txt;22;2;0;24;355;0.06;0.01;0.0
11037_3.txt;6;0;0;6;133;0.05;0.0;0.0
569_1.txt;19;3;2;24;396;0.05;0.01;0.01
8612_3.txt;1;0;0;1;80;0.01;0.0;0.0
7553_2.txt;23;2;0;25;554;0.04;0.0;0.0
2510_4.txt;6;0;0;6;217;0.03;0.0;0.0
2061_1.txt;0;0;0;0;160;0.0;0.0;0.0
9647_2.txt;47;9;0;56;686;0.07;0.01;0.0
4445_4.txt;0;0;0;0;169;0.0;0.0;0.0
2384_1.txt;4;0;5;9;59;0.07;0.0;0.08
10185_4.txt;2;0;0;2;143;0.01;0.0;0.0
5288_1.txt;12;1;0;13;179;0.07;0.01;0.0
11217_3.txt;0;0;0;0;186;0.0;0.0;0.0
4142_1.txt;0;0;0;0;131;0.0;0.0;0.0
4949_3.txt;30;20;2;52;1147;0.03;0.02;0.0
6394_1.txt;1;2;0;3;360;0.0;0.01;0.0
9039_4.txt;3;3;0;6;109;0.03;0.03;0.0
10021_2.txt;3;1;0;4;130;0.02;0.01;0.0
9663_4.txt;0;0;0;0;185;0.0;0.0;0.0
12166_1.txt;15;3;0;18;282;0.05;0.01;0.0
575_3.txt;0;0;0;0;118;0.0;0.0;0.0
9569_4.txt;28;3;0;31;538;0.05;0.01;0.0
10529_4.txt;9;4;0;13;276;0.03;0.01;0.0
2237_3.txt;0;0;0;0;140;0.0;0.0;0.0
10826_1.txt;0;0;0;0;223;0.0;0.0;0.0
3007_2.txt;3;0;0;3;448;0.01;0.0;0.0
1820_4.txt;19;0;1;20;584;0.03;0.0;0.0
4043_3.txt;0;0;0;0;177;0.0;0.0;0.0
1898_2.txt;4;0;1;5;131;0.03;0.0;0.01
9644_2.txt;1;2;1;4;150;0.01;0.01;0.01
11337_3.txt;19;4;5;28;896;0.02;0.0;0.01
4970_3.txt;3;0;0;3;123;0.02;0.0;0.0
11811_2.txt;9;1;0;10;337;0.03;0.0;0.0
2926_1.txt;5;0;3;8;265;0.02;0.0;0.01
10262_1.txt;0;0;0;0;354;0.0;0.0;0.0
7834_3.txt;0;0;0;0;257;0.0;0.0;0.0
10827_1.txt;20;2;0;22;310;0.06;0.01;0.0
1038_2.txt;3;0;0;3;129;0.02;0.0;0.0
10876_1.txt;3;0;2;5;110;0.03;0.0;0.02
11779_3.txt;14;0;0;14;303;0.05;0.0;0.0
4776_3.txt;12;1;2;15;274;0.04;0.0;0.01
9256_1.txt;0;0;0;0;155;0.0;0.0;0.0
11925_2.txt;1;1;0;2;152;0.01;0.01;0.0
4853_1.txt;0;2;0;2;279;0.0;0.01;0.0
7953_1.txt;0;1;2;3;121;0.0;0.01;0.02
6686_1.txt;0;0;0;0;180;0.0;0.0;0.0
3855_2.txt;11;0;2;13;97;0.11;0.0;0.02
5844_1.txt;0;0;0;0;194;0.0;0.0;0.0
12222_1.txt;13;4;0;17;580;0.02;0.01;0.0
5408_3.txt;0;10;2;12;869;0.0;0.01;0.0
9101_1.txt;6;0;2;8;110;0.05;0.0;0.02
11131_4.txt;3;0;0;3;282;0.01;0.0;0.0
8089_4.txt;2;1;0;3;193;0.01;0.01;0.0
2822_1.txt;3;0;0;3;156;0.02;0.0;0.0
3411_1.txt;9;1;0;10;208;0.04;0.0;0.0
8603_2.txt;15;0;0;15;434;0.03;0.0;0.0
6210_1.txt;4;0;0;4;149;0.03;0.0;0.0
11874_1.txt;14;3;2;19;452;0.03;0.01;0.0
7496_4.txt;3;0;0;3;101;0.03;0.0;0.0
9234_4.txt;2;0;0;2;87;0.02;0.0;0.0
10677_3.txt;0;0;0;0;188;0.0;0.0;0.0
11364_1.txt;4;1;0;5;144;0.03;0.01;0.0
11718_1.txt;2;0;0;2;180;0.01;0.0;0.0
9232_1.txt;9;0;0;9;70;0.13;0.0;0.0
3127_3.txt;3;1;0;4;203;0.01;0.0;0.0
6581_1.txt;0;0;0;0;86;0.0;0.0;0.0
2608_2.txt;1;0;0;1;71;0.01;0.0;0.0
2607_1.txt;0;0;0;0;193;0.0;0.0;0.0
8187_2.txt;12;1;0;13;167;0.07;0.01;0.0
7748_2.txt;0;0;0;0;303;0.0;0.0;0.0
4230_2.txt;0;0;1;1;242;0.0;0.0;0.0
7750_1.txt;1;2;0;3;211;0.0;0.01;0.0
4403_4.txt;0;5;0;5;162;0.0;0.03;0.0
12290_1.txt;0;0;0;0;59;0.0;0.0;0.0
2443_1.txt;3;0;0;3;187;0.02;0.0;0.0
4862_1.txt;7;0;0;7;147;0.05;0.0;0.0
885_2.txt;0;0;0;0;167;0.0;0.0;0.0
381_1.txt;1;1;0;2;167;0.01;0.01;0.0
1812_1.txt;0;0;0;0;118;0.0;0.0;0.0
6287_4.txt;7;0;0;7;291;0.02;0.0;0.0
3308_3.txt;0;1;0;1;157;0.0;0.01;0.0
7462_1.txt;7;0;2;9;244;0.03;0.0;0.01
693_2.txt;12;1;0;13;339;0.04;0.0;0.0
3686_2.txt;16;2;2;20;540;0.03;0.0;0.0
7747_1.txt;1;0;0;1;158;0.01;0.0;0.0
9153_1.txt;5;0;1;6;325;0.02;0.0;0.0
1459_1.txt;22;1;3;26;326;0.07;0.0;0.01
2873_1.txt;2;0;0;2;151;0.01;0.0;0.0
4265_2.txt;2;0;0;2;134;0.01;0.0;0.0
8175_3.txt;0;0;0;0;125;0.0;0.0;0.0
754_2.txt;2;1;0;3;281;0.01;0.0;0.0
8363_2.txt;0;1;0;1;163;0.0;0.01;0.0
3433_3.txt;0;0;0;0;175;0.0;0.0;0.0
4418_1.txt;11;0;5;16;704;0.02;0.0;0.01
7307_2.txt;4;0;0;4;242;0.02;0.0;0.0
7441_3.txt;0;1;0;1;138;0.0;0.01;0.0
2116_4.txt;9;0;0;9;166;0.05;0.0;0.0
10503_1.txt;2;0;0;2;171;0.01;0.0;0.0
8008_1.txt;10;2;0;12;266;0.04;0.01;0.0
12064_1.txt;15;0;0;15;432;0.03;0.0;0.0
10833_3.txt;0;0;1;1;143;0.0;0.0;0.01
4816_4.txt;7;2;2;11;229;0.03;0.01;0.01
462_2.txt;4;0;0;4;150;0.03;0.0;0.0
9766_3.txt;10;0;0;10;342;0.03;0.0;0.0
4179_4.txt;3;0;0;3;158;0.02;0.0;0.0
6012_1.txt;2;1;1;4;493;0.0;0.0;0.0
3689_2.txt;18;3;0;21;351;0.05;0.01;0.0
259_3.txt;0;0;0;0;39;0.0;0.0;0.0
9209_1.txt;16;0;0;16;651;0.02;0.0;0.0
2738_1.txt;0;0;0;0;149;0.0;0.0;0.0
4886_1.txt;13;0;3;16;289;0.04;0.0;0.01
11018_1.txt;0;0;0;0;97;0.0;0.0;0.0
8211_3.txt;11;6;0;17;378;0.03;0.02;0.0
5442_3.txt;0;0;0;0;58;0.0;0.0;0.0
2353_1.txt;3;7;0;10;186;0.02;0.04;0.0
4778_1.txt;2;0;0;2;146;0.01;0.0;0.0
9301_1.txt;2;0;0;2;464;0.0;0.0;0.0
7045_1.txt;8;0;0;8;144;0.06;0.0;0.0
8012_1.txt;0;0;1;1;130;0.0;0.0;0.01
10132_2.txt;10;1;1;12;359;0.03;0.0;0.0
9682_3.txt;3;0;0;3;142;0.02;0.0;0.0
11419_1.txt;2;0;0;2;139;0.01;0.0;0.0
11838_1.txt;0;0;0;0;156;0.0;0.0;0.0
1396_2.txt;0;0;0;0;219;0.0;0.0;0.0
4130_1.txt;2;0;0;2;94;0.02;0.0;0.0
3316_2.txt;14;2;0;16;198;0.07;0.01;0.0
5413_1.txt;17;1;0;18;240;0.07;0.0;0.0
9796_1.txt;6;0;6;12;221;0.03;0.0;0.03
1268_2.txt;0;6;0;6;384;0.0;0.02;0.0
6950_1.txt;15;1;0;16;629;0.02;0.0;0.0
4112_1.txt;0;0;0;0;121;0.0;0.0;0.0
8207_3.txt;5;8;0;13;473;0.01;0.02;0.0
6310_3.txt;2;0;0;2;217;0.01;0.0;0.0
12329_1.txt;10;0;0;10;532;0.02;0.0;0.0
5611_2.txt;6;0;0;6;128;0.05;0.0;0.0
2293_1.txt;11;0;0;11;264;0.04;0.0;0.0
1969_1.txt;0;0;0;0;194;0.0;0.0;0.0
874_1.txt;0;0;0;0;18;0.0;0.0;0.0
236_1.txt;7;1;0;8;494;0.01;0.0;0.0
11958_2.txt;1;0;0;1;142;0.01;0.0;0.0
3153_2.txt;0;0;0;0;81;0.0;0.0;0.0
1039_1.txt;2;0;0;2;147;0.01;0.0;0.0
11295_1.txt;0;0;1;1;339;0.0;0.0;0.0
1097_3.txt;3;0;3;6;198;0.02;0.0;0.02
2144_3.txt;2;0;2;4;160;0.01;0.0;0.01
9714_1.txt;0;0;0;0;201;0.0;0.0;0.0
9085_1.txt;5;0;0;5;275;0.02;0.0;0.0
3769_2.txt;2;4;6;12;537;0.0;0.01;0.01
2309_3.txt;0;0;0;0;177;0.0;0.0;0.0
9760_4.txt;0;0;0;0;152;0.0;0.0;0.0
3693_1.txt;0;2;0;2;127;0.0;0.02;0.0
7293_3.txt;15;5;5;25;517;0.03;0.01;0.01
2316_3.txt;4;0;0;4;171;0.02;0.0;0.0
2785_3.txt;0;0;0;0;331;0.0;0.0;0.0
4124_1.txt;14;4;1;19;772;0.02;0.01;0.0
11281_2.txt;6;7;0;13;345;0.02;0.02;0.0
8557_2.txt;5;0;0;5;356;0.01;0.0;0.0
6857_4.txt;2;0;0;2;141;0.01;0.0;0.0
11632_1.txt;10;1;1;12;268;0.04;0.0;0.0
3375_3.txt;15;1;2;18;280;0.05;0.0;0.01
8002_1.txt;0;0;0;0;152;0.0;0.0;0.0
2797_1.txt;0;0;0;0;150;0.0;0.0;0.0
2866_1.txt;0;0;0;0;235;0.0;0.0;0.0
10633_1.txt;1;0;1;2;151;0.01;0.0;0.01
4293_2.txt;14;0;2;16;212;0.07;0.0;0.01
6437_1.txt;1;0;0;1;305;0.0;0.0;0.0
6980_2.txt;0;0;0;0;93;0.0;0.0;0.0
9719_1.txt;6;1;0;7;130;0.05;0.01;0.0
757_3.txt;4;2;0;6;174;0.02;0.01;0.0
2672_4.txt;4;0;2;6;297;0.01;0.0;0.01
2985_4.txt;2;1;2;5;459;0.0;0.0;0.0
7717_2.txt;8;0;0;8;368;0.02;0.0;0.0
8782_4.txt;7;1;5;13;767;0.01;0.0;0.01
12332_3.txt;9;1;0;10;149;0.06;0.01;0.0
7010_4.txt;9;1;0;10;440;0.02;0.0;0.0
7800_1.txt;0;0;0;0;126;0.0;0.0;0.0
3125_1.txt;6;2;0;8;227;0.03;0.01;0.0
7071_4.txt;11;0;1;12;427;0.03;0.0;0.0
10653_4.txt;1;0;0;1;263;0.0;0.0;0.0
7480_3.txt;23;14;4;41;656;0.04;0.02;0.01
1590_1.txt;4;4;1;9;337;0.01;0.01;0.0
7161_3.txt;0;0;0;0;133;0.0;0.0;0.0
5696_4.txt;0;0;0;0;81;0.0;0.0;0.0
5584_1.txt;1;0;0;1;107;0.01;0.0;0.0
10657_3.txt;7;0;0;7;262;0.03;0.0;0.0
12339_4.txt;0;0;0;0;79;0.0;0.0;0.0
5670_1.txt;12;0;3;15;589;0.02;0.0;0.01
10500_4.txt;27;5;4;36;732;0.04;0.01;0.01
1355_1.txt;13;0;0;13;522;0.02;0.0;0.0
10355_1.txt;7;0;1;8;344;0.02;0.0;0.0
5908_2.txt;0;0;0;0;70;0.0;0.0;0.0
10361_1.txt;10;0;1;11;229;0.04;0.0;0.0
6836_3.txt;2;0;0;2;113;0.02;0.0;0.0
823_4.txt;5;0;0;5;176;0.03;0.0;0.0
739_1.txt;11;2;4;17;489;0.02;0.0;0.01
9469_1.txt;4;2;0;6;137;0.03;0.01;0.0
744_1.txt;2;0;0;2;173;0.01;0.0;0.0
9087_1.txt;1;0;0;1;178;0.01;0.0;0.0
695_4.txt;0;0;0;0;320;0.0;0.0;0.0
7370_1.txt;3;0;2;5;159;0.02;0.0;0.01
7182_1.txt;11;0;0;11;236;0.05;0.0;0.0
6991_1.txt;0;0;0;0;117;0.0;0.0;0.0
11050_1.txt;1;0;0;1;166;0.01;0.0;0.0
3463_1.txt;2;0;0;2;314;0.01;0.0;0.0
8802_3.txt;1;1;0;2;234;0.0;0.0;0.0
6743_1.txt;0;0;0;0;78;0.0;0.0;0.0
4262_1.txt;0;0;0;0;179;0.0;0.0;0.0
6370_1.txt;5;0;0;5;193;0.03;0.0;0.0
4245_3.txt;0;0;0;0;150;0.0;0.0;0.0
3522_2.txt;2;0;0;2;208;0.01;0.0;0.0
11913_4.txt;9;1;0;10;359;0.03;0.0;0.0
1775_4.txt;14;0;0;14;440;0.03;0.0;0.0
8087_4.txt;0;2;0;2;230;0.0;0.01;0.0
9261_3.txt;8;2;0;10;478;0.02;0.0;0.0
3909_2.txt;11;0;0;11;188;0.06;0.0;0.0
10155_4.txt;4;0;0;4;384;0.01;0.0;0.0
10120_4.txt;1;0;0;1;161;0.01;0.0;0.0
9754_2.txt;17;6;14;37;785;0.02;0.01;0.02
3680_4.txt;8;1;0;9;646;0.01;0.0;0.0
205_4.txt;8;0;2;10;391;0.02;0.0;0.01
3912_3.txt;3;0;0;3;43;0.07;0.0;0.0
278_1.txt;3;1;0;4;160;0.02;0.01;0.0
11241_1.txt;5;2;0;7;326;0.02;0.01;0.0
3716_3.txt;7;0;0;7;164;0.04;0.0;0.0
7631_4.txt;11;2;2;15;377;0.03;0.01;0.01
6985_2.txt;32;2;3;37;632;0.05;0.0;0.0
3229_3.txt;0;0;0;0;124;0.0;0.0;0.0
4959_3.txt;15;1;5;21;704;0.02;0.0;0.01
11599_3.txt;0;0;0;0;211;0.0;0.0;0.0
6864_3.txt;1;3;3;7;890;0.0;0.0;0.0
7154_3.txt;11;0;0;11;272;0.04;0.0;0.0
3861_4.txt;2;0;0;2;114;0.02;0.0;0.0
1646_1.txt;0;0;0;0;124;0.0;0.0;0.0
562_1.txt;10;2;1;13;197;0.05;0.01;0.01
7146_1.txt;4;0;0;4;214;0.02;0.0;0.0
9804_1.txt;0;0;0;0;100;0.0;0.0;0.0
3451_4.txt;7;0;0;7;246;0.03;0.0;0.0
1910_1.txt;0;0;0;0;72;0.0;0.0;0.0
10646_4.txt;9;0;0;9;137;0.07;0.0;0.0
12182_1.txt;8;0;0;8;156;0.05;0.0;0.0
8164_1.txt;2;0;0;2;194;0.01;0.0;0.0
2694_3.txt;2;0;1;3;313;0.01;0.0;0.0
5796_3.txt;0;2;0;2;97;0.0;0.02;0.0
6893_3.txt;2;0;0;2;118;0.02;0.0;0.0
4617_3.txt;14;3;0;17;489;0.03;0.01;0.0
5528_2.txt;2;2;0;4;163;0.01;0.01;0.0
8726_4.txt;1;2;0;3;353;0.0;0.01;0.0
8378_1.txt;0;1;0;1;164;0.0;0.01;0.0
2151_1.txt;3;1;2;6;87;0.03;0.01;0.02
11594_4.txt;5;0;0;5;131;0.04;0.0;0.0
7652_3.txt;27;4;6;37;375;0.07;0.01;0.02
10166_2.txt;5;9;2;16;327;0.02;0.03;0.01
5_3.txt;4;0;0;4;223;0.02;0.0;0.0
7725_2.txt;9;0;0;9;354;0.03;0.0;0.0
1594_1.txt;12;0;0;12;221;0.05;0.0;0.0
1072_4.txt;0;0;0;0;61;0.0;0.0;0.0
6100_2.txt;7;0;0;7;315;0.02;0.0;0.0
11342_1.txt;4;0;0;4;347;0.01;0.0;0.0
766_4.txt;2;0;0;2;97;0.02;0.0;0.0
6567_2.txt;12;0;0;12;149;0.08;0.0;0.0
6598_1.txt;14;1;0;15;176;0.08;0.01;0.0
6765_1.txt;4;0;1;5;343;0.01;0.0;0.0
339_4.txt;4;2;0;6;185;0.02;0.01;0.0
8765_4.txt;3;3;0;6;419;0.01;0.01;0.0
8768_4.txt;15;3;0;18;381;0.04;0.01;0.0
5843_3.txt;34;2;3;39;701;0.05;0.0;0.0
8553_3.txt;4;0;0;4;198;0.02;0.0;0.0
10535_2.txt;2;0;0;2;127;0.02;0.0;0.0
5538_4.txt;40;3;0;43;791;0.05;0.0;0.0
4837_1.txt;4;3;1;8;346;0.01;0.01;0.0
5877_4.txt;6;0;0;6;164;0.04;0.0;0.0
11908_3.txt;16;2;0;18;1000;0.02;0.0;0.0
5758_2.txt;2;0;0;2;217;0.01;0.0;0.0
3471_3.txt;8;0;4;12;213;0.04;0.0;0.02
4500_4.txt;5;0;0;5;239;0.02;0.0;0.0
7062_1.txt;0;0;0;0;529;0.0;0.0;0.0
10656_4.txt;14;1;0;15;205;0.07;0.0;0.0
11990_1.txt;4;0;0;4;184;0.02;0.0;0.0
6402_1.txt;3;0;0;3;135;0.02;0.0;0.0
9625_2.txt;27;1;0;28;429;0.06;0.0;0.0
11742_2.txt;0;1;0;1;54;0.0;0.02;0.0
11548_4.txt;13;2;2;17;188;0.07;0.01;0.01
7192_1.txt;1;0;0;1;191;0.01;0.0;0.0
6675_1.txt;3;0;0;3;113;0.03;0.0;0.0
5099_1.txt;0;1;0;1;557;0.0;0.0;0.0
1026_3.txt;5;0;3;8;226;0.02;0.0;0.01
7683_4.txt;3;0;0;3;355;0.01;0.0;0.0
3134_3.txt;1;0;0;1;201;0.0;0.0;0.0
1250_4.txt;15;2;0;17;734;0.02;0.0;0.0
9417_3.txt;34;2;1;37;1145;0.03;0.0;0.0
1692_1.txt;4;0;0;4;175;0.02;0.0;0.0
5505_1.txt;17;0;1;18;257;0.07;0.0;0.0
2534_3.txt;68;5;31;104;1098;0.06;0.0;0.03
216_4.txt;13;0;2;15;347;0.04;0.0;0.01
7796_4.txt;0;0;0;0;344;0.0;0.0;0.0
447_1.txt;0;0;0;0;135;0.0;0.0;0.0
11371_1.txt;0;1;0;1;134;0.0;0.01;0.0
4281_1.txt;11;4;3;18;436;0.03;0.01;0.01
8869_2.txt;12;1;0;13;206;0.06;0.0;0.0
2731_1.txt;3;0;0;3;214;0.01;0.0;0.0
9395_2.txt;10;0;0;10;481;0.02;0.0;0.0
7291_2.txt;2;0;0;2;85;0.02;0.0;0.0
574_4.txt;2;0;0;2;69;0.03;0.0;0.0
9695_1.txt;1;0;0;1;152;0.01;0.0;0.0
2240_4.txt;8;2;2;12;482;0.02;0.0;0.0
3139_1.txt;1;0;0;1;209;0.0;0.0;0.0
141_3.txt;0;0;0;0;65;0.0;0.0;0.0
12442_2.txt;6;0;2;8;224;0.03;0.0;0.01
6048_1.txt;22;8;3;33;988;0.02;0.01;0.0
6448_1.txt;0;0;0;0;230;0.0;0.0;0.0
10195_1.txt;0;0;0;0;148;0.0;0.0;0.0
4362_2.txt;4;1;2;7;208;0.02;0.0;0.01
12481_1.txt;5;0;0;5;238;0.02;0.0;0.0
6211_2.txt;0;0;0;0;768;0.0;0.0;0.0
6511_1.txt;0;0;0;0;46;0.0;0.0;0.0
8593_4.txt;28;0;0;28;1176;0.02;0.0;0.0
4371_2.txt;6;0;0;6;152;0.04;0.0;0.0
10762_2.txt;2;3;0;5;143;0.01;0.02;0.0
10956_2.txt;0;0;3;3;144;0.0;0.0;0.02
3356_4.txt;10;0;2;12;443;0.02;0.0;0.0
999_3.txt;5;1;0;6;351;0.01;0.0;0.0
1744_3.txt;10;2;2;14;204;0.05;0.01;0.01
10637_2.txt;3;2;0;5;138;0.02;0.01;0.0
986_2.txt;0;0;6;6;165;0.0;0.0;0.04
9570_2.txt;0;0;0;0;391;0.0;0.0;0.0
5407_1.txt;0;0;0;0;177;0.0;0.0;0.0
7200_4.txt;2;1;0;3;115;0.02;0.01;0.0
5139_4.txt;0;0;0;0;164;0.0;0.0;0.0
959_4.txt;4;0;0;4;205;0.02;0.0;0.0
10923_1.txt;2;2;0;4;123;0.02;0.02;0.0
9499_4.txt;0;0;0;0;162;0.0;0.0;0.0
8004_2.txt;0;4;0;4;400;0.0;0.01;0.0
8038_4.txt;35;8;1;44;619;0.06;0.01;0.0
11355_2.txt;6;0;1;7;413;0.01;0.0;0.0
2388_3.txt;5;0;0;5;235;0.02;0.0;0.0
6881_1.txt;6;13;4;23;442;0.01;0.03;0.01
11564_4.txt;18;2;0;20;396;0.05;0.01;0.0
4279_2.txt;15;3;1;19;231;0.06;0.01;0.0
10127_1.txt;0;1;0;1;188;0.0;0.01;0.0
3821_4.txt;26;0;1;27;568;0.05;0.0;0.0
852_1.txt;12;0;0;12;154;0.08;0.0;0.0
10836_2.txt;18;0;0;18;351;0.05;0.0;0.0
3060_1.txt;12;8;0;20;650;0.02;0.01;0.0
974_4.txt;0;1;0;1;203;0.0;0.0;0.0
2225_4.txt;7;1;0;8;229;0.03;0.0;0.0
969_1.txt;0;0;0;0;156;0.0;0.0;0.0
1926_3.txt;17;0;0;17;311;0.05;0.0;0.0
8399_2.txt;5;0;0;5;209;0.02;0.0;0.0
9410_1.txt;0;0;0;0;229;0.0;0.0;0.0
1757_1.txt;15;0;0;15;125;0.12;0.0;0.0
5507_4.txt;1;2;0;3;111;0.01;0.02;0.0
2590_4.txt;1;0;0;1;159;0.01;0.0;0.0
7603_2.txt;0;0;0;0;77;0.0;0.0;0.0
174_3.txt;11;1;2;14;738;0.01;0.0;0.0
10287_4.txt;4;2;0;6;577;0.01;0.0;0.0
7207_1.txt;0;0;0;0;69;0.0;0.0;0.0
5937_4.txt;3;0;1;4;171;0.02;0.0;0.01
4310_4.txt;22;0;0;22;293;0.08;0.0;0.0
2310_1.txt;2;0;0;2;183;0.01;0.0;0.0
6104_1.txt;3;0;0;3;695;0.0;0.0;0.0
897_4.txt;15;0;0;15;201;0.07;0.0;0.0
3682_1.txt;3;1;2;6;536;0.01;0.0;0.0
1405_3.txt;74;11;2;87;1146;0.06;0.01;0.0
12327_1.txt;4;0;1;5;187;0.02;0.0;0.01
1955_1.txt;0;0;0;0;169;0.0;0.0;0.0
2117_1.txt;3;0;0;3;290;0.01;0.0;0.0
3796_1.txt;0;0;0;0;67;0.0;0.0;0.0
9526_2.txt;0;0;0;0;145;0.0;0.0;0.0
11849_4.txt;29;0;5;34;522;0.06;0.0;0.01
1369_4.txt;46;0;2;48;369;0.12;0.0;0.01
10673_2.txt;0;0;0;0;137;0.0;0.0;0.0
6930_4.txt;1;0;0;1;185;0.01;0.0;0.0
2998_3.txt;2;0;0;2;105;0.02;0.0;0.0
10031_2.txt;4;6;4;14;380;0.01;0.02;0.01
3688_2.txt;5;0;0;5;151;0.03;0.0;0.0
4985_2.txt;17;1;0;18;325;0.05;0.0;0.0
9372_4.txt;6;0;0;6;321;0.02;0.0;0.0
8408_3.txt;20;1;0;21;458;0.04;0.0;0.0
2881_1.txt;0;0;0;0;129;0.0;0.0;0.0
4017_1.txt;0;0;3;3;232;0.0;0.0;0.01
5568_3.txt;16;2;0;18;257;0.06;0.01;0.0
4730_4.txt;8;3;0;11;569;0.01;0.01;0.0
11894_3.txt;2;4;1;7;296;0.01;0.01;0.0
11039_1.txt;6;0;0;6;219;0.03;0.0;0.0
11616_4.txt;10;0;0;10;375;0.03;0.0;0.0
4042_1.txt;0;0;0;0;169;0.0;0.0;0.0
8964_1.txt;2;0;0;2;272;0.01;0.0;0.0
7671_1.txt;0;0;0;0;149;0.0;0.0;0.0
1329_1.txt;1;0;0;1;96;0.01;0.0;0.0
11994_2.txt;23;0;2;25;658;0.03;0.0;0.0
4100_3.txt;2;1;0;3;368;0.01;0.0;0.0
11468_3.txt;0;0;0;0;149;0.0;0.0;0.0
7215_1.txt;6;2;5;13;155;0.04;0.01;0.03
11907_4.txt;5;3;0;8;269;0.02;0.01;0.0
12345_3.txt;35;3;8;46;779;0.04;0.0;0.01
7231_1.txt;2;7;0;9;344;0.01;0.02;0.0
6277_1.txt;0;0;0;0;286;0.0;0.0;0.0
264_2.txt;28;0;0;28;659;0.04;0.0;0.0
8542_2.txt;1;0;0;1;167;0.01;0.0;0.0
8495_3.txt;3;1;3;7;610;0.0;0.0;0.0
6968_3.txt;3;0;0;3;288;0.01;0.0;0.0
9606_4.txt;24;0;0;24;558;0.04;0.0;0.0
7287_2.txt;1;0;0;1;213;0.0;0.0;0.0
7267_1.txt;0;0;0;0;265;0.0;0.0;0.0
9895_3.txt;9;0;0;9;152;0.06;0.0;0.0
828_2.txt;3;0;0;3;221;0.01;0.0;0.0
23_3.txt;3;0;0;3;192;0.02;0.0;0.0
8331_4.txt;24;1;0;25;516;0.05;0.0;0.0
2860_1.txt;0;1;1;2;145;0.0;0.01;0.01
4608_2.txt;1;0;0;1;171;0.01;0.0;0.0
5498_3.txt;0;0;0;0;67;0.0;0.0;0.0
3842_3.txt;2;0;0;2;152;0.01;0.0;0.0
8290_2.txt;8;0;0;8;254;0.03;0.0;0.0
2271_1.txt;0;1;0;1;142;0.0;0.01;0.0
5172_4.txt;1;1;0;2;196;0.01;0.01;0.0
10110_1.txt;0;0;0;0;244;0.0;0.0;0.0
11720_2.txt;10;2;0;12;192;0.05;0.01;0.0
8165_3.txt;0;0;0;0;205;0.0;0.0;0.0
7516_3.txt;2;0;0;2;183;0.01;0.0;0.0
8166_1.txt;3;0;2;5;283;0.01;0.0;0.01
8909_2.txt;0;0;0;0;343;0.0;0.0;0.0
2809_4.txt;2;0;3;5;358;0.01;0.0;0.01
979_4.txt;7;3;0;10;308;0.02;0.01;0.0
11986_1.txt;3;1;0;4;163;0.02;0.01;0.0
5965_3.txt;44;2;0;46;327;0.13;0.01;0.0
2827_3.txt;11;8;2;21;186;0.06;0.04;0.01
8162_4.txt;7;0;0;7;96;0.07;0.0;0.0
12194_3.txt;0;0;0;0;400;0.0;0.0;0.0
4542_1.txt;3;0;0;3;577;0.01;0.0;0.0
5468_2.txt;0;0;1;1;127;0.0;0.0;0.01
2042_1.txt;3;1;4;8;347;0.01;0.0;0.01
2134_1.txt;5;0;0;5;152;0.03;0.0;0.0
6491_1.txt;6;1;0;7;265;0.02;0.0;0.0
8212_2.txt;5;3;0;8;192;0.03;0.02;0.0
385_3.txt;1;0;0;1;72;0.01;0.0;0.0
4274_4.txt;3;1;0;4;140;0.02;0.01;0.0
9272_2.txt;8;0;0;8;883;0.01;0.0;0.0
11462_4.txt;1;3;0;4;269;0.0;0.01;0.0
1555_1.txt;14;0;0;14;322;0.04;0.0;0.0
7411_4.txt;2;0;0;2;231;0.01;0.0;0.0
9862_1.txt;0;0;1;1;138;0.0;0.0;0.01
10094_1.txt;0;0;0;0;220;0.0;0.0;0.0
7825_1.txt;28;1;3;32;972;0.03;0.0;0.0
7510_1.txt;1;0;0;1;262;0.0;0.0;0.0
11794_2.txt;11;3;0;14;108;0.1;0.03;0.0
12414_3.txt;15;3;0;18;254;0.06;0.01;0.0
7746_1.txt;0;0;0;0;420;0.0;0.0;0.0
11172_1.txt;0;0;0;0;352;0.0;0.0;0.0
4874_2.txt;5;0;0;5;194;0.03;0.0;0.0
10263_4.txt;10;1;0;11;102;0.1;0.01;0.0
8708_3.txt;0;0;0;0;197;0.0;0.0;0.0
1961_4.txt;0;0;0;0;134;0.0;0.0;0.0
2868_1.txt;0;0;0;0;141;0.0;0.0;0.0
5340_3.txt;10;0;0;10;177;0.06;0.0;0.0
7189_4.txt;2;0;0;2;178;0.01;0.0;0.0
1276_1.txt;0;0;0;0;290;0.0;0.0;0.0
1106_1.txt;3;0;0;3;161;0.02;0.0;0.0
4656_4.txt;4;0;0;4;69;0.06;0.0;0.0
6228_1.txt;2;0;0;2;191;0.01;0.0;0.0
5065_2.txt;0;0;0;0;78;0.0;0.0;0.0
8871_1.txt;2;0;0;2;117;0.02;0.0;0.0
4622_2.txt;11;0;4;15;320;0.03;0.0;0.01
3663_4.txt;9;6;0;15;399;0.02;0.02;0.0
4767_4.txt;3;0;1;4;234;0.01;0.0;0.0
1140_3.txt;5;4;2;11;152;0.03;0.03;0.01
8313_2.txt;2;0;0;2;143;0.01;0.0;0.0
3253_3.txt;3;1;0;4;123;0.02;0.01;0.0
6004_2.txt;2;0;0;2;237;0.01;0.0;0.0
5015_1.txt;1;0;0;1;191;0.01;0.0;0.0
9252_3.txt;0;0;0;0;134;0.0;0.0;0.0
10542_3.txt;30;0;0;30;344;0.09;0.0;0.0
1919_3.txt;0;13;0;13;240;0.0;0.05;0.0
11672_4.txt;11;0;0;11;190;0.06;0.0;0.0
3397_4.txt;12;0;0;12;226;0.05;0.0;0.0
3158_2.txt;2;0;0;2;155;0.01;0.0;0.0
11810_3.txt;6;2;0;8;270;0.02;0.01;0.0
3530_2.txt;7;0;2;9;348;0.02;0.0;0.01
868_3.txt;0;0;1;1;173;0.0;0.0;0.01
5549_2.txt;4;2;0;6;550;0.01;0.0;0.0
8280_1.txt;9;0;2;11;143;0.06;0.0;0.01
5382_3.txt;0;0;0;0;302;0.0;0.0;0.0
8901_1.txt;9;0;0;9;272;0.03;0.0;0.0
1551_4.txt;6;1;0;7;172;0.03;0.01;0.0
8340_1.txt;0;0;0;0;129;0.0;0.0;0.0
8481_4.txt;1;0;0;1;224;0.0;0.0;0.0
9741_1.txt;9;0;0;9;236;0.04;0.0;0.0
8072_1.txt;0;0;0;0;128;0.0;0.0;0.0
1461_1.txt;8;1;1;10;218;0.04;0.0;0.0
4528_3.txt;12;4;9;25;169;0.07;0.02;0.05
6243_1.txt;1;0;1;2;274;0.0;0.0;0.0
7985_4.txt;13;0;0;13;504;0.03;0.0;0.0
1959_4.txt;1;0;0;1;150;0.01;0.0;0.0
11109_1.txt;1;2;0;3;206;0.0;0.01;0.0
5286_1.txt;11;1;0;12;208;0.05;0.0;0.0
11447_1.txt;4;0;0;4;140;0.03;0.0;0.0
2925_1.txt;0;0;0;0;134;0.0;0.0;0.0
1373_2.txt;0;0;0;0;237;0.0;0.0;0.0
11128_2.txt;29;1;0;30;558;0.05;0.0;0.0
6123_4.txt;10;0;0;10;226;0.04;0.0;0.0
2358_3.txt;9;0;0;9;178;0.05;0.0;0.0
6940_4.txt;2;1;2;5;244;0.01;0.0;0.01
5013_1.txt;1;0;1;2;284;0.0;0.0;0.0
9888_4.txt;28;0;0;28;729;0.04;0.0;0.0
6325_1.txt;6;2;5;13;466;0.01;0.0;0.01
11833_1.txt;2;0;6;8;199;0.01;0.0;0.03
4679_4.txt;6;0;2;8;128;0.05;0.0;0.02
5486_3.txt;1;1;0;2;279;0.0;0.0;0.0
11071_2.txt;1;0;0;1;111;0.01;0.0;0.0
8025_3.txt;7;1;0;8;528;0.01;0.0;0.0
3186_2.txt;7;0;0;7;74;0.09;0.0;0.0
2407_2.txt;4;0;0;4;262;0.02;0.0;0.0
116_1.txt;5;1;0;6;157;0.03;0.01;0.0
778_2.txt;2;7;1;10;348;0.01;0.02;0.0
4860_2.txt;6;0;0;6;197;0.03;0.0;0.0
3878_2.txt;5;2;1;8;537;0.01;0.0;0.0
1816_1.txt;0;0;0;0;177;0.0;0.0;0.0
2363_1.txt;2;0;0;2;141;0.01;0.0;0.0
12041_1.txt;20;0;0;20;199;0.1;0.0;0.0
401_3.txt;2;0;0;2;270;0.01;0.0;0.0
4024_2.txt;8;0;0;8;318;0.03;0.0;0.0
1574_1.txt;0;0;0;0;171;0.0;0.0;0.0
3254_3.txt;10;0;0;10;166;0.06;0.0;0.0
7401_1.txt;4;1;0;5;127;0.03;0.01;0.0
2896_1.txt;2;0;0;2;138;0.01;0.0;0.0
2446_3.txt;6;0;0;6;228;0.03;0.0;0.0
3929_4.txt;2;0;0;2;247;0.01;0.0;0.0
5409_1.txt;3;0;0;3;208;0.01;0.0;0.0
6660_1.txt;0;0;0;0;260;0.0;0.0;0.0
5215_2.txt;2;0;0;2;162;0.01;0.0;0.0
4483_2.txt;1;1;0;2;188;0.01;0.01;0.0
2177_2.txt;23;3;0;26;748;0.03;0.0;0.0
8654_1.txt;5;2;0;7;122;0.04;0.02;0.0
4176_2.txt;4;0;0;4;297;0.01;0.0;0.0
10397_2.txt;4;2;2;8;140;0.03;0.01;0.01
6349_4.txt;12;1;0;13;336;0.04;0.0;0.0
11588_1.txt;1;2;0;3;57;0.02;0.04;0.0
651_4.txt;3;0;1;4;296;0.01;0.0;0.0
7273_4.txt;8;3;1;12;285;0.03;0.01;0.0
9147_1.txt;17;0;6;23;657;0.03;0.0;0.01
7514_1.txt;0;1;0;1;117;0.0;0.01;0.0
10693_4.txt;17;0;1;18;266;0.06;0.0;0.0
1223_1.txt;4;0;0;4;245;0.02;0.0;0.0
7091_1.txt;14;0;0;14;280;0.05;0.0;0.0
5839_3.txt;24;3;0;27;540;0.04;0.01;0.0
7619_2.txt;4;0;0;4;202;0.02;0.0;0.0
2345_4.txt;6;2;8;16;143;0.04;0.01;0.06
11911_2.txt;2;0;0;2;378;0.01;0.0;0.0
2726_3.txt;9;1;0;10;126;0.07;0.01;0.0
10776_4.txt;14;0;0;14;215;0.07;0.0;0.0
8422_2.txt;20;12;2;34;1026;0.02;0.01;0.0
8450_2.txt;2;0;1;3;289;0.01;0.0;0.0
8269_1.txt;11;0;0;11;418;0.03;0.0;0.0
9989_2.txt;0;0;0;0;153;0.0;0.0;0.0
11634_1.txt;6;2;2;10;216;0.03;0.01;0.01
412_4.txt;50;0;5;55;1171;0.04;0.0;0.0
1707_2.txt;0;0;0;0;129;0.0;0.0;0.0
11884_4.txt;4;0;0;4;251;0.02;0.0;0.0
2334_2.txt;9;0;0;9;227;0.04;0.0;0.0
1255_3.txt;0;0;0;0;70;0.0;0.0;0.0
1272_4.txt;2;0;0;2;127;0.02;0.0;0.0
1677_2.txt;8;1;0;9;648;0.01;0.0;0.0
1231_4.txt;30;1;0;31;412;0.07;0.0;0.0
7450_3.txt;6;0;0;6;160;0.04;0.0;0.0
6666_4.txt;0;0;0;0;148;0.0;0.0;0.0
6110_1.txt;7;1;4;12;197;0.04;0.01;0.02
9831_1.txt;0;0;0;0;199;0.0;0.0;0.0
3727_2.txt;0;0;0;0;101;0.0;0.0;0.0
7256_3.txt;3;2;0;5;190;0.02;0.01;0.0
5617_2.txt;12;0;0;12;265;0.05;0.0;0.0
9715_4.txt;2;2;0;4;263;0.01;0.01;0.0
10659_2.txt;4;1;0;5;304;0.01;0.0;0.0
6817_1.txt;2;0;0;2;55;0.04;0.0;0.0
8248_1.txt;1;0;0;1;134;0.01;0.0;0.0
3613_3.txt;2;0;0;2;96;0.02;0.0;0.0
2629_4.txt;6;0;0;6;86;0.07;0.0;0.0
5397_4.txt;11;1;0;12;137;0.08;0.01;0.0
7384_4.txt;7;1;0;8;374;0.02;0.0;0.0
3297_1.txt;1;0;1;2;194;0.01;0.0;0.01
3988_4.txt;5;0;0;5;358;0.01;0.0;0.0
7867_2.txt;9;2;0;11;189;0.05;0.01;0.0
11975_1.txt;0;0;0;0;136;0.0;0.0;0.0
11724_2.txt;6;1;0;7;361;0.02;0.0;0.0
11923_3.txt;0;0;0;0;82;0.0;0.0;0.0
7128_1.txt;0;0;5;5;111;0.0;0.0;0.05
6418_1.txt;0;0;0;0;280;0.0;0.0;0.0
7070_2.txt;0;0;0;0;175;0.0;0.0;0.0
9169_1.txt;1;0;0;1;100;0.01;0.0;0.0
3590_1.txt;2;0;2;4;294;0.01;0.0;0.01
3557_4.txt;6;2;0;8;430;0.01;0.0;0.0
5040_3.txt;1;0;0;1;161;0.01;0.0;0.0
6714_4.txt;0;0;0;0;68;0.0;0.0;0.0
7268_4.txt;3;4;1;8;226;0.01;0.02;0.0
8573_3.txt;17;1;0;18;228;0.07;0.0;0.0
6054_2.txt;3;0;0;3;152;0.02;0.0;0.0
2898_1.txt;1;0;0;1;249;0.0;0.0;0.0
1120_1.txt;10;0;0;10;369;0.03;0.0;0.0
6952_1.txt;2;0;0;2;178;0.01;0.0;0.0
5782_3.txt;0;0;0;0;141;0.0;0.0;0.0
4382_3.txt;12;10;2;24;319;0.04;0.03;0.01
3434_2.txt;0;0;0;0;166;0.0;0.0;0.0
2210_1.txt;0;0;0;0;127;0.0;0.0;0.0
10095_1.txt;0;0;0;0;213;0.0;0.0;0.0
6582_4.txt;7;0;0;7;469;0.01;0.0;0.0
11972_1.txt;12;2;0;14;303;0.04;0.01;0.0
1902_4.txt;12;4;1;17;703;0.02;0.01;0.0
9243_4.txt;2;0;0;2;206;0.01;0.0;0.0
9762_3.txt;10;0;2;12;134;0.07;0.0;0.01
6859_1.txt;14;0;0;14;582;0.02;0.0;0.0
3921_1.txt;0;0;0;0;148;0.0;0.0;0.0
3740_2.txt;1;6;0;7;262;0.0;0.02;0.0
8255_3.txt;0;0;0;0;86;0.0;0.0;0.0
9267_3.txt;2;0;0;2;100;0.02;0.0;0.0
12004_4.txt;0;1;1;2;182;0.0;0.01;0.01
6852_1.txt;0;0;0;0;112;0.0;0.0;0.0
3017_4.txt;14;0;0;14;280;0.05;0.0;0.0
603_1.txt;0;4;0;4;247;0.0;0.02;0.0
3345_1.txt;0;1;0;1;198;0.0;0.01;0.0
11386_4.txt;0;2;0;2;194;0.0;0.01;0.0
7927_1.txt;7;1;0;8;191;0.04;0.01;0.0
9556_4.txt;0;0;0;0;128;0.0;0.0;0.0
4424_4.txt;0;0;0;0;216;0.0;0.0;0.0
8986_1.txt;0;0;0;0;250;0.0;0.0;0.0
11397_1.txt;0;0;4;4;129;0.0;0.0;0.03
10339_2.txt;3;0;0;3;146;0.02;0.0;0.0
9334_4.txt;4;2;0;6;137;0.03;0.01;0.0
8810_1.txt;0;0;0;0;132;0.0;0.0;0.0
466_1.txt;2;2;0;4;241;0.01;0.01;0.0
11326_4.txt;6;0;0;6;141;0.04;0.0;0.0
7527_4.txt;17;0;0;17;620;0.03;0.0;0.0
12002_1.txt;9;1;1;11;427;0.02;0.0;0.0
3001_3.txt;0;0;0;0;95;0.0;0.0;0.0
3813_1.txt;3;0;2;5;147;0.02;0.0;0.01
9705_1.txt;0;0;0;0;89;0.0;0.0;0.0
7947_2.txt;8;0;0;8;396;0.02;0.0;0.0
1612_1.txt;0;4;2;6;123;0.0;0.03;0.02
7781_2.txt;14;0;0;14;212;0.07;0.0;0.0
8336_1.txt;12;0;0;12;224;0.05;0.0;0.0
2018_3.txt;29;5;4;38;525;0.06;0.01;0.01
392_3.txt;0;0;0;0;55;0.0;0.0;0.0
7542_2.txt;2;0;0;2;184;0.01;0.0;0.0
6865_1.txt;0;0;0;0;277;0.0;0.0;0.0
3490_3.txt;9;0;0;9;174;0.05;0.0;0.0
8460_2.txt;8;0;0;8;196;0.04;0.0;0.0
9508_3.txt;0;0;0;0;71;0.0;0.0;0.0
7292_3.txt;8;3;1;12;315;0.03;0.01;0.0
1966_1.txt;0;0;0;0;153;0.0;0.0;0.0
12091_3.txt;0;1;0;1;183;0.0;0.01;0.0
10873_4.txt;0;0;0;0;196;0.0;0.0;0.0
6547_2.txt;15;0;0;15;462;0.03;0.0;0.0
2119_4.txt;6;2;0;8;546;0.01;0.0;0.0
7353_1.txt;2;1;0;3;179;0.01;0.01;0.0
9363_2.txt;3;1;0;4;137;0.02;0.01;0.0
9037_3.txt;20;0;0;20;504;0.04;0.0;0.0
4290_2.txt;4;0;0;4;425;0.01;0.0;0.0
11061_1.txt;6;0;0;6;170;0.04;0.0;0.0
6802_1.txt;0;0;1;1;238;0.0;0.0;0.0
9731_4.txt;4;0;0;4;96;0.04;0.0;0.0
4105_1.txt;2;2;0;4;199;0.01;0.01;0.0
4294_2.txt;6;5;0;11;618;0.01;0.01;0.0
8975_1.txt;1;0;0;1;114;0.01;0.0;0.0
7038_2.txt;1;0;0;1;169;0.01;0.0;0.0
4375_1.txt;2;1;0;3;165;0.01;0.01;0.0
2262_1.txt;13;3;0;16;566;0.02;0.01;0.0
11277_1.txt;2;0;0;2;142;0.01;0.0;0.0
6363_1.txt;0;0;0;0;171;0.0;0.0;0.0
5176_1.txt;0;2;2;4;176;0.0;0.01;0.01
8035_1.txt;0;0;0;0;118;0.0;0.0;0.0
3090_1.txt;3;0;1;4;274;0.01;0.0;0.0
9881_1.txt;16;1;0;17;371;0.04;0.0;0.0
12390_4.txt;2;0;0;2;223;0.01;0.0;0.0
279_1.txt;0;1;0;1;210;0.0;0.0;0.0
6045_2.txt;11;0;0;11;158;0.07;0.0;0.0
6152_1.txt;1;0;0;1;330;0.0;0.0;0.0
9891_1.txt;0;0;0;0;71;0.0;0.0;0.0
6161_1.txt;6;0;0;6;142;0.04;0.0;0.0
3614_2.txt;5;2;3;10;211;0.02;0.01;0.01
2464_4.txt;0;0;0;0;156;0.0;0.0;0.0
6687_4.txt;10;0;2;12;537;0.02;0.0;0.0
3526_2.txt;1;0;0;1;102;0.01;0.0;0.0
183_3.txt;8;2;3;13;183;0.04;0.01;0.02
4897_2.txt;3;0;0;3;256;0.01;0.0;0.0
11793_3.txt;0;2;0;2;264;0.0;0.01;0.0
10111_1.txt;0;0;0;0;205;0.0;0.0;0.0
11682_1.txt;3;0;0;3;162;0.02;0.0;0.0
4283_1.txt;2;0;0;2;287;0.01;0.0;0.0
12036_1.txt;5;1;1;7;178;0.03;0.01;0.01
11007_1.txt;2;0;2;4;183;0.01;0.0;0.01
2242_1.txt;2;0;0;2;439;0.0;0.0;0.0
2825_3.txt;16;0;2;18;450;0.04;0.0;0.0
12389_1.txt;18;0;0;18;309;0.06;0.0;0.0
8345_3.txt;21;1;0;22;161;0.13;0.01;0.0
915_4.txt;6;0;1;7;59;0.1;0.0;0.02
5811_3.txt;29;1;1;31;528;0.05;0.0;0.0
8881_1.txt;13;0;3;16;328;0.04;0.0;0.01
2362_1.txt;6;1;0;7;438;0.01;0.0;0.0
127_4.txt;5;4;0;9;314;0.02;0.01;0.0
9239_2.txt;11;1;1;13;189;0.06;0.01;0.01
11504_1.txt;0;0;0;0;171;0.0;0.0;0.0
9413_2.txt;14;0;0;14;202;0.07;0.0;0.0
6814_4.txt;7;0;0;7;467;0.01;0.0;0.0
5055_4.txt;6;2;0;8;311;0.02;0.01;0.0
12472_2.txt;0;1;0;1;100;0.0;0.01;0.0
10317_1.txt;1;0;0;1;131;0.01;0.0;0.0
12184_1.txt;0;0;0;0;53;0.0;0.0;0.0
6275_2.txt;0;2;0;2;130;0.0;0.02;0.0
9231_4.txt;6;4;2;12;226;0.03;0.02;0.01
5862_2.txt;20;0;0;20;395;0.05;0.0;0.0
8299_1.txt;2;0;0;2;102;0.02;0.0;0.0
2897_4.txt;11;0;0;11;202;0.05;0.0;0.0
3672_4.txt;14;1;0;15;123;0.11;0.01;0.0
4056_4.txt;12;5;10;27;527;0.02;0.01;0.02
6532_4.txt;1;3;0;4;290;0.0;0.01;0.0
11701_3.txt;6;0;0;6;244;0.02;0.0;0.0
6816_1.txt;2;0;1;3;334;0.01;0.0;0.0
3757_1.txt;3;0;0;3;146;0.02;0.0;0.0
3436_2.txt;7;0;0;7;210;0.03;0.0;0.0
9676_1.txt;0;0;0;0;204;0.0;0.0;0.0
11614_3.txt;7;0;0;7;179;0.04;0.0;0.0
3786_1.txt;4;0;0;4;194;0.02;0.0;0.0
5743_2.txt;0;0;0;0;379;0.0;0.0;0.0
10175_3.txt;7;3;1;11;410;0.02;0.01;0.0
7896_1.txt;0;0;0;0;108;0.0;0.0;0.0
4906_1.txt;0;0;0;0;93;0.0;0.0;0.0
6149_1.txt;12;0;1;13;187;0.06;0.0;0.01
5771_1.txt;2;0;0;2;692;0.0;0.0;0.0
3165_2.txt;4;0;0;4;153;0.03;0.0;0.0
1318_2.txt;8;2;0;10;279;0.03;0.01;0.0
3753_1.txt;7;0;4;11;122;0.06;0.0;0.03
7044_1.txt;8;0;0;8;179;0.04;0.0;0.0
8994_2.txt;10;2;3;15;143;0.07;0.01;0.02
4229_2.txt;9;1;0;10;203;0.04;0.0;0.0
6416_4.txt;3;0;0;3;346;0.01;0.0;0.0
5503_1.txt;6;0;0;6;145;0.04;0.0;0.0
10645_4.txt;3;0;0;3;156;0.02;0.0;0.0
11177_3.txt;16;1;1;18;262;0.06;0.0;0.0
2771_1.txt;2;2;0;4;423;0.0;0.0;0.0
8679_4.txt;5;2;1;8;759;0.01;0.0;0.0
3697_4.txt;9;0;1;10;524;0.02;0.0;0.0
514_1.txt;5;0;0;5;158;0.03;0.0;0.0
3067_1.txt;2;1;0;3;210;0.01;0.0;0.0
3959_1.txt;0;0;0;0;240;0.0;0.0;0.0
11033_1.txt;1;6;6;13;148;0.01;0.04;0.04
5713_4.txt;0;1;0;1;533;0.0;0.0;0.0
1009_4.txt;23;0;11;34;364;0.06;0.0;0.03
4657_4.txt;8;0;0;8;298;0.03;0.0;0.0
6776_3.txt;12;2;0;14;166;0.07;0.01;0.0
6404_2.txt;7;0;0;7;127;0.06;0.0;0.0
7212_2.txt;14;0;0;14;294;0.05;0.0;0.0
11981_4.txt;8;0;0;8;176;0.05;0.0;0.0
10108_1.txt;14;5;4;23;762;0.02;0.01;0.01
2800_1.txt;0;0;3;3;185;0.0;0.0;0.02
11707_1.txt;23;0;0;23;420;0.05;0.0;0.0
3559_2.txt;49;1;0;50;457;0.11;0.0;0.0
10332_1.txt;3;0;0;3;167;0.02;0.0;0.0
2_1.txt;5;0;0;5;150;0.03;0.0;0.0
5455_1.txt;4;0;0;4;341;0.01;0.0;0.0
6555_2.txt;8;3;0;11;224;0.04;0.01;0.0
6271_1.txt;0;0;0;0;226;0.0;0.0;0.0
1341_3.txt;15;0;1;16;350;0.04;0.0;0.0
7227_2.txt;3;0;0;3;228;0.01;0.0;0.0
10639_1.txt;6;0;0;6;136;0.04;0.0;0.0
883_1.txt;2;2;0;4;180;0.01;0.01;0.0
11957_1.txt;26;0;0;26;1004;0.03;0.0;0.0
10027_1.txt;9;2;1;12;140;0.06;0.01;0.01
4738_4.txt;14;0;1;15;322;0.04;0.0;0.0
1589_1.txt;5;1;1;7;262;0.02;0.0;0.0
1285_1.txt;3;2;0;5;136;0.02;0.01;0.0
4069_1.txt;2;0;0;2;216;0.01;0.0;0.0
9761_2.txt;18;1;2;21;603;0.03;0.0;0.0
2114_4.txt;14;0;2;16;174;0.08;0.0;0.01
7066_1.txt;0;0;0;0;167;0.0;0.0;0.0
5489_1.txt;3;0;0;3;170;0.02;0.0;0.0
11282_2.txt;30;3;6;39;447;0.07;0.01;0.01
1616_4.txt;2;3;2;7;204;0.01;0.01;0.01
8701_2.txt;0;0;0;0;208;0.0;0.0;0.0
6764_4.txt;27;4;3;34;660;0.04;0.01;0.0
10592_1.txt;13;2;3;18;547;0.02;0.0;0.01
8890_1.txt;7;0;1;8;242;0.03;0.0;0.0
2230_1.txt;0;0;0;0;143;0.0;0.0;0.0
11029_4.txt;102;2;9;113;1126;0.09;0.0;0.01
3864_4.txt;4;0;0;4;171;0.02;0.0;0.0
4832_2.txt;2;0;0;2;271;0.01;0.0;0.0
4648_1.txt;0;0;0;0;134;0.0;0.0;0.0
11015_1.txt;3;0;0;3;316;0.01;0.0;0.0
11563_3.txt;3;0;0;3;357;0.01;0.0;0.0
3666_3.txt;0;1;0;1;176;0.0;0.01;0.0
6092_1.txt;4;2;0;6;484;0.01;0.0;0.0
8309_3.txt;13;3;0;16;421;0.03;0.01;0.0
12066_2.txt;0;0;0;0;166;0.0;0.0;0.0
1034_2.txt;3;0;0;3;145;0.02;0.0;0.0
8088_3.txt;15;0;0;15;203;0.07;0.0;0.0
2404_3.txt;16;0;0;16;174;0.09;0.0;0.0
10629_2.txt;4;0;0;4;128;0.03;0.0;0.0
476_1.txt;2;1;0;3;227;0.01;0.0;0.0
1270_1.txt;1;0;0;1;157;0.01;0.0;0.0
45_2.txt;2;2;0;4;408;0.0;0.0;0.0
6630_1.txt;5;1;0;6;256;0.02;0.0;0.0
5930_3.txt;14;0;0;14;201;0.07;0.0;0.0
188_1.txt;0;1;0;1;93;0.0;0.01;0.0
2793_1.txt;0;0;2;2;364;0.0;0.0;0.01
3872_4.txt;5;0;0;5;127;0.04;0.0;0.0
4673_1.txt;19;2;0;21;277;0.07;0.01;0.0
8482_1.txt;4;1;0;5;204;0.02;0.0;0.0
11129_2.txt;13;0;0;13;136;0.1;0.0;0.0
12385_1.txt;0;0;0;0;72;0.0;0.0;0.0
2339_1.txt;3;0;1;4;146;0.02;0.0;0.01
214_4.txt;0;0;0;0;209;0.0;0.0;0.0
12494_1.txt;0;0;3;3;142;0.0;0.0;0.02
10285_3.txt;0;0;0;0;589;0.0;0.0;0.0
1343_1.txt;0;1;0;1;217;0.0;0.0;0.0
8640_4.txt;4;0;0;4;290;0.01;0.0;0.0
7885_1.txt;0;0;0;0;155;0.0;0.0;0.0
3465_4.txt;0;0;0;0;47;0.0;0.0;0.0
12380_1.txt;0;0;0;0;132;0.0;0.0;0.0
10059_4.txt;9;4;0;13;186;0.05;0.02;0.0
6382_2.txt;8;0;0;8;190;0.04;0.0;0.0
1127_4.txt;4;1;0;5;51;0.08;0.02;0.0
12325_3.txt;5;1;2;8;149;0.03;0.01;0.01
6825_4.txt;2;0;0;2;275;0.01;0.0;0.0
7657_1.txt;17;0;0;17;863;0.02;0.0;0.0
8702_2.txt;2;0;2;4;437;0.0;0.0;0.0
7936_4.txt;0;0;0;0;436;0.0;0.0;0.0
5375_2.txt;0;0;0;0;472;0.0;0.0;0.0
3299_1.txt;0;0;0;0;220;0.0;0.0;0.0
2448_4.txt;19;2;0;21;428;0.04;0.0;0.0
12386_1.txt;1;0;0;1;141;0.01;0.0;0.0
12136_1.txt;0;0;0;0;194;0.0;0.0;0.0
12075_1.txt;3;0;0;3;124;0.02;0.0;0.0
1099_4.txt;3;0;0;3;153;0.02;0.0;0.0
10801_1.txt;5;0;0;5;199;0.03;0.0;0.0
788_2.txt;4;0;0;4;342;0.01;0.0;0.0
10674_1.txt;2;1;1;4;137;0.01;0.01;0.01
10258_4.txt;16;1;0;17;185;0.09;0.01;0.0
997_4.txt;9;0;0;9;576;0.02;0.0;0.0
5379_2.txt;0;1;0;1;267;0.0;0.0;0.0
4600_4.txt;1;0;0;1;163;0.01;0.0;0.0
12478_1.txt;2;0;0;2;330;0.01;0.0;0.0
7641_3.txt;0;0;0;0;157;0.0;0.0;0.0
7776_1.txt;1;0;0;1;325;0.0;0.0;0.0
5740_3.txt;4;0;0;4;250;0.02;0.0;0.0
4055_3.txt;0;0;0;0;435;0.0;0.0;0.0
7478_2.txt;0;0;0;0;128;0.0;0.0;0.0
7663_1.txt;11;2;0;13;131;0.08;0.02;0.0
2820_4.txt;5;0;0;5;103;0.05;0.0;0.0
9105_2.txt;19;0;0;19;300;0.06;0.0;0.0
3081_2.txt;0;0;0;0;115;0.0;0.0;0.0
11221_4.txt;3;0;0;3;101;0.03;0.0;0.0
5923_4.txt;20;0;4;24;159;0.13;0.0;0.03
11685_2.txt;17;0;4;21;647;0.03;0.0;0.01
5660_1.txt;3;0;1;4;196;0.02;0.0;0.01
11947_4.txt;5;0;0;5;136;0.04;0.0;0.0
7173_1.txt;2;0;4;6;624;0.0;0.0;0.01
8545_3.txt;3;0;0;3;506;0.01;0.0;0.0
3687_1.txt;0;1;0;1;146;0.0;0.01;0.0
11625_4.txt;8;2;4;14;155;0.05;0.01;0.03
8996_1.txt;5;1;1;7;164;0.03;0.01;0.01
12495_1.txt;9;4;0;13;728;0.01;0.01;0.0
232_1.txt;6;1;0;7;158;0.04;0.01;0.0
4924_1.txt;5;0;0;5;242;0.02;0.0;0.0
8584_4.txt;0;0;0;0;46;0.0;0.0;0.0
1861_3.txt;0;0;0;0;120;0.0;0.0;0.0
2091_3.txt;1;1;5;7;243;0.0;0.0;0.02
1997_2.txt;8;0;0;8;200;0.04;0.0;0.0
4707_1.txt;4;0;0;4;129;0.03;0.0;0.0
6719_2.txt;1;1;0;2;152;0.01;0.01;0.0
2623_1.txt;4;0;0;4;291;0.01;0.0;0.0
4674_3.txt;11;0;0;11;173;0.06;0.0;0.0
6537_1.txt;0;1;0;1;137;0.0;0.01;0.0
11759_3.txt;8;0;1;9;162;0.05;0.0;0.01
9121_3.txt;2;2;0;4;103;0.02;0.02;0.0
6510_4.txt;4;0;1;5;228;0.02;0.0;0.0
6855_4.txt;2;0;2;4;134;0.01;0.0;0.01
5158_3.txt;4;0;0;4;92;0.04;0.0;0.0
8806_3.txt;0;0;3;3;165;0.0;0.0;0.02
10109_1.txt;2;3;2;7;183;0.01;0.02;0.01
11308_3.txt;1;1;0;2;101;0.01;0.01;0.0
9269_1.txt;1;0;0;1;166;0.01;0.0;0.0
4327_4.txt;2;0;0;2;92;0.02;0.0;0.0
8762_1.txt;3;0;0;3;148;0.02;0.0;0.0
3755_4.txt;1;0;0;1;192;0.01;0.0;0.0
10119_2.txt;1;0;0;1;161;0.01;0.0;0.0
7773_1.txt;0;0;0;0;200;0.0;0.0;0.0
62_2.txt;0;3;2;5;399;0.0;0.01;0.01
9332_3.txt;4;1;0;5;159;0.03;0.01;0.0
4838_1.txt;0;1;0;1;165;0.0;0.01;0.0
3645_3.txt;5;0;0;5;189;0.03;0.0;0.0
7448_2.txt;38;4;3;45;547;0.07;0.01;0.01
7677_4.txt;6;0;3;9;129;0.05;0.0;0.02
308_1.txt;0;0;0;0;76;0.0;0.0;0.0
10492_1.txt;1;0;0;1;49;0.02;0.0;0.0
11991_3.txt;0;0;0;0;160;0.0;0.0;0.0
2580_3.txt;3;0;1;4;147;0.02;0.0;0.01
3438_4.txt;0;0;0;0;198;0.0;0.0;0.0
2005_3.txt;3;0;0;3;180;0.02;0.0;0.0
4734_2.txt;2;0;1;3;302;0.01;0.0;0.0
11137_1.txt;0;0;0;0;129;0.0;0.0;0.0
9296_4.txt;4;0;0;4;408;0.01;0.0;0.0
8510_1.txt;3;0;0;3;226;0.01;0.0;0.0
2181_1.txt;0;0;0;0;75;0.0;0.0;0.0
11681_1.txt;0;0;0;0;211;0.0;0.0;0.0
1446_2.txt;7;0;0;7;129;0.05;0.0;0.0
7855_1.txt;0;0;0;0;144;0.0;0.0;0.0
4303_1.txt;7;3;0;10;256;0.03;0.01;0.0
1840_1.txt;6;0;0;6;177;0.03;0.0;0.0
7439_4.txt;3;0;0;3;159;0.02;0.0;0.0
9518_3.txt;6;1;0;7;127;0.05;0.01;0.0
11130_3.txt;25;12;5;42;1084;0.02;0.01;0.0
12326_1.txt;7;0;0;7;302;0.02;0.0;0.0
122_1.txt;0;0;0;0;134;0.0;0.0;0.0
3992_2.txt;9;0;0;9;299;0.03;0.0;0.0
7634_2.txt;1;0;0;1;189;0.01;0.0;0.0
1712_1.txt;5;0;0;5;280;0.02;0.0;0.0
5275_4.txt;4;2;1;7;423;0.01;0.0;0.0
4401_1.txt;0;0;0;0;151;0.0;0.0;0.0
376_4.txt;4;0;4;8;195;0.02;0.0;0.02
3414_1.txt;0;0;0;0;295;0.0;0.0;0.0
2767_1.txt;1;0;0;1;132;0.01;0.0;0.0
7765_4.txt;2;0;0;2;112;0.02;0.0;0.0
7891_2.txt;6;3;0;9;319;0.02;0.01;0.0
4661_3.txt;4;0;0;4;183;0.02;0.0;0.0
7586_4.txt;45;2;1;48;358;0.13;0.01;0.0
3519_3.txt;3;0;1;4;174;0.02;0.0;0.01
11615_2.txt;13;0;0;13;430;0.03;0.0;0.0
12085_3.txt;6;0;0;6;269;0.02;0.0;0.0
1471_4.txt;0;0;0;0;137;0.0;0.0;0.0
4101_1.txt;0;0;0;0;144;0.0;0.0;0.0
10506_1.txt;11;1;1;13;1054;0.01;0.0;0.0
545_1.txt;0;6;0;6;103;0.0;0.06;0.0
11755_3.txt;2;0;0;2;60;0.03;0.0;0.0
3037_1.txt;0;0;0;0;152;0.0;0.0;0.0
9353_3.txt;2;0;0;2;286;0.01;0.0;0.0
6013_1.txt;0;0;1;1;211;0.0;0.0;0.0
3923_2.txt;23;1;6;30;784;0.03;0.0;0.01
9415_4.txt;14;0;0;14;176;0.08;0.0;0.0
3207_1.txt;1;1;0;2;161;0.01;0.01;0.0
9158_1.txt;0;0;0;0;189;0.0;0.0;0.0
7248_2.txt;2;1;0;3;146;0.01;0.01;0.0
1867_2.txt;5;0;1;6;202;0.02;0.0;0.0
7532_4.txt;0;0;0;0;127;0.0;0.0;0.0
2938_3.txt;13;4;0;17;506;0.03;0.01;0.0
1302_2.txt;0;1;0;1;290;0.0;0.0;0.0
11721_1.txt;0;0;0;0;126;0.0;0.0;0.0
9822_1.txt;0;0;0;0;101;0.0;0.0;0.0
11361_4.txt;0;0;0;0;182;0.0;0.0;0.0
5588_3.txt;16;2;0;18;153;0.1;0.01;0.0
689_1.txt;6;0;0;6;294;0.02;0.0;0.0
4430_1.txt;20;0;0;20;217;0.09;0.0;0.0
10273_2.txt;0;0;0;0;364;0.0;0.0;0.0
3240_1.txt;0;6;0;6;406;0.0;0.01;0.0
1694_1.txt;0;1;0;1;164;0.0;0.01;0.0
1934_4.txt;21;11;12;44;785;0.03;0.01;0.02
4944_3.txt;3;2;2;7;440;0.01;0.0;0.0
8477_3.txt;0;0;0;0;232;0.0;0.0;0.0
5467_2.txt;0;0;2;2;141;0.0;0.0;0.01
2202_1.txt;2;0;0;2;142;0.01;0.0;0.0
11146_4.txt;4;0;0;4;188;0.02;0.0;0.0
5920_3.txt;8;2;0;10;139;0.06;0.01;0.0
7271_4.txt;0;0;0;0;148;0.0;0.0;0.0
1642_3.txt;6;0;0;6;189;0.03;0.0;0.0
8985_2.txt;10;0;1;11;147;0.07;0.0;0.01
9404_1.txt;2;2;0;4;152;0.01;0.01;0.0
10042_1.txt;1;4;0;5;256;0.0;0.02;0.0
1055_2.txt;3;2;0;5;247;0.01;0.01;0.0
11030_1.txt;2;0;0;2;233;0.01;0.0;0.0
9520_4.txt;15;0;1;16;372;0.04;0.0;0.0
11665_3.txt;0;0;0;0;279;0.0;0.0;0.0
9786_2.txt;0;0;1;1;249;0.0;0.0;0.0
5183_4.txt;0;2;2;4;226;0.0;0.01;0.01
645_2.txt;0;0;0;0;543;0.0;0.0;0.0
6376_4.txt;8;0;0;8;144;0.06;0.0;0.0
3707_2.txt;7;0;0;7;132;0.05;0.0;0.0
5428_4.txt;26;0;0;26;933;0.03;0.0;0.0
328_1.txt;4;0;0;4;206;0.02;0.0;0.0
8360_3.txt;0;1;1;2;432;0.0;0.0;0.0
10781_2.txt;12;1;0;13;133;0.09;0.01;0.0
9060_1.txt;0;2;0;2;343;0.0;0.01;0.0
2606_4.txt;20;0;1;21;341;0.06;0.0;0.0
6206_1.txt;6;0;0;6;305;0.02;0.0;0.0
7628_1.txt;0;0;0;0;136;0.0;0.0;0.0
2015_2.txt;4;0;4;8;181;0.02;0.0;0.02
5546_4.txt;8;1;0;9;289;0.03;0.0;0.0
1115_1.txt;1;0;0;1;108;0.01;0.0;0.0
6839_2.txt;4;0;2;6;115;0.03;0.0;0.02
7840_4.txt;2;2;0;4;344;0.01;0.01;0.0
1239_1.txt;9;0;0;9;134;0.07;0.0;0.0
12131_2.txt;10;0;0;10;238;0.04;0.0;0.0
4068_3.txt;2;0;0;2;319;0.01;0.0;0.0
9747_3.txt;5;1;0;6;309;0.02;0.0;0.0
2791_3.txt;19;0;1;20;707;0.03;0.0;0.0
7552_1.txt;23;2;0;25;771;0.03;0.0;0.0
11863_1.txt;9;0;0;9;385;0.02;0.0;0.0
9280_1.txt;0;0;1;1;147;0.0;0.0;0.01
6200_1.txt;0;2;1;3;238;0.0;0.01;0.0
11231_3.txt;3;0;0;3;169;0.02;0.0;0.0
5531_2.txt;22;4;0;26;234;0.09;0.02;0.0
4336_4.txt;0;0;0;0;233;0.0;0.0;0.0
2834_1.txt;19;1;0;20;335;0.06;0.0;0.0
907_1.txt;0;0;0;0;124;0.0;0.0;0.0
9500_2.txt;15;0;0;15;224;0.07;0.0;0.0
3608_3.txt;0;0;2;2;149;0.0;0.0;0.01
701_4.txt;0;1;2;3;568;0.0;0.0;0.0
11606_4.txt;0;0;0;0;91;0.0;0.0;0.0
1014_2.txt;5;0;0;5;121;0.04;0.0;0.0
12277_3.txt;4;0;0;4;74;0.05;0.0;0.0
2641_1.txt;0;1;2;3;120;0.0;0.01;0.02
11203_1.txt;4;0;1;5;395;0.01;0.0;0.0
12282_1.txt;3;2;4;9;185;0.02;0.01;0.02
2454_4.txt;18;1;2;21;495;0.04;0.0;0.0
9079_1.txt;0;0;0;0;176;0.0;0.0;0.0
4719_1.txt;0;0;0;0;123;0.0;0.0;0.0
8759_1.txt;4;0;0;4;66;0.06;0.0;0.0
8932_2.txt;13;0;0;13;351;0.04;0.0;0.0
2283_4.txt;9;0;0;9;224;0.04;0.0;0.0
6244_1.txt;15;1;3;19;172;0.09;0.01;0.02
3084_1.txt;1;0;0;1;198;0.01;0.0;0.0
10324_2.txt;2;1;8;11;134;0.01;0.01;0.06
6169_1.txt;0;0;0;0;348;0.0;0.0;0.0
8364_2.txt;2;0;3;5;94;0.02;0.0;0.03
12251_3.txt;4;6;2;12;582;0.01;0.01;0.0
7167_3.txt;5;0;0;5;76;0.07;0.0;0.0
1436_3.txt;0;0;1;1;158;0.0;0.0;0.01
980_4.txt;1;0;0;1;200;0.01;0.0;0.0
11044_1.txt;2;1;0;3;142;0.01;0.01;0.0
9683_1.txt;0;0;0;0;111;0.0;0.0;0.0
4708_1.txt;3;0;0;3;319;0.01;0.0;0.0
4596_2.txt;0;0;0;0;210;0.0;0.0;0.0
4586_1.txt;4;1;2;7;90;0.04;0.01;0.02
11280_3.txt;0;0;0;0;145;0.0;0.0;0.0
1872_1.txt;2;0;0;2;324;0.01;0.0;0.0
910_4.txt;2;0;0;2;104;0.02;0.0;0.0
8370_1.txt;16;8;2;26;757;0.02;0.01;0.0
9411_1.txt;0;3;0;3;459;0.0;0.01;0.0
1721_1.txt;2;3;0;5;151;0.01;0.02;0.0
1570_2.txt;0;0;0;0;20;0.0;0.0;0.0
11404_4.txt;0;1;0;1;286;0.0;0.0;0.0
1057_3.txt;0;0;0;0;97;0.0;0.0;0.0
3599_2.txt;4;0;0;4;146;0.03;0.0;0.0
11745_1.txt;9;2;0;11;357;0.03;0.01;0.0
9712_1.txt;0;0;0;0;182;0.0;0.0;0.0
1182_3.txt;0;0;0;0;195;0.0;0.0;0.0
832_3.txt;3;0;0;3;489;0.01;0.0;0.0
1526_1.txt;1;0;0;1;141;0.01;0.0;0.0
3361_4.txt;4;0;0;4;151;0.03;0.0;0.0
4506_1.txt;6;1;0;7;153;0.04;0.01;0.0
8653_1.txt;0;0;0;0;281;0.0;0.0;0.0
2048_1.txt;2;0;0;2;205;0.01;0.0;0.0
5240_1.txt;0;0;0;0;150;0.0;0.0;0.0
4268_1.txt;3;1;0;4;252;0.01;0.0;0.0
11826_4.txt;4;0;0;4;119;0.03;0.0;0.0
3832_4.txt;42;1;2;45;514;0.08;0.0;0.0
2845_4.txt;3;1;1;5;124;0.02;0.01;0.01
3875_1.txt;0;1;0;1;81;0.0;0.01;0.0
210_4.txt;3;1;4;8;306;0.01;0.0;0.01
3914_2.txt;2;0;0;2;58;0.03;0.0;0.0
5376_3.txt;0;1;0;1;990;0.0;0.0;0.0
3048_1.txt;1;5;0;6;145;0.01;0.03;0.0
6953_2.txt;15;2;2;19;713;0.02;0.0;0.0
4423_2.txt;3;0;0;3;142;0.02;0.0;0.0
4435_1.txt;4;0;0;4;158;0.03;0.0;0.0
923_2.txt;4;2;6;12;204;0.02;0.01;0.03
664_2.txt;0;0;0;0;319;0.0;0.0;0.0
11919_1.txt;0;0;0;0;162;0.0;0.0;0.0
6474_3.txt;8;1;1;10;404;0.02;0.0;0.0
1654_1.txt;8;1;2;11;1045;0.01;0.0;0.0
622_2.txt;0;0;0;0;113;0.0;0.0;0.0
12019_4.txt;14;1;0;15;226;0.06;0.0;0.0
5996_3.txt;19;2;6;27;679;0.03;0.0;0.01
3366_1.txt;7;0;0;7;150;0.05;0.0;0.0
8080_3.txt;8;0;0;8;86;0.09;0.0;0.0
10934_2.txt;1;0;2;3;265;0.0;0.0;0.01
9025_1.txt;0;0;0;0;121;0.0;0.0;0.0
5245_4.txt;0;0;0;0;141;0.0;0.0;0.0
3742_1.txt;0;0;0;0;66;0.0;0.0;0.0
1468_1.txt;0;0;0;0;119;0.0;0.0;0.0
6863_3.txt;0;0;0;0;440;0.0;0.0;0.0
5541_2.txt;9;0;0;9;310;0.03;0.0;0.0
2637_1.txt;0;0;0;0;128;0.0;0.0;0.0
8800_3.txt;1;0;0;1;142;0.01;0.0;0.0
11207_4.txt;22;0;0;22;420;0.05;0.0;0.0
12189_4.txt;3;0;0;3;273;0.01;0.0;0.0
58_3.txt;14;13;9;36;858;0.02;0.02;0.01
989_4.txt;4;0;0;4;371;0.01;0.0;0.0
7964_4.txt;11;0;0;11;481;0.02;0.0;0.0
168_1.txt;8;0;1;9;308;0.03;0.0;0.0
2282_4.txt;35;0;0;35;212;0.17;0.0;0.0
3089_1.txt;0;0;1;1;149;0.0;0.0;0.01
2428_4.txt;6;1;0;7;337;0.02;0.0;0.0
5144_1.txt;2;0;1;3;629;0.0;0.0;0.0
7238_2.txt;2;0;0;2;100;0.02;0.0;0.0
5046_3.txt;4;3;0;7;165;0.02;0.02;0.0
5906_1.txt;0;1;0;1;186;0.0;0.01;0.0
167_1.txt;9;1;0;10;187;0.05;0.01;0.0
3843_3.txt;34;0;0;34;627;0.05;0.0;0.0
1779_1.txt;15;0;0;15;247;0.06;0.0;0.0
7185_3.txt;0;0;0;0;261;0.0;0.0;0.0
345_4.txt;12;0;0;12;383;0.03;0.0;0.0
9414_3.txt;7;1;1;9;301;0.02;0.0;0.0
9389_4.txt;2;0;0;2;277;0.01;0.0;0.0
12109_4.txt;20;0;1;21;453;0.04;0.0;0.0
11519_1.txt;4;0;0;4;100;0.04;0.0;0.0
4585_2.txt;0;0;0;0;129;0.0;0.0;0.0
11790_1.txt;1;0;0;1;70;0.01;0.0;0.0
6739_1.txt;8;1;0;9;286;0.03;0.0;0.0
8483_1.txt;4;2;0;6;662;0.01;0.0;0.0
5791_1.txt;0;4;2;6;222;0.0;0.02;0.01
1535_1.txt;0;0;0;0;359;0.0;0.0;0.0
1452_1.txt;2;4;1;7;205;0.01;0.02;0.0
11604_1.txt;0;0;0;0;70;0.0;0.0;0.0
12322_4.txt;8;2;1;11;361;0.02;0.01;0.0
920_1.txt;9;0;1;10;309;0.03;0.0;0.0
9402_1.txt;3;0;0;3;168;0.02;0.0;0.0
893_2.txt;0;0;0;0;218;0.0;0.0;0.0
9613_1.txt;19;1;0;20;441;0.04;0.0;0.0
4204_4.txt;50;0;1;51;584;0.09;0.0;0.0
330_1.txt;4;0;0;4;167;0.02;0.0;0.0
4439_4.txt;15;0;2;17;242;0.06;0.0;0.01
10504_1.txt;0;0;0;0;192;0.0;0.0;0.0
1085_2.txt;14;0;0;14;466;0.03;0.0;0.0
3776_4.txt;4;6;2;12;628;0.01;0.01;0.0
663_1.txt;7;3;2;12;317;0.02;0.01;0.01
2190_2.txt;10;3;0;13;242;0.04;0.01;0.0
6798_1.txt;0;0;2;2;182;0.0;0.0;0.01
12422_1.txt;8;2;0;10;187;0.04;0.01;0.0
6229_3.txt;0;0;0;0;394;0.0;0.0;0.0
6408_2.txt;2;0;4;6;334;0.01;0.0;0.01
762_2.txt;3;0;0;3;95;0.03;0.0;0.0
7318_4.txt;9;0;0;9;201;0.04;0.0;0.0
9958_1.txt;0;0;0;0;146;0.0;0.0;0.0
10078_1.txt;2;0;0;2;157;0.01;0.0;0.0
2308_1.txt;4;0;0;4;145;0.03;0.0;0.0
6472_2.txt;9;0;4;13;513;0.02;0.0;0.01
4132_1.txt;1;1;4;6;225;0.0;0.0;0.02
3372_3.txt;4;0;0;4;214;0.02;0.0;0.0
9636_1.txt;12;1;0;13;205;0.06;0.0;0.0
6982_4.txt;21;6;4;31;231;0.09;0.03;0.02
5392_3.txt;45;1;3;49;910;0.05;0.0;0.0
9012_1.txt;3;0;0;3;188;0.02;0.0;0.0
10978_1.txt;0;0;0;0;151;0.0;0.0;0.0
12021_1.txt;9;0;0;9;250;0.04;0.0;0.0
6391_2.txt;0;0;0;0;302;0.0;0.0;0.0
3475_3.txt;29;1;1;31;553;0.05;0.0;0.0
4026_1.txt;0;2;0;2;60;0.0;0.03;0.0
337_4.txt;4;0;0;4;115;0.03;0.0;0.0
10890_2.txt;0;0;0;0;77;0.0;0.0;0.0
4343_3.txt;14;1;1;16;542;0.03;0.0;0.0
1337_4.txt;1;0;0;1;67;0.01;0.0;0.0
11749_4.txt;3;0;0;3;103;0.03;0.0;0.0
208_1.txt;2;0;1;3;125;0.02;0.0;0.01
414_2.txt;5;0;0;5;355;0.01;0.0;0.0
9050_1.txt;0;0;2;2;233;0.0;0.0;0.01
4378_4.txt;0;1;0;1;259;0.0;0.0;0.0
8242_3.txt;0;0;0;0;228;0.0;0.0;0.0
11659_2.txt;6;0;0;6;355;0.02;0.0;0.0
3529_2.txt;44;0;0;44;282;0.16;0.0;0.0
8051_2.txt;2;0;0;2;59;0.03;0.0;0.0
10939_3.txt;0;0;0;0;94;0.0;0.0;0.0
9227_2.txt;6;1;0;7;415;0.01;0.0;0.0
2560_1.txt;0;0;0;0;132;0.0;0.0;0.0
6620_1.txt;59;0;2;61;827;0.07;0.0;0.0
12141_3.txt;0;0;1;1;509;0.0;0.0;0.0
4501_4.txt;2;1;0;3;147;0.01;0.01;0.0
8398_3.txt;9;2;4;15;299;0.03;0.01;0.01
9407_4.txt;0;0;0;0;139;0.0;0.0;0.0
11195_1.txt;8;1;0;9;527;0.02;0.0;0.0
5873_1.txt;0;0;0;0;174;0.0;0.0;0.0
11358_3.txt;0;2;0;2;195;0.0;0.01;0.0
3320_2.txt;6;4;0;10;457;0.01;0.01;0.0
2085_1.txt;0;0;0;0;187;0.0;0.0;0.0
6129_4.txt;5;0;1;6;258;0.02;0.0;0.0
110_1.txt;52;10;3;65;1036;0.05;0.01;0.0
9960_4.txt;10;0;0;10;167;0.06;0.0;0.0
5800_2.txt;4;2;0;6;404;0.01;0.0;0.0
6909_1.txt;0;0;0;0;65;0.0;0.0;0.0
6525_2.txt;0;2;1;3;183;0.0;0.01;0.01
12328_1.txt;0;0;0;0;188;0.0;0.0;0.0
419_2.txt;15;0;0;15;435;0.03;0.0;0.0
9_1.txt;0;0;0;0;160;0.0;0.0;0.0
8572_4.txt;12;1;0;13;211;0.06;0.0;0.0
11421_2.txt;0;2;2;4;524;0.0;0.0;0.0
6389_2.txt;7;0;5;12;246;0.03;0.0;0.02
11521_1.txt;0;0;0;0;161;0.0;0.0;0.0
8983_1.txt;4;1;1;6;165;0.02;0.01;0.01
5825_1.txt;2;0;0;2;180;0.01;0.0;0.0
11102_4.txt;2;0;1;3;720;0.0;0.0;0.0
8684_1.txt;2;0;0;2;176;0.01;0.0;0.0
3351_4.txt;9;1;0;10;217;0.04;0.0;0.0
4780_1.txt;4;0;0;4;195;0.02;0.0;0.0
5247_4.txt;0;0;0;0;77;0.0;0.0;0.0
5217_4.txt;11;0;2;13;341;0.03;0.0;0.01
6293_4.txt;2;0;0;2;156;0.01;0.0;0.0
11525_1.txt;0;0;1;1;151;0.0;0.0;0.01
6230_2.txt;1;0;0;1;207;0.0;0.0;0.0
5928_4.txt;3;0;1;4;156;0.02;0.0;0.01
8153_1.txt;0;0;0;0;129;0.0;0.0;0.0
8867_1.txt;8;1;0;9;197;0.04;0.01;0.0
84_3.txt;0;0;0;0;253;0.0;0.0;0.0
8659_1.txt;2;0;0;2;154;0.01;0.0;0.0
4641_1.txt;3;0;0;3;418;0.01;0.0;0.0
2609_1.txt;9;1;0;10;286;0.03;0.0;0.0
4955_3.txt;7;2;0;9;191;0.04;0.01;0.0
7017_4.txt;27;2;0;29;599;0.05;0.0;0.0
8167_4.txt;8;0;0;8;219;0.04;0.0;0.0
5009_3.txt;2;0;1;3;139;0.01;0.0;0.01
3391_3.txt;9;1;4;14;204;0.04;0.0;0.02
5719_2.txt;0;0;0;0;180;0.0;0.0;0.0
11572_1.txt;2;0;3;5;147;0.01;0.0;0.02
10838_1.txt;1;0;0;1;418;0.0;0.0;0.0
6689_1.txt;0;0;1;1;220;0.0;0.0;0.0
10259_1.txt;0;0;0;0;143;0.0;0.0;0.0
6422_1.txt;18;2;4;24;501;0.04;0.0;0.01
12250_2.txt;13;1;3;17;307;0.04;0.0;0.01
8873_3.txt;2;0;0;2;115;0.02;0.0;0.0
7402_2.txt;8;0;0;8;367;0.02;0.0;0.0
8230_4.txt;16;0;0;16;664;0.02;0.0;0.0
7589_3.txt;7;2;2;11;190;0.04;0.01;0.01
6517_3.txt;0;1;0;1;119;0.0;0.01;0.0
2465_2.txt;0;1;0;1;137;0.0;0.01;0.0
1855_3.txt;0;1;0;1;149;0.0;0.01;0.0
20_1.txt;2;0;0;2;158;0.01;0.0;0.0
3496_1.txt;2;0;0;2;208;0.01;0.0;0.0
6413_3.txt;0;0;0;0;215;0.0;0.0;0.0
11848_1.txt;2;0;1;3;194;0.01;0.0;0.01
1678_3.txt;2;1;0;3;188;0.01;0.01;0.0
8494_2.txt;7;0;0;7;217;0.03;0.0;0.0
5058_1.txt;5;3;1;9;185;0.03;0.02;0.01
1907_2.txt;7;1;0;8;182;0.04;0.01;0.0
2748_2.txt;0;0;0;0;161;0.0;0.0;0.0
5156_1.txt;6;0;0;6;164;0.04;0.0;0.0
4667_1.txt;5;0;0;5;149;0.03;0.0;0.0
500_2.txt;0;0;0;0;297;0.0;0.0;0.0
10756_2.txt;8;1;2;11;808;0.01;0.0;0.0
10569_1.txt;0;0;0;0;150;0.0;0.0;0.0
12374_1.txt;0;0;1;1;170;0.0;0.0;0.01
6636_3.txt;0;0;0;0;139;0.0;0.0;0.0
2155_3.txt;8;4;0;12;254;0.03;0.02;0.0
4388_2.txt;1;0;0;1;156;0.01;0.0;0.0
12160_4.txt;18;0;2;20;468;0.04;0.0;0.0
8529_4.txt;4;0;14;18;199;0.02;0.0;0.07
5842_1.txt;0;0;0;0;118;0.0;0.0;0.0
10808_1.txt;2;0;0;2;230;0.01;0.0;0.0
3837_4.txt;6;0;0;6;214;0.03;0.0;0.0
10250_3.txt;2;0;0;2;86;0.02;0.0;0.0
3477_3.txt;14;0;0;14;284;0.05;0.0;0.0
7222_2.txt;3;0;0;3;157;0.02;0.0;0.0
760_4.txt;4;0;0;4;157;0.03;0.0;0.0
10865_2.txt;1;0;0;1;111;0.01;0.0;0.0
9386_2.txt;23;0;1;24;295;0.08;0.0;0.0
179_3.txt;0;1;0;1;153;0.0;0.01;0.0
6337_1.txt;0;0;1;1;65;0.0;0.0;0.02
2239_4.txt;10;0;0;10;159;0.06;0.0;0.0
10422_1.txt;0;0;0;0;163;0.0;0.0;0.0
4890_4.txt;7;0;0;7;243;0.03;0.0;0.0
1382_1.txt;4;0;0;4;77;0.05;0.0;0.0
9019_1.txt;6;2;0;8;414;0.01;0.0;0.0
9141_1.txt;33;2;5;40;526;0.06;0.0;0.01
1821_4.txt;2;0;0;2;48;0.04;0.0;0.0
2390_1.txt;8;0;2;10;193;0.04;0.0;0.01
4645_3.txt;4;2;0;6;168;0.02;0.01;0.0
9966_1.txt;2;0;0;2;225;0.01;0.0;0.0
1945_3.txt;12;0;2;14;753;0.02;0.0;0.0
7410_2.txt;0;0;0;0;253;0.0;0.0;0.0
6560_4.txt;7;0;4;11;212;0.03;0.0;0.02
4941_2.txt;0;0;1;1;219;0.0;0.0;0.0
357_2.txt;31;0;2;33;509;0.06;0.0;0.0
10556_1.txt;0;0;0;0;331;0.0;0.0;0.0
2671_4.txt;8;2;0;10;225;0.04;0.01;0.0
10929_1.txt;11;2;0;13;158;0.07;0.01;0.0
1319_1.txt;10;2;0;12;210;0.05;0.01;0.0
7316_1.txt;2;0;0;2;286;0.01;0.0;0.0
265_1.txt;1;1;0;2;502;0.0;0.0;0.0
493_4.txt;1;0;1;2;134;0.01;0.0;0.01
6838_4.txt;20;8;0;28;236;0.08;0.03;0.0
2247_2.txt;3;2;4;9;91;0.03;0.02;0.04
11099_4.txt;4;2;7;13;686;0.01;0.0;0.01
10784_1.txt;3;0;2;5;101;0.03;0.0;0.02
2819_3.txt;14;1;2;17;297;0.05;0.0;0.01
10344_4.txt;3;0;1;4;239;0.01;0.0;0.0
10103_1.txt;0;1;0;1;304;0.0;0.0;0.0
7889_3.txt;0;0;0;0;370;0.0;0.0;0.0
9870_4.txt;9;0;0;9;246;0.04;0.0;0.0
6563_3.txt;0;3;0;3;136;0.0;0.02;0.0
2335_1.txt;0;0;0;0;154;0.0;0.0;0.0
9496_4.txt;8;2;0;10;129;0.06;0.02;0.0
484_1.txt;5;0;0;5;244;0.02;0.0;0.0
7330_2.txt;12;0;5;17;329;0.04;0.0;0.02
2945_1.txt;3;0;1;4;130;0.02;0.0;0.01
6665_3.txt;1;3;0;4;384;0.0;0.01;0.0
432_4.txt;6;0;0;6;254;0.02;0.0;0.0
2562_4.txt;2;0;0;2;177;0.01;0.0;0.0
4481_1.txt;11;0;1;12;338;0.03;0.0;0.0
8567_1.txt;0;0;1;1;117;0.0;0.0;0.01
12379_2.txt;4;0;0;4;273;0.01;0.0;0.0
5500_1.txt;21;0;9;30;423;0.05;0.0;0.02
173_3.txt;3;0;0;3;97;0.03;0.0;0.0
11022_4.txt;15;4;0;19;311;0.05;0.01;0.0
5680_2.txt;1;0;0;1;437;0.0;0.0;0.0
3657_1.txt;7;0;0;7;140;0.05;0.0;0.0
5241_3.txt;2;0;2;4;389;0.01;0.0;0.01
6221_3.txt;34;1;1;36;689;0.05;0.0;0.0
3488_4.txt;3;1;2;6;252;0.01;0.0;0.01
7975_3.txt;18;3;0;21;294;0.06;0.01;0.0
3953_1.txt;4;0;0;4;139;0.03;0.0;0.0
6279_1.txt;0;0;0;0;316;0.0;0.0;0.0
5564_2.txt;3;0;0;3;59;0.05;0.0;0.0
6676_2.txt;4;0;2;6;406;0.01;0.0;0.0
8973_3.txt;2;0;0;2;55;0.04;0.0;0.0
12193_4.txt;55;4;1;60;932;0.06;0.0;0.0
8795_2.txt;2;1;0;3;212;0.01;0.0;0.0
5048_2.txt;8;0;0;8;443;0.02;0.0;0.0
8987_2.txt;2;0;0;2;133;0.02;0.0;0.0
1025_2.txt;2;1;0;3;179;0.01;0.01;0.0
10206_3.txt;41;0;0;41;247;0.17;0.0;0.0
3469_4.txt;12;1;0;13;991;0.01;0.0;0.0
2232_1.txt;1;0;0;1;183;0.01;0.0;0.0
2346_4.txt;21;0;1;22;259;0.08;0.0;0.0
3675_2.txt;3;0;2;5;158;0.02;0.0;0.01
11622_1.txt;9;0;0;9;299;0.03;0.0;0.0
11579_2.txt;4;10;0;14;234;0.02;0.04;0.0
2747_3.txt;0;0;0;0;337;0.0;0.0;0.0
8384_1.txt;15;2;0;17;304;0.05;0.01;0.0
1112_1.txt;4;0;0;4;136;0.03;0.0;0.0
5259_1.txt;0;0;0;0;135;0.0;0.0;0.0
6484_1.txt;35;1;6;42;1127;0.03;0.0;0.01
10844_1.txt;4;0;0;4;433;0.01;0.0;0.0
2847_2.txt;1;0;0;1;58;0.02;0.0;0.0
11303_4.txt;10;3;0;13;82;0.12;0.04;0.0
1829_1.txt;1;0;0;1;144;0.01;0.0;0.0
2604_3.txt;10;0;0;10;282;0.04;0.0;0.0
6421_1.txt;3;1;0;4;199;0.02;0.01;0.0
1088_1.txt;6;0;0;6;189;0.03;0.0;0.0
3594_1.txt;4;0;0;4;124;0.03;0.0;0.0
282_1.txt;6;1;0;7;172;0.03;0.01;0.0
2062_1.txt;4;0;1;5;369;0.01;0.0;0.0
9665_2.txt;4;0;0;4;179;0.02;0.0;0.0
4484_1.txt;1;2;0;3;393;0.0;0.01;0.0
1262_1.txt;0;0;0;0;154;0.0;0.0;0.0
7457_4.txt;2;0;0;2;145;0.01;0.0;0.0
8522_2.txt;2;0;0;2;38;0.05;0.0;0.0
2999_3.txt;2;0;1;3;98;0.02;0.0;0.01
2354_1.txt;2;0;2;4;215;0.01;0.0;0.01
12493_1.txt;0;0;0;0;72;0.0;0.0;0.0
4523_3.txt;4;2;0;6;280;0.01;0.01;0.0
4038_1.txt;0;0;0;0;160;0.0;0.0;0.0
5033_3.txt;2;1;1;4;91;0.02;0.01;0.01
10944_1.txt;9;0;0;9;330;0.03;0.0;0.0
9984_1.txt;0;0;0;0;75;0.0;0.0;0.0
3738_2.txt;0;0;0;0;212;0.0;0.0;0.0
5136_3.txt;3;0;0;3;187;0.02;0.0;0.0
943_2.txt;0;0;0;0;176;0.0;0.0;0.0
5688_2.txt;3;0;2;5;532;0.01;0.0;0.0
8839_3.txt;6;3;0;9;215;0.03;0.01;0.0
6374_3.txt;18;0;2;20;235;0.08;0.0;0.01
9875_3.txt;2;0;0;2;138;0.01;0.0;0.0
1311_4.txt;4;0;1;5;126;0.03;0.0;0.01
2333_2.txt;0;2;0;2;45;0.0;0.04;0.0
593_1.txt;6;1;0;7;325;0.02;0.0;0.0
9078_1.txt;2;0;0;2;123;0.02;0.0;0.0
8108_3.txt;6;0;0;6;344;0.02;0.0;0.0
984_1.txt;0;1;0;1;207;0.0;0.0;0.0
6508_4.txt;8;0;0;8;151;0.05;0.0;0.0
5529_3.txt;36;2;10;48;456;0.08;0.0;0.02
10034_1.txt;18;1;2;21;271;0.07;0.0;0.01
12244_1.txt;3;0;2;5;237;0.01;0.0;0.01
8628_4.txt;0;0;5;5;150;0.0;0.0;0.03
417_1.txt;2;0;1;3;814;0.0;0.0;0.0
12304_3.txt;6;0;0;6;170;0.04;0.0;0.0
11987_4.txt;4;0;0;4;185;0.02;0.0;0.0
4330_1.txt;12;0;4;16;214;0.06;0.0;0.02
1316_1.txt;57;2;5;64;845;0.07;0.0;0.01
6125_4.txt;5;1;0;6;142;0.04;0.01;0.0
8078_2.txt;29;4;0;33;744;0.04;0.01;0.0
9103_1.txt;4;0;0;4;500;0.01;0.0;0.0
3295_1.txt;7;0;0;7;115;0.06;0.0;0.0
2321_1.txt;0;0;1;1;267;0.0;0.0;0.0
3621_1.txt;3;0;10;13;209;0.01;0.0;0.05
9448_1.txt;0;0;2;2;124;0.0;0.0;0.02
106_2.txt;2;0;0;2;180;0.01;0.0;0.0
8797_4.txt;13;0;2;15;157;0.08;0.0;0.01
4629_1.txt;9;0;0;9;167;0.05;0.0;0.0
1344_1.txt;0;0;0;0;185;0.0;0.0;0.0
11763_3.txt;3;2;0;5;254;0.01;0.01;0.0
8409_4.txt;9;2;0;11;94;0.1;0.02;0.0
10731_1.txt;0;0;0;0;225;0.0;0.0;0.0
849_1.txt;2;0;1;3;521;0.0;0.0;0.0
11503_3.txt;9;2;7;18;346;0.03;0.01;0.02
10396_1.txt;7;0;0;7;344;0.02;0.0;0.0
655_1.txt;0;0;0;0;396;0.0;0.0;0.0
6061_2.txt;5;0;2;7;214;0.02;0.0;0.01
4328_3.txt;12;9;0;21;300;0.04;0.03;0.0
3810_4.txt;6;2;5;13;330;0.02;0.01;0.02
6191_4.txt;6;2;0;8;185;0.03;0.01;0.0
10418_1.txt;0;0;0;0;135;0.0;0.0;0.0
7625_1.txt;4;0;0;4;482;0.01;0.0;0.0
2364_4.txt;8;0;0;8;148;0.05;0.0;0.0
7580_1.txt;5;8;0;13;218;0.02;0.04;0.0
10427_4.txt;5;0;0;5;157;0.03;0.0;0.0
10742_1.txt;2;0;0;2;181;0.01;0.0;0.0
7708_1.txt;0;0;0;0;73;0.0;0.0;0.0
8498_3.txt;0;0;0;0;582;0.0;0.0;0.0
6324_1.txt;6;0;2;8;220;0.03;0.0;0.01
11669_1.txt;0;1;0;1;291;0.0;0.0;0.0
8758_4.txt;6;1;2;9;107;0.06;0.01;0.02
10399_4.txt;0;0;0;0;141;0.0;0.0;0.0
2662_3.txt;6;0;0;6;51;0.12;0.0;0.0
5481_1.txt;0;0;0;0;139;0.0;0.0;0.0
8725_3.txt;6;3;0;9;672;0.01;0.0;0.0
2038_1.txt;0;1;1;2;572;0.0;0.0;0.0
3794_1.txt;1;1;6;8;507;0.0;0.0;0.01
431_4.txt;2;2;4;8;302;0.01;0.01;0.01
12143_1.txt;6;0;1;7;558;0.01;0.0;0.0
2734_4.txt;0;0;0;0;137;0.0;0.0;0.0
2461_4.txt;5;0;0;5;148;0.03;0.0;0.0
1149_3.txt;49;2;15;66;694;0.07;0.0;0.02
7843_4.txt;0;0;1;1;207;0.0;0.0;0.0
9052_1.txt;8;0;0;8;352;0.02;0.0;0.0
2601_3.txt;6;1;0;7;128;0.05;0.01;0.0
5706_2.txt;0;1;0;1;185;0.0;0.01;0.0
5401_2.txt;0;0;0;0;85;0.0;0.0;0.0
3257_1.txt;2;0;0;2;117;0.02;0.0;0.0
4978_2.txt;4;3;0;7;204;0.02;0.01;0.0
4894_2.txt;0;0;0;0;161;0.0;0.0;0.0
8001_3.txt;0;2;0;2;426;0.0;0.0;0.0
9491_1.txt;4;0;0;4;152;0.03;0.0;0.0
5378_3.txt;0;2;0;2;291;0.0;0.01;0.0
14_2.txt;8;0;0;8;190;0.04;0.0;0.0
1681_4.txt;6;0;0;6;137;0.04;0.0;0.0
2556_1.txt;0;0;0;0;196;0.0;0.0;0.0
5765_1.txt;2;0;0;2;302;0.01;0.0;0.0
5536_1.txt;0;0;0;0;289;0.0;0.0;0.0
8997_1.txt;1;5;0;6;309;0.0;0.02;0.0
1371_3.txt;0;0;2;2;156;0.0;0.0;0.01
11475_1.txt;4;0;0;4;177;0.02;0.0;0.0
817_4.txt;6;0;0;6;187;0.03;0.0;0.0
1230_1.txt;4;0;0;4;178;0.02;0.0;0.0
4335_4.txt;11;1;0;12;279;0.04;0.0;0.0
5007_1.txt;3;0;0;3;155;0.02;0.0;0.0
288_1.txt;0;1;0;1;188;0.0;0.01;0.0
3867_3.txt;21;0;0;21;320;0.07;0.0;0.0
2385_1.txt;5;2;0;7;206;0.02;0.01;0.0
1708_1.txt;4;0;0;4;205;0.02;0.0;0.0
1029_3.txt;7;1;0;8;261;0.03;0.0;0.0
10565_3.txt;3;1;1;5;160;0.02;0.01;0.01
3390_4.txt;34;0;1;35;701;0.05;0.0;0.0
972_3.txt;0;0;0;0;160;0.0;0.0;0.0
9403_1.txt;0;0;0;0;94;0.0;0.0;0.0
5872_2.txt;9;0;0;9;149;0.06;0.0;0.0
1417_4.txt;20;1;0;21;139;0.14;0.01;0.0
2894_4.txt;27;0;0;27;726;0.04;0.0;0.0
5370_4.txt;4;1;0;5;219;0.02;0.0;0.0
5269_1.txt;0;0;0;0;48;0.0;0.0;0.0
5101_1.txt;6;0;0;6;179;0.03;0.0;0.0
2378_1.txt;2;2;0;4;168;0.01;0.01;0.0
3957_1.txt;1;0;0;1;240;0.0;0.0;0.0
671_1.txt;9;1;1;11;502;0.02;0.0;0.0
1244_2.txt;3;0;1;4;95;0.03;0.0;0.01
8849_4.txt;10;0;0;10;293;0.03;0.0;0.0
9047_4.txt;3;0;0;3;141;0.02;0.0;0.0
4965_3.txt;1;0;0;1;152;0.01;0.0;0.0
3182_1.txt;9;2;0;11;117;0.08;0.02;0.0
10734_4.txt;0;0;0;0;147;0.0;0.0;0.0
8206_2.txt;2;0;0;2;155;0.01;0.0;0.0
11777_3.txt;3;0;2;5;288;0.01;0.0;0.01
11630_1.txt;0;0;0;0;181;0.0;0.0;0.0
8062_2.txt;0;0;0;0;76;0.0;0.0;0.0
8034_1.txt;2;0;0;2;330;0.01;0.0;0.0
8028_1.txt;0;0;1;1;173;0.0;0.0;0.01
5840_1.txt;5;0;0;5;667;0.01;0.0;0.0
4118_3.txt;0;0;0;0;137;0.0;0.0;0.0
3255_2.txt;21;0;2;23;453;0.05;0.0;0.0
10464_1.txt;2;1;0;3;237;0.01;0.0;0.0
4588_1.txt;0;1;1;2;177;0.0;0.01;0.01
12475_1.txt;0;0;0;0;100;0.0;0.0;0.0
10483_4.txt;2;0;2;4;148;0.01;0.0;0.01
4490_1.txt;7;1;0;8;484;0.01;0.0;0.0
11186_2.txt;2;0;0;2;180;0.01;0.0;0.0
11471_3.txt;0;0;0;0;292;0.0;0.0;0.0
11984_2.txt;0;0;0;0;244;0.0;0.0;0.0
3853_1.txt;7;0;0;7;117;0.06;0.0;0.0
5027_3.txt;8;6;6;20;481;0.02;0.01;0.01
6077_1.txt;0;0;0;0;135;0.0;0.0;0.0
703_4.txt;4;0;0;4;189;0.02;0.0;0.0
555_4.txt;3;0;0;3;283;0.01;0.0;0.0
6471_2.txt;0;1;0;1;110;0.0;0.01;0.0
9276_1.txt;4;0;0;4;227;0.02;0.0;0.0
10975_3.txt;5;0;0;5;206;0.02;0.0;0.0
7823_1.txt;35;1;2;38;1175;0.03;0.0;0.0
8094_2.txt;17;0;0;17;343;0.05;0.0;0.0
906_1.txt;0;0;0;0;141;0.0;0.0;0.0
6364_1.txt;0;0;0;0;127;0.0;0.0;0.0
7780_3.txt;9;1;0;10;383;0.02;0.0;0.0
9871_1.txt;0;5;0;5;135;0.0;0.04;0.0
2769_1.txt;0;1;0;1;150;0.0;0.01;0.0
5079_4.txt;23;4;2;29;552;0.04;0.01;0.0
7678_3.txt;13;2;2;17;335;0.04;0.01;0.01
11446_2.txt;4;1;0;5;149;0.03;0.01;0.0
5483_2.txt;0;4;0;4;334;0.0;0.01;0.0
1370_2.txt;0;0;0;0;302;0.0;0.0;0.0
9345_1.txt;0;1;0;1;426;0.0;0.0;0.0
8596_3.txt;2;0;0;2;214;0.01;0.0;0.0
11732_1.txt;0;0;0;0;261;0.0;0.0;0.0
3111_1.txt;2;0;0;2;139;0.01;0.0;0.0
5595_1.txt;0;0;0;0;104;0.0;0.0;0.0
8513_2.txt;2;0;0;2;80;0.03;0.0;0.0
1561_1.txt;0;0;0;0;75;0.0;0.0;0.0
4524_2.txt;31;2;1;34;530;0.06;0.0;0.0
12391_4.txt;26;2;0;28;429;0.06;0.0;0.0
5309_1.txt;0;0;0;0;163;0.0;0.0;0.0
4540_2.txt;0;0;0;0;131;0.0;0.0;0.0
12346_1.txt;6;2;0;8;260;0.02;0.01;0.0
11499_1.txt;2;1;0;3;133;0.02;0.01;0.0
3215_2.txt;2;0;0;2;152;0.01;0.0;0.0
5818_4.txt;9;0;0;9;101;0.09;0.0;0.0
8525_2.txt;1;0;0;1;41;0.02;0.0;0.0
847_3.txt;0;0;0;0;219;0.0;0.0;0.0
4592_1.txt;7;0;1;8;246;0.03;0.0;0.0
7573_2.txt;6;0;0;6;173;0.03;0.0;0.0
629_1.txt;0;0;0;0;145;0.0;0.0;0.0
12196_3.txt;0;0;0;0;236;0.0;0.0;0.0
2014_4.txt;1;0;0;1;179;0.01;0.0;0.0
5128_4.txt;12;0;0;12;268;0.04;0.0;0.0
108_1.txt;0;0;3;3;177;0.0;0.0;0.02
5036_4.txt;25;0;0;25;309;0.08;0.0;0.0
11321_3.txt;0;0;0;0;184;0.0;0.0;0.0
5274_3.txt;7;1;2;10;157;0.04;0.01;0.01
9406_2.txt;8;3;4;15;601;0.01;0.0;0.01
3328_3.txt;12;0;0;12;456;0.03;0.0;0.0
1433_4.txt;3;1;0;4;68;0.04;0.01;0.0
4402_1.txt;6;0;2;8;407;0.01;0.0;0.0
4726_1.txt;0;0;0;0;179;0.0;0.0;0.0
7987_2.txt;0;4;1;5;161;0.0;0.02;0.01
7984_1.txt;0;0;0;0;218;0.0;0.0;0.0
4012_4.txt;33;0;0;33;943;0.03;0.0;0.0
2250_1.txt;13;0;0;13;263;0.05;0.0;0.0
9656_3.txt;0;0;0;0;184;0.0;0.0;0.0
5901_4.txt;31;2;11;44;413;0.08;0.0;0.03
4975_1.txt;4;3;0;7;271;0.01;0.01;0.0
1118_1.txt;2;0;0;2;139;0.01;0.0;0.0
2659_1.txt;0;0;0;0;126;0.0;0.0;0.0
7720_4.txt;5;3;0;8;242;0.02;0.01;0.0
3159_2.txt;2;0;0;2;212;0.01;0.0;0.0
8625_4.txt;2;0;0;2;188;0.01;0.0;0.0
3593_3.txt;1;0;3;4;225;0.0;0.0;0.01
10072_1.txt;0;1;2;3;275;0.0;0.0;0.01
1552_3.txt;0;0;1;1;222;0.0;0.0;0.0
11438_1.txt;17;2;0;19;219;0.08;0.01;0.0
5682_1.txt;0;0;0;0;147;0.0;0.0;0.0
9551_1.txt;5;0;0;5;211;0.02;0.0;0.0
7086_1.txt;14;0;0;14;280;0.05;0.0;0.0
5363_1.txt;5;0;0;5;144;0.03;0.0;0.0
92_3.txt;0;0;0;0;141;0.0;0.0;0.0
7794_1.txt;0;0;2;2;141;0.0;0.0;0.01
4929_3.txt;22;0;0;22;357;0.06;0.0;0.0
9563_3.txt;31;7;7;45;1059;0.03;0.01;0.01
10439_1.txt;0;0;0;0;142;0.0;0.0;0.0
11629_2.txt;10;0;0;10;168;0.06;0.0;0.0
12387_4.txt;6;0;0;6;124;0.05;0.0;0.0
3347_3.txt;5;0;0;5;580;0.01;0.0;0.0
4826_4.txt;0;0;0;0;170;0.0;0.0;0.0
7775_4.txt;0;0;3;3;303;0.0;0.0;0.01
9581_2.txt;3;1;0;4;200;0.01;0.01;0.0
1983_1.txt;8;0;0;8;343;0.02;0.0;0.0
6862_1.txt;0;0;0;0;84;0.0;0.0;0.0
11589_3.txt;1;0;0;1;60;0.02;0.0;0.0
8330_1.txt;1;1;0;2;388;0.0;0.0;0.0
12253_2.txt;0;0;0;0;105;0.0;0.0;0.0
4197_2.txt;10;0;0;10;188;0.05;0.0;0.0
9228_3.txt;6;0;0;6;177;0.03;0.0;0.0
1359_2.txt;18;3;0;21;343;0.05;0.01;0.0
11969_4.txt;0;6;0;6;241;0.0;0.02;0.0
3386_2.txt;9;0;0;9;258;0.03;0.0;0.0
9805_1.txt;1;1;4;6;120;0.01;0.01;0.03
12139_2.txt;2;0;2;4;527;0.0;0.0;0.0
9627_2.txt;7;0;0;7;155;0.05;0.0;0.0
12367_2.txt;3;1;9;13;569;0.01;0.0;0.02
10596_1.txt;9;0;1;10;139;0.06;0.0;0.01
2153_2.txt;8;0;2;10;181;0.04;0.0;0.01
4889_3.txt;15;2;0;17;576;0.03;0.0;0.0
8897_3.txt;11;3;1;15;260;0.04;0.01;0.0
9430_2.txt;0;0;0;0;162;0.0;0.0;0.0
9424_2.txt;0;0;0;0;142;0.0;0.0;0.0
3173_3.txt;3;0;0;3;180;0.02;0.0;0.0
4031_4.txt;4;15;6;25;777;0.01;0.02;0.01
8501_1.txt;7;2;0;9;117;0.06;0.02;0.0
9393_1.txt;5;1;1;7;196;0.03;0.01;0.01
9962_3.txt;14;1;0;15;445;0.03;0.0;0.0
11619_1.txt;0;0;0;0;180;0.0;0.0;0.0
6174_2.txt;7;0;4;11;431;0.02;0.0;0.01
10073_4.txt;18;1;4;23;436;0.04;0.0;0.01
779_4.txt;4;0;0;4;153;0.03;0.0;0.0
11746_2.txt;2;0;2;4;153;0.01;0.0;0.01
10719_2.txt;8;0;1;9;171;0.05;0.0;0.01
636_4.txt;11;1;0;12;226;0.05;0.0;0.0
9436_2.txt;6;1;0;7;330;0.02;0.0;0.0
525_1.txt;1;1;0;2;139;0.01;0.01;0.0
767_3.txt;2;4;0;6;57;0.04;0.07;0.0
5534_4.txt;12;2;2;16;228;0.05;0.01;0.01
9506_1.txt;0;0;0;0;90;0.0;0.0;0.0
11535_3.txt;10;1;0;11;353;0.03;0.0;0.0
5302_4.txt;13;1;0;14;121;0.11;0.01;0.0
4991_2.txt;1;0;0;1;126;0.01;0.0;0.0
11306_3.txt;20;1;0;21;252;0.08;0.0;0.0
1108_1.txt;2;0;0;2;108;0.02;0.0;0.0
11336_4.txt;29;8;5;42;931;0.03;0.01;0.01
5523_1.txt;12;3;2;17;493;0.02;0.01;0.0
8666_4.txt;4;0;5;9;168;0.02;0.0;0.03
835_2.txt;0;0;0;0;172;0.0;0.0;0.0
5127_4.txt;19;3;0;22;308;0.06;0.01;0.0
7112_4.txt;0;0;0;0;161;0.0;0.0;0.0
7194_1.txt;1;0;2;3;160;0.01;0.0;0.01
11844_3.txt;0;1;0;1;95;0.0;0.01;0.0
479_3.txt;9;11;0;20;574;0.02;0.02;0.0
12466_1.txt;2;0;0;2;170;0.01;0.0;0.0
8415_2.txt;1;0;3;4;136;0.01;0.0;0.02
355_4.txt;8;0;0;8;117;0.07;0.0;0.0
8287_4.txt;6;1;0;7;208;0.03;0.0;0.0
4117_1.txt;2;0;0;2;110;0.02;0.0;0.0
4486_4.txt;5;0;0;5;262;0.02;0.0;0.0
2396_1.txt;0;0;0;0;110;0.0;0.0;0.0
3058_1.txt;1;4;5;10;272;0.0;0.01;0.02
12008_4.txt;50;6;3;59;993;0.05;0.01;0.0
7596_3.txt;8;0;0;8;172;0.05;0.0;0.0
300_4.txt;19;3;0;22;212;0.09;0.01;0.0
892_3.txt;2;18;0;20;1161;0.0;0.02;0.0
6267_1.txt;14;2;0;16;461;0.03;0.0;0.0
1275_2.txt;2;0;0;2;95;0.02;0.0;0.0
662_3.txt;1;0;0;1;465;0.0;0.0;0.0
2727_3.txt;2;0;6;8;139;0.01;0.0;0.04
6_1.txt;0;0;0;0;159;0.0;0.0;0.0
8235_2.txt;0;0;7;7;500;0.0;0.0;0.01
3114_1.txt;4;0;0;4;132;0.03;0.0;0.0
3421_4.txt;12;2;2;16;272;0.04;0.01;0.01
3516_4.txt;7;0;0;7;157;0.04;0.0;0.0
2981_1.txt;4;1;5;10;1571;0.0;0.0;0.0
1186_2.txt;4;0;0;4;438;0.01;0.0;0.0
10968_1.txt;7;3;1;11;960;0.01;0.0;0.0
8502_1.txt;2;1;0;3;124;0.02;0.01;0.0
10972_3.txt;2;0;0;2;150;0.01;0.0;0.0
11466_2.txt;9;0;0;9;554;0.02;0.0;0.0
7699_2.txt;1;0;0;1;234;0.0;0.0;0.0
2940_3.txt;12;0;0;12;342;0.04;0.0;0.0
9573_1.txt;1;0;0;1;127;0.01;0.0;0.0
8018_1.txt;2;0;0;2;174;0.01;0.0;0.0
4525_1.txt;6;2;0;8;287;0.02;0.01;0.0
7853_1.txt;1;1;0;2;139;0.01;0.01;0.0
2849_4.txt;2;1;0;3;112;0.02;0.01;0.0
1122_1.txt;0;0;0;0;68;0.0;0.0;0.0
10148_3.txt;20;0;6;26;761;0.03;0.0;0.01
3949_1.txt;1;0;0;1;290;0.0;0.0;0.0
11906_2.txt;3;3;0;6;175;0.02;0.02;0.0
7275_1.txt;8;1;0;9;325;0.02;0.0;0.0
8718_4.txt;0;0;1;1;221;0.0;0.0;0.0
6830_4.txt;0;0;0;0;66;0.0;0.0;0.0
6306_2.txt;0;0;1;1;179;0.0;0.0;0.01
6397_2.txt;0;1;2;3;132;0.0;0.01;0.02
7536_1.txt;5;0;0;5;601;0.01;0.0;0.0
1277_1.txt;0;0;0;0;237;0.0;0.0;0.0
6658_3.txt;17;6;2;25;535;0.03;0.01;0.0
7727_3.txt;23;0;0;23;483;0.05;0.0;0.0
7409_2.txt;0;1;0;1;384;0.0;0.0;0.0
7380_2.txt;7;0;0;7;274;0.03;0.0;0.0
139_4.txt;2;0;0;2;104;0.02;0.0;0.0
114_4.txt;3;5;0;8;166;0.02;0.03;0.0
11831_3.txt;0;0;2;2;224;0.0;0.0;0.01
11607_1.txt;1;0;0;1;88;0.01;0.0;0.0
8616_1.txt;2;0;0;2;62;0.03;0.0;0.0
11147_2.txt;0;0;0;0;138;0.0;0.0;0.0
11430_3.txt;2;0;0;2;240;0.01;0.0;0.0
4573_1.txt;17;7;2;26;1108;0.02;0.01;0.0
1854_2.txt;0;0;1;1;52;0.0;0.0;0.02
11832_4.txt;1;3;0;4;125;0.01;0.02;0.0
4962_1.txt;6;0;0;6;148;0.04;0.0;0.0
11666_1.txt;2;0;0;2;239;0.01;0.0;0.0
4798_4.txt;0;0;0;0;594;0.0;0.0;0.0
10980_3.txt;0;0;1;1;141;0.0;0.0;0.01
2815_2.txt;17;0;0;17;263;0.06;0.0;0.0
3886_1.txt;6;2;0;8;216;0.03;0.01;0.0
1958_4.txt;0;0;0;0;165;0.0;0.0;0.0
3617_2.txt;0;0;0;0;309;0.0;0.0;0.0
11492_1.txt;2;0;0;2;144;0.01;0.0;0.0
10534_1.txt;4;0;1;5;64;0.06;0.0;0.02
9681_1.txt;2;1;0;3;50;0.04;0.02;0.0
3601_3.txt;2;0;0;2;138;0.01;0.0;0.0
10432_2.txt;10;0;0;10;160;0.06;0.0;0.0
8151_4.txt;12;0;0;12;125;0.1;0.0;0.0
12027_2.txt;2;0;0;2;150;0.01;0.0;0.0
9704_1.txt;0;0;0;0;157;0.0;0.0;0.0
8138_2.txt;7;2;0;9;566;0.01;0.0;0.0
563_4.txt;3;0;0;3;274;0.01;0.0;0.0
6546_3.txt;3;0;0;3;111;0.03;0.0;0.0
440_3.txt;7;3;1;11;300;0.02;0.01;0.0
1170_3.txt;9;2;0;11;421;0.02;0.0;0.0
7113_2.txt;0;0;0;0;275;0.0;0.0;0.0
11952_1.txt;10;0;0;10;167;0.06;0.0;0.0
2760_2.txt;23;2;1;26;1097;0.02;0.0;0.0
3791_1.txt;1;0;0;1;196;0.01;0.0;0.0
10585_2.txt;0;0;0;0;84;0.0;0.0;0.0
2355_3.txt;0;1;0;1;424;0.0;0.0;0.0
5194_2.txt;6;0;0;6;207;0.03;0.0;0.0
10515_1.txt;0;0;0;0;187;0.0;0.0;0.0
4002_1.txt;1;2;0;3;135;0.01;0.01;0.0
12035_3.txt;4;0;0;4;188;0.02;0.0;0.0
2777_2.txt;0;2;2;4;390;0.0;0.01;0.01
8960_2.txt;0;0;0;0;202;0.0;0.0;0.0
10436_4.txt;27;5;8;40;623;0.04;0.01;0.01
6579_4.txt;32;0;5;37;654;0.05;0.0;0.01
6439_1.txt;2;0;0;2;837;0.0;0.0;0.0
8919_2.txt;5;0;1;6;341;0.01;0.0;0.0
8895_3.txt;30;4;4;38;608;0.05;0.01;0.01
5439_2.txt;17;2;0;19;570;0.03;0.0;0.0
7868_3.txt;6;0;0;6;159;0.04;0.0;0.0
2456_3.txt;23;6;9;38;1182;0.02;0.01;0.01
3179_2.txt;1;0;0;1;242;0.0;0.0;0.0
1439_3.txt;7;3;0;10;328;0.02;0.01;0.0
1740_3.txt;1;0;0;1;145;0.01;0.0;0.0
7375_2.txt;7;0;0;7;168;0.04;0.0;0.0
7374_1.txt;5;0;0;5;167;0.03;0.0;0.0
5987_1.txt;3;5;0;8;145;0.02;0.03;0.0
9552_1.txt;2;1;0;3;123;0.02;0.01;0.0
9671_4.txt;1;0;0;1;278;0.0;0.0;0.0
6728_3.txt;5;0;0;5;63;0.08;0.0;0.0
1243_1.txt;0;0;0;0;74;0.0;0.0;0.0
12090_3.txt;0;1;0;1;256;0.0;0.0;0.0
5709_1.txt;49;5;8;62;925;0.05;0.01;0.01
519_1.txt;0;0;0;0;180;0.0;0.0;0.0
329_1.txt;4;0;0;4;116;0.03;0.0;0.0
11497_3.txt;3;0;0;3;127;0.02;0.0;0.0
11493_2.txt;0;8;0;8;163;0.0;0.05;0.0
1429_1.txt;0;0;4;4;533;0.0;0.0;0.01
9090_1.txt;0;3;0;3;135;0.0;0.02;0.0
471_4.txt;2;0;0;2;79;0.03;0.0;0.0
11871_4.txt;4;0;0;4;92;0.04;0.0;0.0
7084_1.txt;3;0;0;3;186;0.02;0.0;0.0
5540_2.txt;12;1;1;14;286;0.04;0.0;0.0
7447_2.txt;2;1;1;4;164;0.01;0.01;0.01
3450_3.txt;13;2;0;15;424;0.03;0.0;0.0
2605_1.txt;11;5;0;16;185;0.06;0.03;0.0
9392_4.txt;8;0;2;10;186;0.04;0.0;0.01
11822_4.txt;12;1;0;13;143;0.08;0.01;0.0
2713_2.txt;0;1;3;4;194;0.0;0.01;0.02
2070_4.txt;15;1;0;16;323;0.05;0.0;0.0
7373_4.txt;9;0;2;11;280;0.03;0.0;0.01
7616_1.txt;19;1;5;25;669;0.03;0.0;0.01
2259_2.txt;3;3;0;6;157;0.02;0.02;0.0
11388_1.txt;5;0;0;5;343;0.01;0.0;0.0
4781_1.txt;5;0;1;6;220;0.02;0.0;0.0
3208_4.txt;1;0;0;1;148;0.01;0.0;0.0
10948_1.txt;0;2;1;3;153;0.0;0.01;0.01
9092_3.txt;11;0;0;11;327;0.03;0.0;0.0
4214_1.txt;0;0;0;0;149;0.0;0.0;0.0
10180_1.txt;0;2;5;7;136;0.0;0.01;0.04
3298_1.txt;25;4;1;30;443;0.06;0.01;0.0
5827_2.txt;0;2;2;4;217;0.0;0.01;0.01
680_1.txt;5;0;0;5;105;0.05;0.0;0.0
8474_2.txt;2;0;0;2;171;0.01;0.0;0.0
7020_1.txt;11;0;0;11;304;0.04;0.0;0.0
4415_4.txt;2;0;0;2;205;0.01;0.0;0.0
4971_1.txt;9;1;5;15;262;0.03;0.0;0.02
1278_2.txt;0;0;0;0;77;0.0;0.0;0.0
4553_2.txt;0;0;0;0;165;0.0;0.0;0.0
3546_4.txt;2;0;0;2;168;0.01;0.0;0.0
8904_4.txt;26;0;0;26;329;0.08;0.0;0.0
6156_2.txt;0;0;0;0;68;0.0;0.0;0.0
4_4.txt;10;0;0;10;81;0.12;0.0;0.0
6775_3.txt;16;2;0;18;338;0.05;0.01;0.0
4758_4.txt;14;0;0;14;540;0.03;0.0;0.0
7633_3.txt;12;0;3;15;579;0.02;0.0;0.01
8723_2.txt;0;0;0;0;94;0.0;0.0;0.0
11042_2.txt;0;1;0;1;159;0.0;0.01;0.0
10532_4.txt;7;5;0;12;432;0.02;0.01;0.0
9484_3.txt;6;3;0;9;361;0.02;0.01;0.0
2298_1.txt;14;4;7;25;293;0.05;0.01;0.02
3911_4.txt;1;0;0;1;35;0.03;0.0;0.0
11398_4.txt;6;1;0;7;276;0.02;0.0;0.0
8742_3.txt;10;0;0;10;340;0.03;0.0;0.0
9174_4.txt;4;0;0;4;114;0.04;0.0;0.0
1306_3.txt;6;0;1;7;347;0.02;0.0;0.0
11539_1.txt;2;0;0;2;139;0.01;0.0;0.0
10702_1.txt;16;0;0;16;417;0.04;0.0;0.0
9708_4.txt;0;0;8;8;244;0.0;0.0;0.03
5450_1.txt;0;2;0;2;244;0.0;0.01;0.0
9591_3.txt;10;8;1;19;825;0.01;0.01;0.0
11995_4.txt;14;0;2;16;271;0.05;0.0;0.01
11416_4.txt;14;1;0;15;278;0.05;0.0;0.0
12294_2.txt;0;0;0;0;174;0.0;0.0;0.0
10590_4.txt;2;0;0;2;63;0.03;0.0;0.0
5138_1.txt;1;0;0;1;591;0.0;0.0;0.0
10589_1.txt;2;1;0;3;201;0.01;0.0;0.0
2787_2.txt;8;2;2;12;388;0.02;0.01;0.01
5384_2.txt;0;0;0;0;147;0.0;0.0;0.0
4324_1.txt;13;4;3;20;232;0.06;0.02;0.01
2960_1.txt;0;0;3;3;272;0.0;0.0;0.01
11621_4.txt;1;0;0;1;395;0.0;0.0;0.0
5230_1.txt;5;0;1;6;161;0.03;0.0;0.01
1456_1.txt;6;0;1;7;248;0.02;0.0;0.0
11587_2.txt;3;0;0;3;93;0.03;0.0;0.0
11000_1.txt;3;0;0;3;82;0.04;0.0;0.0
3005_2.txt;7;0;0;7;369;0.02;0.0;0.0
10210_3.txt;16;0;1;17;201;0.08;0.0;0.0
10607_2.txt;22;0;0;22;442;0.05;0.0;0.0
9289_3.txt;0;0;0;0;221;0.0;0.0;0.0
9419_3.txt;6;3;0;9;233;0.03;0.01;0.0
659_1.txt;0;1;1;2;300;0.0;0.0;0.0
1434_3.txt;17;3;0;20;464;0.04;0.01;0.0
6433_3.txt;28;6;8;42;489;0.06;0.01;0.02
732_1.txt;3;0;0;3;204;0.01;0.0;0.0
9349_2.txt;1;0;0;1;239;0.0;0.0;0.0
5501_1.txt;2;0;1;3;139;0.01;0.0;0.01
4158_1.txt;0;0;0;0;249;0.0;0.0;0.0
888_4.txt;0;6;0;6;226;0.0;0.03;0.0
4867_3.txt;7;1;2;10;241;0.03;0.0;0.01
12434_4.txt;4;0;0;4;176;0.02;0.0;0.0
10266_1.txt;2;0;0;2;223;0.01;0.0;0.0
4089_1.txt;1;0;0;1;170;0.01;0.0;0.0
8041_1.txt;0;0;0;0;81;0.0;0.0;0.0
4255_4.txt;0;0;0;0;729;0.0;0.0;0.0
11610_1.txt;13;1;0;14;149;0.09;0.01;0.0
5815_3.txt;3;0;0;3;90;0.03;0.0;0.0
7501_2.txt;6;0;0;6;114;0.05;0.0;0.0
4757_4.txt;16;0;0;16;327;0.05;0.0;0.0
4394_1.txt;4;0;0;4;130;0.03;0.0;0.0
8936_1.txt;61;6;7;74;1237;0.05;0.0;0.01
9525_1.txt;9;1;1;11;386;0.02;0.0;0.0
10409_2.txt;0;0;0;0;180;0.0;0.0;0.0
4973_1.txt;4;0;0;4;111;0.04;0.0;0.0
9736_3.txt;9;0;0;9;416;0.02;0.0;0.0
5262_4.txt;0;0;0;0;229;0.0;0.0;0.0
3662_4.txt;18;2;0;20;739;0.02;0.0;0.0
7583_2.txt;2;0;0;2;151;0.01;0.0;0.0
1317_2.txt;5;1;3;9;296;0.02;0.0;0.01
10450_1.txt;0;0;0;0;145;0.0;0.0;0.0
11422_1.txt;0;1;1;2;168;0.0;0.01;0.01
12384_1.txt;0;0;0;0;33;0.0;0.0;0.0
9778_2.txt;0;0;6;6;244;0.0;0.0;0.02
2149_4.txt;8;0;2;10;254;0.03;0.0;0.01
4833_3.txt;0;3;0;3;153;0.0;0.02;0.0
388_1.txt;1;0;2;3;181;0.01;0.0;0.01
6533_2.txt;0;0;0;0;84;0.0;0.0;0.0
9927_1.txt;5;0;0;5;133;0.04;0.0;0.0
9722_2.txt;0;1;0;1;118;0.0;0.01;0.0
4312_4.txt;0;0;0;0;127;0.0;0.0;0.0
6895_2.txt;0;0;2;2;230;0.0;0.0;0.01
8136_1.txt;0;0;0;0;54;0.0;0.0;0.0
6127_3.txt;3;1;0;4;131;0.02;0.01;0.0
4640_3.txt;8;0;3;11;377;0.02;0.0;0.01
12285_4.txt;0;3;0;3;92;0.0;0.03;0.0
8638_1.txt;3;0;3;6;152;0.02;0.0;0.02
12463_4.txt;0;0;0;0;246;0.0;0.0;0.0
1664_4.txt;7;0;0;7;94;0.07;0.0;0.0
6528_4.txt;16;5;2;23;498;0.03;0.01;0.0
4254_2.txt;3;0;0;3;134;0.02;0.0;0.0
5621_4.txt;3;0;0;3;281;0.01;0.0;0.0
24_1.txt;4;0;0;4;281;0.01;0.0;0.0
11059_4.txt;13;0;0;13;162;0.08;0.0;0.0
10821_1.txt;12;2;0;14;132;0.09;0.02;0.0
9271_1.txt;0;0;0;0;204;0.0;0.0;0.0
12215_1.txt;6;1;0;7;139;0.04;0.01;0.0
8374_1.txt;0;0;0;0;127;0.0;0.0;0.0
4557_2.txt;0;2;0;2;376;0.0;0.01;0.0
7808_1.txt;3;0;0;3;242;0.01;0.0;0.0
9580_3.txt;5;0;0;5;131;0.04;0.0;0.0
11182_3.txt;6;1;0;7;225;0.03;0.0;0.0
7741_1.txt;7;7;1;15;605;0.01;0.01;0.0
9221_3.txt;5;2;0;7;200;0.03;0.01;0.0
8948_2.txt;0;0;0;0;156;0.0;0.0;0.0
6773_3.txt;50;5;6;61;972;0.05;0.01;0.01
2798_1.txt;2;0;1;3;271;0.01;0.0;0.0
6664_4.txt;16;5;0;21;388;0.04;0.01;0.0
32_3.txt;7;1;2;10;574;0.01;0.0;0.0
4993_2.txt;0;0;0;0;194;0.0;0.0;0.0
643_1.txt;1;0;0;1;148;0.01;0.0;0.0
59_3.txt;2;0;1;3;83;0.02;0.0;0.01
5783_4.txt;0;1;0;1;283;0.0;0.0;0.0
6834_2.txt;6;0;0;6;277;0.02;0.0;0.0
2718_2.txt;0;0;0;0;94;0.0;0.0;0.0
10442_2.txt;2;0;0;2;138;0.01;0.0;0.0
3429_4.txt;0;0;0;0;153;0.0;0.0;0.0
1929_4.txt;52;9;5;66;1704;0.03;0.01;0.0
848_3.txt;5;0;2;7;232;0.02;0.0;0.01
6093_1.txt;5;0;1;6;384;0.01;0.0;0.0
9944_1.txt;0;0;0;0;49;0.0;0.0;0.0
9830_2.txt;3;0;1;4;192;0.02;0.0;0.01
96_1.txt;2;0;0;2;180;0.01;0.0;0.0
11366_1.txt;3;1;0;4;236;0.01;0.0;0.0
9478_1.txt;0;0;2;2;224;0.0;0.0;0.01
508_3.txt;22;0;0;22;151;0.15;0.0;0.0
1256_3.txt;38;1;4;43;773;0.05;0.0;0.01
7220_2.txt;0;0;0;0;241;0.0;0.0;0.0
4836_4.txt;0;0;1;1;292;0.0;0.0;0.0
1739_4.txt;30;3;3;36;303;0.1;0.01;0.01
1217_3.txt;14;2;0;16;501;0.03;0.0;0.0
737_1.txt;0;0;1;1;195;0.0;0.0;0.01
10328_4.txt;0;0;1;1;140;0.0;0.0;0.01
4521_1.txt;2;0;0;2;129;0.02;0.0;0.0
5527_2.txt;2;1;0;3;284;0.01;0.0;0.0
481_3.txt;0;1;0;1;217;0.0;0.0;0.0
6290_3.txt;14;0;0;14;265;0.05;0.0;0.0
9112_1.txt;0;0;0;0;152;0.0;0.0;0.0
8275_1.txt;3;2;1;6;299;0.01;0.01;0.0
5214_2.txt;2;2;0;4;246;0.01;0.01;0.0
8590_4.txt;7;0;0;7;234;0.03;0.0;0.0
303_2.txt;0;0;0;0;202;0.0;0.0;0.0
2368_3.txt;1;0;0;1;268;0.0;0.0;0.0
7712_2.txt;0;0;0;0;261;0.0;0.0;0.0
10550_4.txt;14;3;2;19;337;0.04;0.01;0.01
9076_1.txt;9;2;2;13;199;0.05;0.01;0.01
9873_1.txt;2;0;0;2;136;0.01;0.0;0.0
6738_1.txt;0;0;0;0;327;0.0;0.0;0.0
2836_1.txt;11;0;0;11;251;0.04;0.0;0.0
11470_3.txt;26;5;0;31;906;0.03;0.01;0.0
11710_4.txt;16;0;0;16;244;0.07;0.0;0.0
1381_2.txt;31;5;0;36;694;0.04;0.01;0.0
3631_3.txt;5;1;0;6;139;0.04;0.01;0.0
10441_1.txt;2;1;1;4;188;0.01;0.01;0.01
2978_1.txt;3;0;0;3;287;0.01;0.0;0.0
9328_1.txt;13;1;2;16;482;0.03;0.0;0.0
1498_2.txt;12;4;0;16;830;0.01;0.0;0.0
9725_2.txt;0;0;0;0;52;0.0;0.0;0.0
8344_4.txt;22;2;2;26;398;0.06;0.01;0.01
9183_1.txt;12;0;0;12;745;0.02;0.0;0.0
7140_1.txt;0;0;0;0;120;0.0;0.0;0.0
3696_4.txt;4;0;0;4;193;0.02;0.0;0.0
3989_1.txt;3;1;0;4;252;0.01;0.0;0.0
6223_1.txt;39;3;1;43;858;0.05;0.0;0.0
5210_2.txt;0;0;0;0;188;0.0;0.0;0.0
4154_1.txt;4;0;7;11;315;0.01;0.0;0.02
3905_1.txt;9;1;0;10;121;0.07;0.01;0.0
12458_2.txt;4;2;1;7;294;0.01;0.01;0.0
3703_3.txt;2;0;0;2;134;0.01;0.0;0.0
4000_4.txt;7;0;0;7;339;0.02;0.0;0.0
3927_4.txt;3;1;0;4;122;0.02;0.01;0.0
7574_4.txt;5;1;0;6;237;0.02;0.0;0.0
11219_3.txt;7;0;0;7;182;0.04;0.0;0.0
1587_2.txt;8;0;0;8;240;0.03;0.0;0.0
10720_2.txt;5;0;0;5;172;0.03;0.0;0.0
383_4.txt;2;0;0;2;171;0.01;0.0;0.0
4856_2.txt;0;2;12;14;265;0.0;0.01;0.05
11943_1.txt;2;0;0;2;68;0.03;0.0;0.0
9972_1.txt;0;0;0;0;94;0.0;0.0;0.0
7550_1.txt;7;1;0;8;238;0.03;0.0;0.0
5201_1.txt;2;0;0;2;242;0.01;0.0;0.0
10430_3.txt;3;1;1;5;547;0.01;0.0;0.0
3371_4.txt;3;0;0;3;127;0.02;0.0;0.0
10979_1.txt;11;0;0;11;295;0.04;0.0;0.0
2645_3.txt;5;0;0;5;62;0.08;0.0;0.0
2507_2.txt;3;0;2;5;317;0.01;0.0;0.01
6098_1.txt;3;0;2;5;215;0.01;0.0;0.01
11583_3.txt;3;0;0;3;171;0.02;0.0;0.0
8048_4.txt;0;0;0;0;155;0.0;0.0;0.0
2717_1.txt;1;0;0;1;107;0.01;0.0;0.0
9987_1.txt;2;0;0;2;56;0.04;0.0;0.0
1175_2.txt;6;0;0;6;243;0.02;0.0;0.0
332_1.txt;4;0;1;5;235;0.02;0.0;0.0
2034_1.txt;0;0;0;0;141;0.0;0.0;0.0
3824_1.txt;12;0;2;14;281;0.04;0.0;0.01
1258_3.txt;58;3;4;65;1175;0.05;0.0;0.0
1124_1.txt;2;0;2;4;215;0.01;0.0;0.01
9602_3.txt;1;0;0;1;143;0.01;0.0;0.0
11676_2.txt;3;3;0;6;440;0.01;0.01;0.0
4703_1.txt;3;0;0;3;158;0.02;0.0;0.0
2002_1.txt;0;0;0;0;143;0.0;0.0;0.0
1019_1.txt;13;1;0;14;293;0.04;0.0;0.0
11453_3.txt;10;0;0;10;190;0.05;0.0;0.0
3358_1.txt;2;0;1;3;173;0.01;0.0;0.01
5362_1.txt;0;0;0;0;127;0.0;0.0;0.0
7119_3.txt;6;0;0;6;188;0.03;0.0;0.0
6014_1.txt;0;0;0;0;161;0.0;0.0;0.0
5044_1.txt;0;0;3;3;198;0.0;0.0;0.02
697_2.txt;6;0;0;6;187;0.03;0.0;0.0
2698_1.txt;8;0;0;8;145;0.06;0.0;0.0
8033_1.txt;20;3;0;23;343;0.06;0.01;0.0
9438_3.txt;0;1;0;1;342;0.0;0.0;0.0
3877_4.txt;0;0;0;0;226;0.0;0.0;0.0
2408_2.txt;0;0;0;0;137;0.0;0.0;0.0
7706_4.txt;5;0;0;5;598;0.01;0.0;0.0
3721_1.txt;4;0;0;4;197;0.02;0.0;0.0
8923_3.txt;10;3;0;13;233;0.04;0.01;0.0
12456_3.txt;14;0;8;22;499;0.03;0.0;0.02
8453_1.txt;4;0;0;4;248;0.02;0.0;0.0
2946_1.txt;9;2;0;11;283;0.03;0.01;0.0
11062_2.txt;2;0;0;2;163;0.01;0.0;0.0
10626_1.txt;3;0;0;3;129;0.02;0.0;0.0
12068_1.txt;2;0;0;2;153;0.01;0.0;0.0
3346_2.txt;6;0;0;6;300;0.02;0.0;0.0
11803_3.txt;32;2;0;34;254;0.13;0.01;0.0
10775_3.txt;4;0;0;4;72;0.06;0.0;0.0
4644_1.txt;0;0;0;0;199;0.0;0.0;0.0
4346_3.txt;12;1;0;13;406;0.03;0.0;0.0
2031_1.txt;6;2;0;8;140;0.04;0.01;0.0
5377_3.txt;23;3;2;28;828;0.03;0.0;0.0
10642_2.txt;5;2;2;9;173;0.03;0.01;0.01
1150_4.txt;0;2;0;2;798;0.0;0.0;0.0
389_3.txt;10;0;0;10;146;0.07;0.0;0.0
4934_4.txt;33;0;0;33;583;0.06;0.0;0.0
7392_1.txt;16;0;7;23;384;0.04;0.0;0.02
2492_3.txt;6;0;0;6;182;0.03;0.0;0.0
7983_3.txt;5;0;0;5;309;0.02;0.0;0.0
2140_2.txt;23;2;0;25;460;0.05;0.0;0.0
3892_2.txt;6;1;1;8;297;0.02;0.0;0.0
6906_1.txt;0;2;1;3;275;0.0;0.01;0.0
4885_1.txt;3;0;2;5;215;0.01;0.0;0.01
1430_1.txt;4;0;0;4;222;0.02;0.0;0.0
1248_1.txt;6;0;0;6;426;0.01;0.0;0.0
6296_1.txt;0;0;0;0;111;0.0;0.0;0.0
4273_1.txt;4;0;0;4;264;0.02;0.0;0.0
9983_3.txt;0;0;0;0;92;0.0;0.0;0.0
10907_1.txt;0;0;0;0;214;0.0;0.0;0.0
9462_1.txt;10;0;1;11;310;0.03;0.0;0.0
2265_1.txt;2;0;0;2;71;0.03;0.0;0.0
7894_1.txt;0;0;0;0;144;0.0;0.0;0.0
6286_3.txt;10;1;0;11;500;0.02;0.0;0.0
6681_1.txt;0;0;0;0;68;0.0;0.0;0.0
3230_4.txt;0;0;2;2;206;0.0;0.0;0.01
5919_1.txt;4;0;0;4;160;0.03;0.0;0.0
11056_4.txt;0;0;0;0;191;0.0;0.0;0.0
7751_4.txt;2;0;2;4;173;0.01;0.0;0.01
10412_1.txt;4;0;0;4;60;0.07;0.0;0.0
309_1.txt;16;1;0;17;163;0.1;0.01;0.0
9130_4.txt;20;0;1;21;404;0.05;0.0;0.0
6995_4.txt;1;0;3;4;341;0.0;0.0;0.01
7098_4.txt;23;1;1;25;165;0.14;0.01;0.01
5284_4.txt;35;0;0;35;522;0.07;0.0;0.0
10969_4.txt;5;0;0;5;196;0.03;0.0;0.0
3278_1.txt;8;1;2;11;249;0.03;0.0;0.01
7626_3.txt;0;3;0;3;149;0.0;0.02;0.0
2695_3.txt;24;0;1;25;725;0.03;0.0;0.0
908_1.txt;0;0;0;0;108;0.0;0.0;0.0
10392_3.txt;2;1;3;6;479;0.0;0.0;0.01
4453_3.txt;5;2;7;14;232;0.02;0.01;0.03
1666_2.txt;4;0;2;6;184;0.02;0.0;0.01
8189_4.txt;23;6;0;29;500;0.05;0.01;0.0
677_1.txt;7;1;0;8;194;0.04;0.01;0.0
11441_4.txt;0;0;0;0;233;0.0;0.0;0.0
10792_1.txt;0;0;0;0;192;0.0;0.0;0.0
10910_2.txt;24;1;0;25;484;0.05;0.0;0.0
7075_3.txt;0;0;0;0;163;0.0;0.0;0.0
6326_4.txt;0;0;0;0;54;0.0;0.0;0.0
4407_4.txt;31;14;2;47;872;0.04;0.02;0.0
841_1.txt;4;3;1;8;295;0.01;0.01;0.0
11876_1.txt;1;0;1;2;279;0.0;0.0;0.0
2602_3.txt;5;0;0;5;147;0.03;0.0;0.0
8128_1.txt;0;0;0;0;98;0.0;0.0;0.0
2962_1.txt;8;1;0;9;275;0.03;0.0;0.0
3863_1.txt;2;0;0;2;425;0.0;0.0;0.0
4360_1.txt;0;0;0;0;122;0.0;0.0;0.0
2406_2.txt;11;3;3;17;161;0.07;0.02;0.02
8307_1.txt;2;0;0;2;214;0.01;0.0;0.0
3209_1.txt;0;1;0;1;115;0.0;0.01;0.0
1837_2.txt;30;0;0;30;453;0.07;0.0;0.0
5693_1.txt;1;0;1;2;181;0.01;0.0;0.01
7090_1.txt;2;0;0;2;239;0.01;0.0;0.0
3009_3.txt;5;0;0;5;262;0.02;0.0;0.0
981_2.txt;14;1;0;15;245;0.06;0.0;0.0
1546_3.txt;2;2;0;4;91;0.02;0.02;0.0
2082_1.txt;5;0;0;5;258;0.02;0.0;0.0
3170_3.txt;56;3;0;59;608;0.09;0.0;0.0
1476_4.txt;2;0;0;2;78;0.03;0.0;0.0
5905_1.txt;0;0;0;0;162;0.0;0.0;0.0
5162_1.txt;8;3;2;13;303;0.03;0.01;0.01
7696_2.txt;3;0;0;3;293;0.01;0.0;0.0
3348_2.txt;16;0;1;17;672;0.02;0.0;0.0
5954_1.txt;1;0;3;4;258;0.0;0.0;0.01
5390_1.txt;9;0;0;9;244;0.04;0.0;0.0
592_3.txt;6;1;0;7;166;0.04;0.01;0.0
12055_1.txt;2;0;0;2;167;0.01;0.0;0.0
1782_4.txt;7;0;0;7;251;0.03;0.0;0.0
4715_3.txt;4;0;2;6;311;0.01;0.0;0.01
6787_1.txt;15;1;1;17;412;0.04;0.0;0.0
1511_1.txt;17;0;0;17;998;0.02;0.0;0.0
2690_2.txt;0;0;0;0;149;0.0;0.0;0.0
4693_3.txt;7;2;0;9;261;0.03;0.01;0.0
9533_3.txt;23;9;0;32;681;0.03;0.01;0.0
9530_4.txt;2;0;0;2;153;0.01;0.0;0.0
12154_1.txt;0;0;0;0;159;0.0;0.0;0.0
6914_3.txt;7;0;1;8;165;0.04;0.0;0.01
3891_3.txt;17;1;1;19;735;0.02;0.0;0.0
4913_1.txt;1;0;0;1;51;0.02;0.0;0.0
9919_3.txt;3;2;1;6;239;0.01;0.01;0.0
2481_1.txt;4;0;1;5;363;0.01;0.0;0.0
12435_3.txt;18;1;0;19;214;0.08;0.0;0.0
11373_2.txt;2;1;5;8;408;0.0;0.0;0.01
5106_4.txt;8;1;0;9;227;0.04;0.0;0.0
4284_3.txt;4;0;0;4;229;0.02;0.0;0.0
2599_4.txt;1;0;0;1;187;0.01;0.0;0.0
9123_1.txt;3;0;0;3;122;0.02;0.0;0.0
9205_1.txt;0;0;0;0;66;0.0;0.0;0.0
9126_3.txt;2;0;1;3;54;0.04;0.0;0.02
1215_1.txt;16;1;1;18;674;0.02;0.0;0.0
9522_1.txt;0;0;0;0;258;0.0;0.0;0.0
7526_3.txt;15;0;0;15;235;0.06;0.0;0.0
3389_1.txt;10;1;0;11;283;0.04;0.0;0.0
8174_4.txt;2;1;0;3;502;0.0;0.0;0.0
4538_2.txt;2;0;0;2;144;0.01;0.0;0.0
10576_4.txt;2;0;0;2;194;0.01;0.0;0.0
8392_3.txt;15;0;4;19;547;0.03;0.0;0.01
10936_3.txt;2;0;0;2;217;0.01;0.0;0.0
3154_2.txt;3;0;0;3;165;0.02;0.0;0.0
1479_1.txt;0;0;0;0;150;0.0;0.0;0.0
7255_2.txt;2;0;0;2;106;0.02;0.0;0.0
6057_1.txt;3;2;0;5;115;0.03;0.02;0.0
678_1.txt;0;0;0;0;83;0.0;0.0;0.0
8337_3.txt;7;0;0;7;297;0.02;0.0;0.0
975_4.txt;4;0;0;4;146;0.03;0.0;0.0
9868_1.txt;0;0;0;0;276;0.0;0.0;0.0
9593_2.txt;0;0;0;0;210;0.0;0.0;0.0
10435_2.txt;4;0;0;4;176;0.02;0.0;0.0
9241_3.txt;6;23;2;31;779;0.01;0.03;0.0
10420_2.txt;0;0;0;0;510;0.0;0.0;0.0
6193_1.txt;1;0;0;1;353;0.0;0.0;0.0
777_2.txt;0;1;0;1;174;0.0;0.01;0.0
7707_4.txt;3;0;0;3;349;0.01;0.0;0.0
247_3.txt;0;4;0;4;310;0.0;0.01;0.0
3683_1.txt;10;8;1;19;865;0.01;0.01;0.0
4827_1.txt;1;0;0;1;177;0.01;0.0;0.0
2813_1.txt;11;0;2;13;201;0.05;0.0;0.01
5092_2.txt;8;2;0;10;265;0.03;0.01;0.0
2539_1.txt;3;0;0;3;74;0.04;0.0;0.0
11316_1.txt;2;0;0;2;191;0.01;0.0;0.0
10540_4.txt;18;0;1;19;223;0.08;0.0;0.0
5715_2.txt;3;2;0;5;334;0.01;0.01;0.0
8323_3.txt;10;0;0;10;384;0.03;0.0;0.0
9988_2.txt;5;0;0;5;97;0.05;0.0;0.0
5757_1.txt;5;1;0;6;152;0.03;0.01;0.0
6753_4.txt;31;1;3;35;715;0.04;0.0;0.0
12457_4.txt;2;0;0;2;134;0.01;0.0;0.0
6171_4.txt;0;0;0;0;164;0.0;0.0;0.0
797_1.txt;0;0;0;0;136;0.0;0.0;0.0
11867_1.txt;0;4;0;4;231;0.0;0.02;0.0
8815_2.txt;0;0;0;0;405;0.0;0.0;0.0
533_2.txt;2;0;2;4;636;0.0;0.0;0.0
8650_2.txt;2;0;0;2;145;0.01;0.0;0.0
2207_3.txt;3;0;0;3;325;0.01;0.0;0.0
2278_4.txt;28;5;4;37;706;0.04;0.01;0.01
10794_1.txt;2;0;0;2;54;0.04;0.0;0.0
5495_3.txt;4;0;0;4;40;0.1;0.0;0.0
8888_4.txt;3;0;0;3;179;0.02;0.0;0.0
1994_2.txt;2;0;0;2;78;0.03;0.0;0.0
8914_1.txt;5;0;0;5;189;0.03;0.0;0.0
1890_2.txt;0;0;0;0;144;0.0;0.0;0.0
10160_4.txt;18;2;2;22;214;0.08;0.01;0.01
6886_1.txt;10;0;0;10;133;0.08;0.0;0.0
4321_1.txt;0;1;2;3;135;0.0;0.01;0.01
9133_2.txt;9;0;0;9;267;0.03;0.0;0.0
3664_4.txt;17;1;1;19;460;0.04;0.0;0.0
10499_1.txt;6;0;0;6;278;0.02;0.0;0.0
7538_2.txt;2;0;0;2;148;0.01;0.0;0.0
730_1.txt;0;0;0;0;137;0.0;0.0;0.0
11517_1.txt;0;0;0;0;111;0.0;0.0;0.0
11360_2.txt;0;1;0;1;344;0.0;0.0;0.0
1444_4.txt;3;1;0;4;127;0.02;0.01;0.0
378_4.txt;0;0;0;0;163;0.0;0.0;0.0
1537_1.txt;0;0;0;0;202;0.0;0.0;0.0
905_1.txt;16;0;0;16;217;0.07;0.0;0.0
10448_1.txt;12;3;1;16;1149;0.01;0.0;0.0
10951_1.txt;0;1;3;4;189;0.0;0.01;0.02
6945_3.txt;11;0;0;11;195;0.06;0.0;0.0
2113_3.txt;15;0;0;15;232;0.06;0.0;0.0
2630_3.txt;6;0;4;10;138;0.04;0.0;0.03
427_4.txt;10;0;0;10;95;0.11;0.0;0.0
11138_2.txt;7;1;3;11;610;0.01;0.0;0.0
10458_2.txt;0;0;0;0;300;0.0;0.0;0.0
12426_1.txt;0;0;0;0;72;0.0;0.0;0.0
7434_2.txt;2;0;0;2;68;0.03;0.0;0.0
6726_3.txt;10;0;0;10;234;0.04;0.0;0.0
12274_3.txt;6;0;0;6;184;0.03;0.0;0.0
543_2.txt;0;0;0;0;177;0.0;0.0;0.0
2544_1.txt;15;5;0;20;340;0.04;0.01;0.0
4675_4.txt;22;4;0;26;405;0.05;0.01;0.0
7246_4.txt;2;2;0;4;58;0.03;0.03;0.0
5591_2.txt;49;1;0;50;685;0.07;0.0;0.0
11781_1.txt;18;0;0;18;409;0.04;0.0;0.0
7209_2.txt;1;1;0;2;212;0.0;0.0;0.0
7142_1.txt;0;0;2;2;139;0.0;0.0;0.01
3642_1.txt;2;0;0;2;259;0.01;0.0;0.0
3266_1.txt;39;3;3;45;467;0.08;0.01;0.01
3164_3.txt;4;0;0;4;134;0.03;0.0;0.0
6138_1.txt;2;4;0;6;310;0.01;0.01;0.0
10988_2.txt;41;2;2;45;591;0.07;0.0;0.0
9316_3.txt;0;3;0;3;561;0.0;0.01;0.0
9275_1.txt;0;0;0;0;231;0.0;0.0;0.0
3270_1.txt;0;0;0;0;164;0.0;0.0;0.0
3812_1.txt;5;0;4;9;292;0.02;0.0;0.01
8694_2.txt;2;0;0;2;131;0.02;0.0;0.0
3573_4.txt;6;3;0;9;408;0.01;0.01;0.0
6493_2.txt;2;0;0;2;260;0.01;0.0;0.0
10291_4.txt;0;0;0;0;227;0.0;0.0;0.0
4074_2.txt;0;0;0;0;157;0.0;0.0;0.0
1776_1.txt;5;0;1;6;228;0.02;0.0;0.0
3384_2.txt;2;1;0;3;164;0.01;0.01;0.0
9784_3.txt;0;0;0;0;171;0.0;0.0;0.0
10571_1.txt;3;0;0;3;147;0.02;0.0;0.0
6589_4.txt;0;0;0;0;326;0.0;0.0;0.0
5916_2.txt;4;2;0;6;211;0.02;0.01;0.0
9724_1.txt;5;0;0;5;125;0.04;0.0;0.0
8744_2.txt;2;1;0;3;182;0.01;0.01;0.0
11142_1.txt;0;0;0;0;132;0.0;0.0;0.0
4342_1.txt;3;0;0;3;170;0.02;0.0;0.0
9773_1.txt;12;0;2;14;368;0.03;0.0;0.01
2889_1.txt;0;0;0;0;142;0.0;0.0;0.0
2970_4.txt;3;0;0;3;142;0.02;0.0;0.0
8613_3.txt;18;0;0;18;330;0.05;0.0;0.0
11915_4.txt;10;0;0;10;144;0.07;0.0;0.0
11954_1.txt;0;0;0;0;153;0.0;0.0;0.0
7387_1.txt;3;2;0;5;171;0.02;0.01;0.0
6234_1.txt;3;1;0;4;192;0.02;0.01;0.0
344_2.txt;10;0;0;10;301;0.03;0.0;0.0
6896_1.txt;0;2;0;2;193;0.0;0.01;0.0
10883_1.txt;0;0;0;0;102;0.0;0.0;0.0
12137_1.txt;0;0;0;0;64;0.0;0.0;0.0
4318_3.txt;5;0;0;5;204;0.02;0.0;0.0
6137_1.txt;10;1;0;11;246;0.04;0.0;0.0
4215_4.txt;21;2;1;24;822;0.03;0.0;0.0
2431_1.txt;4;4;3;11;130;0.03;0.03;0.02
1550_1.txt;0;0;1;1;46;0.0;0.0;0.02
3780_2.txt;6;8;4;18;994;0.01;0.01;0.0
5576_3.txt;5;4;0;9;289;0.02;0.01;0.0
9009_1.txt;2;0;0;2;342;0.01;0.0;0.0
8688_1.txt;2;0;0;2;155;0.01;0.0;0.0
293_2.txt;2;1;0;3;350;0.01;0.0;0.0
9431_2.txt;0;0;1;1;169;0.0;0.0;0.01
2657_1.txt;6;1;0;7;248;0.02;0.0;0.0
8452_3.txt;2;0;6;8;326;0.01;0.0;0.02
8014_2.txt;0;0;0;0;227;0.0;0.0;0.0
1856_4.txt;4;0;0;4;140;0.03;0.0;0.0
4187_3.txt;3;2;0;5;197;0.02;0.01;0.0
8569_4.txt;0;0;0;0;261;0.0;0.0;0.0
2984_4.txt;1;0;0;1;281;0.0;0.0;0.0
9040_3.txt;1;3;0;4;177;0.01;0.02;0.0
7738_4.txt;0;0;1;1;85;0.0;0.0;0.01
3815_1.txt;3;2;0;5;129;0.02;0.02;0.0
6176_3.txt;4;0;0;4;209;0.02;0.0;0.0
1536_3.txt;5;0;0;5;539;0.01;0.0;0.0
143_2.txt;2;0;0;2;134;0.01;0.0;0.0
1773_3.txt;2;0;0;2;83;0.02;0.0;0.0
1924_4.txt;46;5;1;52;739;0.06;0.01;0.0
6640_1.txt;2;1;0;3;238;0.01;0.0;0.0
1617_4.txt;1;0;0;1;260;0.0;0.0;0.0
11839_4.txt;18;2;3;23;353;0.05;0.01;0.01
6539_1.txt;1;1;0;2;295;0.0;0.0;0.0
904_3.txt;12;2;0;14;233;0.05;0.01;0.0
2716_4.txt;27;3;6;36;517;0.05;0.01;0.01
8099_3.txt;5;0;0;5;115;0.04;0.0;0.0
9354_2.txt;2;1;0;3;178;0.01;0.01;0.0
1716_1.txt;4;0;0;4;356;0.01;0.0;0.0
3074_1.txt;0;0;0;0;100;0.0;0.0;0.0
10367_4.txt;0;0;0;0;128;0.0;0.0;0.0
8066_4.txt;8;1;2;11;105;0.08;0.01;0.02
10199_4.txt;0;0;0;0;57;0.0;0.0;0.0
12281_2.txt;0;0;0;0;122;0.0;0.0;0.0
9643_2.txt;8;1;0;9;152;0.05;0.01;0.0
9054_1.txt;14;0;2;16;217;0.06;0.0;0.01
5703_2.txt;1;1;1;3;299;0.0;0.0;0.0
2915_1.txt;2;1;0;3;136;0.01;0.01;0.0
782_4.txt;3;0;0;3;137;0.02;0.0;0.0
653_1.txt;0;0;0;0;180;0.0;0.0;0.0
4888_1.txt;6;0;0;6;179;0.03;0.0;0.0
11791_4.txt;0;0;0;0;139;0.0;0.0;0.0
9904_4.txt;3;0;3;6;139;0.02;0.0;0.02
1143_1.txt;0;0;0;0;124;0.0;0.0;0.0
5273_4.txt;0;0;0;0;161;0.0;0.0;0.0
6327_4.txt;0;8;1;9;299;0.0;0.03;0.0
7759_3.txt;32;2;0;34;436;0.07;0.0;0.0
8641_3.txt;39;1;0;40;577;0.07;0.0;0.0
12343_2.txt;11;0;0;11;195;0.06;0.0;0.0
4498_3.txt;9;2;0;11;621;0.01;0.0;0.0
11895_1.txt;8;2;2;12;219;0.04;0.01;0.01
7049_3.txt;16;0;0;16;281;0.06;0.0;0.0
7944_2.txt;6;0;0;6;51;0.12;0.0;0.0
4258_3.txt;11;1;0;12;371;0.03;0.0;0.0
2415_1.txt;1;1;0;2;342;0.0;0.0;0.0
2371_3.txt;10;0;0;10;157;0.06;0.0;0.0
10715_4.txt;5;0;0;5;189;0.03;0.0;0.0
7261_3.txt;25;1;0;26;424;0.06;0.0;0.0
11617_2.txt;1;0;0;1;217;0.0;0.0;0.0
8711_1.txt;7;0;0;7;307;0.02;0.0;0.0
2462_4.txt;2;0;0;2;136;0.01;0.0;0.0
11180_3.txt;3;1;0;4;142;0.02;0.01;0.0
1003_3.txt;4;0;6;10;381;0.01;0.0;0.02
3175_4.txt;14;5;0;19;385;0.04;0.01;0.0
4146_1.txt;2;0;2;4;200;0.01;0.0;0.01
10226_3.txt;16;0;0;16;200;0.08;0.0;0.0
10903_4.txt;11;0;0;11;266;0.04;0.0;0.0
290_2.txt;0;0;0;0;96;0.0;0.0;0.0
11191_3.txt;25;6;5;36;812;0.03;0.01;0.01
8357_3.txt;8;8;2;18;191;0.04;0.04;0.01
4584_1.txt;8;3;0;11;677;0.01;0.0;0.0
12088_2.txt;3;0;0;3;155;0.02;0.0;0.0
213_4.txt;0;0;0;0;150;0.0;0.0;0.0
10284_3.txt;0;1;0;1;273;0.0;0.0;0.0
3333_4.txt;14;2;2;18;168;0.08;0.01;0.01
2393_2.txt;49;3;2;54;857;0.06;0.0;0.0
7225_1.txt;0;0;0;0;167;0.0;0.0;0.0
7878_4.txt;3;0;0;3;127;0.02;0.0;0.0
5979_3.txt;0;0;0;0;170;0.0;0.0;0.0
9299_3.txt;0;1;0;1;242;0.0;0.0;0.0
2643_1.txt;3;3;2;8;410;0.01;0.01;0.0
2352_2.txt;4;0;0;4;185;0.02;0.0;0.0
8414_1.txt;2;1;1;4;87;0.02;0.01;0.01
11405_1.txt;0;0;0;0;164;0.0;0.0;0.0
8361_4.txt;47;3;2;52;594;0.08;0.01;0.0
12201_3.txt;16;3;2;21;432;0.04;0.01;0.0
11354_1.txt;0;1;0;1;158;0.0;0.01;0.0
6566_4.txt;12;1;0;13;176;0.07;0.01;0.0
5589_2.txt;8;1;0;9;290;0.03;0.0;0.0
4119_1.txt;0;0;0;0;104;0.0;0.0;0.0
710_4.txt;3;0;0;3;133;0.02;0.0;0.0
4374_4.txt;0;1;0;1;257;0.0;0.0;0.0
1824_1.txt;18;0;0;18;136;0.13;0.0;0.0
9701_1.txt;4;0;0;4;130;0.03;0.0;0.0
10005_3.txt;15;3;0;18;408;0.04;0.01;0.0
11593_4.txt;6;1;0;7;298;0.02;0.0;0.0
2929_2.txt;6;0;0;6;171;0.04;0.0;0.0
644_2.txt;5;3;0;8;260;0.02;0.01;0.0
5475_3.txt;13;6;5;24;753;0.02;0.01;0.01
673_1.txt;0;0;0;0;201;0.0;0.0;0.0
10247_2.txt;2;0;0;2;85;0.02;0.0;0.0
9650_1.txt;4;1;0;5;173;0.02;0.01;0.0
9193_3.txt;12;3;4;19;1455;0.01;0.0;0.0
995_3.txt;9;0;0;9;288;0.03;0.0;0.0
8121_3.txt;0;0;0;0;161;0.0;0.0;0.0
4452_4.txt;2;1;3;6;343;0.01;0.0;0.01
9233_4.txt;2;0;1;3;57;0.04;0.0;0.02
6709_1.txt;0;0;0;0;110;0.0;0.0;0.0
325_2.txt;5;0;0;5;235;0.02;0.0;0.0
271_1.txt;0;1;0;1;317;0.0;0.0;0.0
1332_3.txt;8;0;0;8;128;0.06;0.0;0.0
2591_2.txt;2;0;0;2;292;0.01;0.0;0.0
9974_3.txt;0;2;0;2;96;0.0;0.02;0.0
3464_1.txt;2;0;0;2;285;0.01;0.0;0.0
1465_3.txt;11;0;0;11;359;0.03;0.0;0.0
11028_4.txt;26;0;4;30;345;0.08;0.0;0.01
944_4.txt;0;0;0;0;204;0.0;0.0;0.0
7000_4.txt;24;1;4;29;366;0.07;0.0;0.01
12430_1.txt;5;5;2;12;447;0.01;0.01;0.0
6218_3.txt;0;0;1;1;724;0.0;0.0;0.0
7753_1.txt;2;0;0;2;186;0.01;0.0;0.0
9064_4.txt;13;3;9;25;262;0.05;0.01;0.03
6331_3.txt;8;0;0;8;249;0.03;0.0;0.0
2171_1.txt;11;0;0;11;142;0.08;0.0;0.0
12470_1.txt;20;3;7;30;702;0.03;0.0;0.01
5751_1.txt;1;0;0;1;122;0.01;0.0;0.0
11420_1.txt;2;2;2;6;168;0.01;0.01;0.01
6988_1.txt;0;0;2;2;137;0.0;0.0;0.01
11935_2.txt;36;10;5;51;1192;0.03;0.01;0.0
8129_3.txt;8;1;0;9;603;0.01;0.0;0.0
11055_1.txt;0;0;1;1;291;0.0;0.0;0.0
4153_1.txt;2;0;0;2;428;0.0;0.0;0.0
12364_1.txt;2;4;0;6;112;0.02;0.04;0.0
2455_2.txt;4;0;0;4;293;0.01;0.0;0.0
9924_2.txt;8;1;0;9;259;0.03;0.0;0.0
10877_1.txt;2;0;0;2;57;0.04;0.0;0.0
5895_4.txt;9;0;2;11;188;0.05;0.0;0.01
11021_1.txt;3;0;0;3;532;0.01;0.0;0.0
5903_1.txt;0;8;4;12;268;0.0;0.03;0.01
6651_1.txt;0;0;0;0;91;0.0;0.0;0.0
1848_3.txt;0;0;0;0;171;0.0;0.0;0.0
4735_3.txt;13;0;0;13;518;0.03;0.0;0.0
5236_2.txt;0;0;0;0;168;0.0;0.0;0.0
4391_4.txt;16;1;0;17;362;0.04;0.0;0.0
6647_2.txt;58;3;1;62;1156;0.05;0.0;0.0
6245_1.txt;3;0;0;3;225;0.01;0.0;0.0
7026_4.txt;5;0;0;5;175;0.03;0.0;0.0
10595_4.txt;3;0;0;3;65;0.05;0.0;0.0
9094_1.txt;11;0;0;11;272;0.04;0.0;0.0
5913_1.txt;0;0;0;0;62;0.0;0.0;0.0
2588_3.txt;52;2;5;59;390;0.13;0.01;0.01
635_1.txt;11;2;0;13;196;0.06;0.01;0.0
6117_1.txt;2;0;0;2;231;0.01;0.0;0.0
5087_1.txt;4;0;0;4;231;0.02;0.0;0.0
1900_4.txt;33;1;1;35;375;0.09;0.0;0.0
4824_2.txt;0;0;1;1;115;0.0;0.0;0.01
6960_1.txt;5;0;0;5;169;0.03;0.0;0.0
4647_1.txt;2;0;0;2;140;0.01;0.0;0.0
7259_4.txt;2;0;0;2;204;0.01;0.0;0.0
12029_4.txt;0;0;0;0;215;0.0;0.0;0.0
3235_1.txt;2;0;1;3;666;0.0;0.0;0.0
527_4.txt;19;0;0;19;141;0.13;0.0;0.0
12316_4.txt;13;0;0;13;147;0.09;0.0;0.0
6585_3.txt;24;11;1;36;509;0.05;0.02;0.0
5636_1.txt;8;1;0;9;214;0.04;0.0;0.0
10946_1.txt;5;0;4;9;377;0.01;0.0;0.01
53_3.txt;5;1;0;6;443;0.01;0.0;0.0
4217_2.txt;0;0;1;1;129;0.0;0.0;0.01
4090_3.txt;27;1;3;31;1096;0.02;0.0;0.0
11117_3.txt;4;1;0;5;101;0.04;0.01;0.0
4040_1.txt;2;2;0;4;198;0.01;0.01;0.0
10340_1.txt;0;0;0;0;174;0.0;0.0;0.0
9288_4.txt;6;0;1;7;209;0.03;0.0;0.0
5238_2.txt;2;0;0;2;169;0.01;0.0;0.0
1627_1.txt;10;2;0;12;570;0.02;0.0;0.0
2357_3.txt;7;0;0;7;426;0.02;0.0;0.0
2617_1.txt;0;0;1;1;178;0.0;0.0;0.01
6255_1.txt;0;1;0;1;57;0.0;0.02;0.0
8673_3.txt;20;8;2;30;919;0.02;0.01;0.0
12053_3.txt;0;0;1;1;329;0.0;0.0;0.0
10650_1.txt;0;0;0;0;230;0.0;0.0;0.0
8818_1.txt;4;3;0;7;201;0.02;0.01;0.0
358_4.txt;51;2;2;55;923;0.06;0.0;0.0
3560_2.txt;3;0;0;3;116;0.03;0.0;0.0
9176_1.txt;0;0;0;0;107;0.0;0.0;0.0
11227_1.txt;10;0;2;12;466;0.02;0.0;0.0
10843_1.txt;2;0;1;3;141;0.01;0.0;0.01
10081_1.txt;2;0;0;2;134;0.01;0.0;0.0
11716_2.txt;3;0;0;3;159;0.02;0.0;0.0
6256_3.txt;19;0;0;19;917;0.02;0.0;0.0
12441_4.txt;6;0;0;6;151;0.04;0.0;0.0
10947_1.txt;0;0;0;0;68;0.0;0.0;0.0
6683_1.txt;0;0;0;0;143;0.0;0.0;0.0
2401_3.txt;8;1;0;9;199;0.04;0.01;0.0
3728_1.txt;1;0;0;1;293;0.0;0.0;0.0
10168_2.txt;4;0;0;4;75;0.05;0.0;0.0
4931_1.txt;0;0;0;0;172;0.0;0.0;0.0
1368_1.txt;4;0;3;7;140;0.03;0.0;0.02
6346_2.txt;15;2;0;17;248;0.06;0.01;0.0
9544_2.txt;0;0;0;0;152;0.0;0.0;0.0
6632_1.txt;14;0;3;17;403;0.03;0.0;0.01
7191_3.txt;0;1;0;1;135;0.0;0.01;0.0
2009_4.txt;16;0;2;18;366;0.04;0.0;0.01
2615_2.txt;13;0;2;15;403;0.03;0.0;0.0
7491_1.txt;4;3;3;10;649;0.01;0.0;0.0
1206_4.txt;0;0;2;2;305;0.0;0.0;0.01
6677_1.txt;0;0;0;0;253;0.0;0.0;0.0
3586_4.txt;2;0;0;2;79;0.03;0.0;0.0
71_1.txt;5;3;0;8;298;0.02;0.01;0.0
10601_3.txt;13;0;0;13;283;0.05;0.0;0.0
3998_1.txt;0;0;0;0;428;0.0;0.0;0.0
4058_2.txt;2;0;1;3;171;0.01;0.0;0.01
8353_3.txt;16;3;0;19;233;0.07;0.01;0.0
9813_1.txt;6;0;0;6;162;0.04;0.0;0.0
5970_3.txt;2;0;0;2;308;0.01;0.0;0.0
2436_1.txt;0;0;0;0;48;0.0;0.0;0.0
6782_4.txt;4;1;2;7;226;0.02;0.0;0.01
12149_4.txt;0;4;0;4;200;0.0;0.02;0.0
8560_1.txt;14;2;1;17;397;0.04;0.01;0.0
4046_1.txt;3;0;0;3;193;0.02;0.0;0.0
9492_4.txt;13;0;0;13;160;0.08;0.0;0.0
10686_2.txt;3;6;4;13;249;0.01;0.02;0.02
2537_4.txt;2;1;0;3;62;0.03;0.02;0.0
2774_2.txt;8;0;0;8;142;0.06;0.0;0.0
4222_2.txt;7;11;2;20;207;0.03;0.05;0.01
8752_2.txt;0;0;0;0;159;0.0;0.0;0.0
8424_3.txt;12;5;0;17;429;0.03;0.01;0.0
640_3.txt;16;0;0;16;141;0.11;0.0;0.0
11025_1.txt;89;2;11;102;789;0.11;0.0;0.01
356_4.txt;2;0;0;2;183;0.01;0.0;0.0
10327_1.txt;4;2;6;12;554;0.01;0.0;0.01
2302_1.txt;50;24;10;84;1212;0.04;0.02;0.01
4408_2.txt;21;3;5;29;428;0.05;0.01;0.01
6974_4.txt;0;0;0;0;115;0.0;0.0;0.0
5976_3.txt;8;2;1;11;419;0.02;0.0;0.0
12118_4.txt;22;0;0;22;226;0.1;0.0;0.0
5254_3.txt;2;6;2;10;925;0.0;0.01;0.0
6142_1.txt;2;0;0;2;135;0.01;0.0;0.0
5580_2.txt;0;1;3;4;194;0.0;0.01;0.02
11036_1.txt;4;0;0;4;155;0.03;0.0;0.0
6815_4.txt;6;0;0;6;236;0.03;0.0;0.0
8274_1.txt;15;4;0;19;331;0.05;0.01;0.0
10498_3.txt;9;0;3;12;206;0.04;0.0;0.01
1991_3.txt;0;2;0;2;138;0.0;0.01;0.0
6072_4.txt;4;0;0;4;164;0.02;0.0;0.0
8249_2.txt;8;0;0;8;284;0.03;0.0;0.0
11008_1.txt;0;0;0;0;146;0.0;0.0;0.0
6332_1.txt;1;0;0;1;163;0.01;0.0;0.0
6488_1.txt;4;0;0;4;156;0.03;0.0;0.0
4110_1.txt;3;0;0;3;206;0.01;0.0;0.0
12065_3.txt;0;0;0;0;296;0.0;0.0;0.0
7013_3.txt;4;0;0;4;88;0.05;0.0;0.0
6443_1.txt;4;0;1;5;164;0.02;0.0;0.01
10825_1.txt;11;1;0;12;269;0.04;0.0;0.0
10769_2.txt;8;0;0;8;155;0.05;0.0;0.0
10885_1.txt;1;0;0;1;637;0.0;0.0;0.0
11012_1.txt;21;0;7;28;992;0.02;0.0;0.01
4053_4.txt;13;0;2;15;452;0.03;0.0;0.0
10062_1.txt;1;0;1;2;244;0.0;0.0;0.0
924_4.txt;0;1;0;1;102;0.0;0.01;0.0
10044_1.txt;3;0;0;3;127;0.02;0.0;0.0
10114_1.txt;0;0;0;0;155;0.0;0.0;0.0
10984_2.txt;2;1;1;4;143;0.01;0.01;0.01
1713_1.txt;0;0;0;0;219;0.0;0.0;0.0
7777_1.txt;0;0;0;0;150;0.0;0.0;0.0
1729_3.txt;7;4;0;11;246;0.03;0.02;0.0
12016_1.txt;9;0;1;10;104;0.09;0.0;0.01
7282_1.txt;0;0;2;2;206;0.0;0.0;0.01
8981_4.txt;0;1;1;2;163;0.0;0.01;0.01
2451_3.txt;1;0;1;2;82;0.01;0.0;0.01
4180_3.txt;6;0;2;8;426;0.01;0.0;0.0
8032_3.txt;13;0;1;14;172;0.08;0.0;0.01
5953_1.txt;0;0;0;0;136;0.0;0.0;0.0
9564_1.txt;0;0;0;0;322;0.0;0.0;0.0
814_1.txt;2;0;0;2;135;0.01;0.0;0.0
8168_4.txt;59;6;0;65;999;0.06;0.01;0.0
409_2.txt;8;0;2;10;304;0.03;0.0;0.01
8950_4.txt;6;0;0;6;255;0.02;0.0;0.0
1236_1.txt;11;2;1;14;327;0.03;0.01;0.0
10922_3.txt;9;2;0;11;182;0.05;0.01;0.0
10162_3.txt;7;5;1;13;337;0.02;0.01;0.0
4018_4.txt;0;0;2;2;150;0.0;0.0;0.01
4744_4.txt;3;0;2;5;102;0.03;0.0;0.02
2137_1.txt;11;1;3;15;205;0.05;0.0;0.01
119_4.txt;23;2;1;26;586;0.04;0.0;0.0
2253_2.txt;30;1;5;36;934;0.03;0.0;0.01
11971_1.txt;2;0;0;2;449;0.0;0.0;0.0
11006_1.txt;7;0;0;7;298;0.02;0.0;0.0
11821_2.txt;3;0;0;3;148;0.02;0.0;0.0
3459_4.txt;2;0;0;2;192;0.01;0.0;0.0
3690_1.txt;6;0;0;6;141;0.04;0.0;0.0
11631_1.txt;4;2;0;6;389;0.01;0.01;0.0
2755_4.txt;4;0;0;4;199;0.02;0.0;0.0
1866_2.txt;0;1;0;1;304;0.0;0.0;0.0
6682_4.txt;2;0;1;3;140;0.01;0.0;0.01
10096_1.txt;1;0;0;1;142;0.01;0.0;0.0
3441_4.txt;5;0;0;5;157;0.03;0.0;0.0
11413_1.txt;1;0;0;1;471;0.0;0.0;0.0
3933_4.txt;9;0;0;9;162;0.06;0.0;0.0
12333_1.txt;4;1;0;5;81;0.05;0.01;0.0
11796_3.txt;3;2;0;5;184;0.02;0.01;0.0
7978_1.txt;7;1;1;9;680;0.01;0.0;0.0
921_2.txt;2;0;0;2;104;0.02;0.0;0.0
12117_4.txt;15;0;0;15;294;0.05;0.0;0.0
7340_1.txt;0;0;2;2;141;0.0;0.0;0.01
234_1.txt;2;0;0;2;449;0.0;0.0;0.0
6861_1.txt;0;0;4;4;125;0.0;0.0;0.03
5994_3.txt;10;2;0;12;262;0.04;0.01;0.0
12262_3.txt;5;2;0;7;375;0.01;0.01;0.0
321_1.txt;9;0;4;13;333;0.03;0.0;0.01
11395_4.txt;15;0;0;15;181;0.08;0.0;0.0
11689_2.txt;33;3;3;39;1245;0.03;0.0;0.0
3195_3.txt;14;2;0;16;612;0.02;0.0;0.0
5251_1.txt;0;0;0;0;216;0.0;0.0;0.0
5933_2.txt;25;0;2;27;186;0.13;0.0;0.01
7537_1.txt;4;0;0;4;193;0.02;0.0;0.0
1699_4.txt;4;0;2;6;240;0.02;0.0;0.01
7875_3.txt;13;0;0;13;307;0.04;0.0;0.0
5165_1.txt;0;1;2;3;95;0.0;0.01;0.02
5187_1.txt;0;0;0;0;255;0.0;0.0;0.0
9493_2.txt;3;0;0;3;237;0.01;0.0;0.0
5952_4.txt;1;0;0;1;324;0.0;0.0;0.0
7938_2.txt;4;0;0;4;347;0.01;0.0;0.0
4458_3.txt;2;0;0;2;151;0.01;0.0;0.0
8772_1.txt;2;3;2;7;221;0.01;0.01;0.01
5253_3.txt;1;0;0;1;186;0.01;0.0;0.0
5537_3.txt;8;3;0;11;137;0.06;0.02;0.0
2453_4.txt;2;0;0;2;180;0.01;0.0;0.0
568_1.txt;1;0;0;1;262;0.0;0.0;0.0
4166_3.txt;0;0;0;0;169;0.0;0.0;0.0
2496_1.txt;2;2;0;4;285;0.01;0.01;0.0
10954_1.txt;0;0;0;0;196;0.0;0.0;0.0
8660_1.txt;0;0;0;0;144;0.0;0.0;0.0
5967_4.txt;2;0;0;2;177;0.01;0.0;0.0
7670_1.txt;0;0;0;0;144;0.0;0.0;0.0
7940_1.txt;5;2;1;8;224;0.02;0.01;0.0
165_4.txt;6;0;0;6;569;0.01;0.0;0.0
3341_1.txt;6;0;0;6;192;0.03;0.0;0.0
7990_4.txt;3;1;0;4;171;0.02;0.01;0.0
6222_1.txt;4;3;2;9;566;0.01;0.01;0.0
12146_2.txt;12;2;4;18;193;0.06;0.01;0.02
11825_1.txt;15;0;1;16;466;0.03;0.0;0.0
11070_1.txt;2;0;0;2;87;0.02;0.0;0.0
7584_3.txt;44;3;9;56;596;0.07;0.01;0.02
7969_1.txt;2;0;0;2;169;0.01;0.0;0.0
1917_1.txt;0;14;0;14;103;0.0;0.14;0.0
10304_1.txt;3;0;0;3;216;0.01;0.0;0.0
10497_4.txt;10;0;3;13;399;0.03;0.0;0.01
5456_3.txt;4;0;0;4;270;0.01;0.0;0.0
6116_1.txt;38;1;0;39;651;0.06;0.0;0.0
10349_4.txt;10;0;0;10;182;0.05;0.0;0.0
8809_1.txt;0;0;0;0;339;0.0;0.0;0.0
11075_2.txt;4;1;0;5;133;0.03;0.01;0.0
3427_1.txt;4;0;0;4;89;0.04;0.0;0.0
5242_1.txt;1;0;0;1;232;0.0;0.0;0.0
4156_1.txt;0;0;0;0;209;0.0;0.0;0.0
9003_1.txt;5;0;1;6;525;0.01;0.0;0.0
1531_1.txt;0;0;4;4;138;0.0;0.0;0.03
7198_1.txt;4;0;0;4;100;0.04;0.0;0.0
6918_2.txt;10;1;0;11;189;0.05;0.01;0.0
5909_3.txt;6;0;0;6;107;0.06;0.0;0.0
10187_3.txt;8;0;2;10;116;0.07;0.0;0.02
7381_1.txt;2;0;0;2;142;0.01;0.0;0.0
6473_3.txt;6;0;0;6;213;0.03;0.0;0.0
8325_1.txt;3;0;0;3;161;0.02;0.0;0.0
2852_3.txt;15;0;0;15;258;0.06;0.0;0.0
6007_4.txt;0;0;0;0;378;0.0;0.0;0.0
3412_1.txt;4;5;1;10;148;0.03;0.03;0.01
9006_4.txt;2;2;0;4;344;0.01;0.01;0.0
6122_2.txt;51;0;0;51;658;0.08;0.0;0.0
5738_4.txt;0;0;0;0;185;0.0;0.0;0.0
4246_4.txt;16;0;0;16;148;0.11;0.0;0.0
5572_4.txt;1;1;0;2;153;0.01;0.01;0.0
6131_1.txt;6;0;0;6;80;0.07;0.0;0.0
821_3.txt;28;0;0;28;268;0.1;0.0;0.0
8215_2.txt;0;0;0;0;226;0.0;0.0;0.0
1979_2.txt;3;0;0;3;157;0.02;0.0;0.0
10167_1.txt;0;2;0;2;80;0.0;0.03;0.0
7145_1.txt;1;0;0;1;174;0.01;0.0;0.0
8551_4.txt;10;4;10;24;185;0.05;0.02;0.05
7008_2.txt;10;2;0;12;127;0.08;0.02;0.0
10041_1.txt;41;1;4;46;782;0.05;0.0;0.01
4957_1.txt;5;1;0;6;299;0.02;0.0;0.0
10077_2.txt;6;0;2;8;453;0.01;0.0;0.0
2167_2.txt;3;1;0;4;159;0.02;0.01;0.0
8658_1.txt;8;3;2;13;407;0.02;0.01;0.0
7874_2.txt;9;1;10;20;385;0.02;0.0;0.03
2332_1.txt;2;0;0;2;123;0.02;0.0;0.0
9294_4.txt;4;0;0;4;199;0.02;0.0;0.0
10943_3.txt;16;0;0;16;450;0.04;0.0;0.0
3277_1.txt;0;0;0;0;211;0.0;0.0;0.0
8671_3.txt;9;2;0;11;199;0.05;0.01;0.0
3432_4.txt;3;0;0;3;374;0.01;0.0;0.0
2512_4.txt;13;2;0;15;153;0.08;0.01;0.0
7164_2.txt;1;0;0;1;158;0.01;0.0;0.0
5155_1.txt;0;0;0;0;63;0.0;0.0;0.0
707_3.txt;5;1;7;13;796;0.01;0.0;0.01
4768_4.txt;0;0;0;0;185;0.0;0.0;0.0
3447_1.txt;0;0;0;0;149;0.0;0.0;0.0
6181_3.txt;6;4;0;10;295;0.02;0.01;0.0
3502_3.txt;16;0;0;16;441;0.04;0.0;0.0
1402_4.txt;0;1;0;1;148;0.0;0.01;0.0
6619_1.txt;2;0;0;2;132;0.02;0.0;0.0
9501_2.txt;14;0;0;14;435;0.03;0.0;0.0
4086_1.txt;6;0;0;6;249;0.02;0.0;0.0
10354_4.txt;0;0;2;2;226;0.0;0.0;0.01
7943_4.txt;5;0;0;5;112;0.04;0.0;0.0
1741_4.txt;8;1;2;11;280;0.03;0.0;0.01
9341_4.txt;15;1;1;17;370;0.04;0.0;0.0
10660_1.txt;0;0;0;0;104;0.0;0.0;0.0
5435_1.txt;9;3;9;21;381;0.02;0.01;0.02
4743_1.txt;1;1;2;4;208;0.0;0.0;0.01
8823_1.txt;17;6;0;23;575;0.03;0.01;0.0
1528_1.txt;0;0;0;0;49;0.0;0.0;0.0
9163_1.txt;0;0;0;0;133;0.0;0.0;0.0
5866_1.txt;4;0;0;4;146;0.03;0.0;0.0
10667_3.txt;12;1;0;13;279;0.04;0.0;0.0
230_2.txt;4;1;4;9;217;0.02;0.0;0.02
11997_4.txt;0;0;0;0;119;0.0;0.0;0.0
4334_1.txt;17;0;0;17;411;0.04;0.0;0.0
10434_3.txt;7;1;1;9;438;0.02;0.0;0.0
4137_3.txt;2;1;3;6;282;0.01;0.0;0.01
12499_2.txt;4;2;0;6;155;0.03;0.01;0.0
9482_1.txt;0;0;0;0;157;0.0;0.0;0.0
5961_4.txt;0;0;0;0;176;0.0;0.0;0.0
2500_1.txt;2;0;0;2;179;0.01;0.0;0.0
4438_1.txt;2;0;0;2;116;0.02;0.0;0.0
287_4.txt;6;0;0;6;142;0.04;0.0;0.0
1799_3.txt;9;0;1;10;220;0.04;0.0;0.0
3999_4.txt;12;7;6;25;637;0.02;0.01;0.01
17_3.txt;0;0;0;0;56;0.0;0.0;0.0
9800_1.txt;0;1;4;5;197;0.0;0.01;0.02
2561_3.txt;25;1;5;31;609;0.04;0.0;0.01
7122_3.txt;8;0;0;8;343;0.02;0.0;0.0
12378_1.txt;2;0;0;2;152;0.01;0.0;0.0
5440_2.txt;7;0;0;7;171;0.04;0.0;0.0
2927_1.txt;0;0;0;0;331;0.0;0.0;0.0
6486_2.txt;5;1;4;10;289;0.02;0.0;0.01
9056_1.txt;17;3;2;22;423;0.04;0.01;0.0
1397_2.txt;0;0;0;0;147;0.0;0.0;0.0
859_1.txt;16;1;3;20;407;0.04;0.0;0.01
8095_4.txt;21;8;2;31;846;0.02;0.01;0.0
978_1.txt;3;0;0;3;265;0.01;0.0;0.0
11809_2.txt;0;0;2;2;157;0.0;0.0;0.01
2065_2.txt;4;3;1;8;161;0.02;0.02;0.01
5057_1.txt;3;0;1;4;124;0.02;0.0;0.01
5813_4.txt;8;0;0;8;252;0.03;0.0;0.0
6068_4.txt;2;0;2;4;141;0.01;0.0;0.01
7360_1.txt;2;0;1;3;298;0.01;0.0;0.0
5548_4.txt;29;1;2;32;547;0.05;0.0;0.0
6542_1.txt;0;0;0;0;140;0.0;0.0;0.0
11383_2.txt;22;0;4;26;267;0.08;0.0;0.01
5366_1.txt;2;1;0;3;428;0.0;0.0;0.0
11641_1.txt;9;0;0;9;380;0.02;0.0;0.0
2044_1.txt;2;0;0;2;181;0.01;0.0;0.0
10520_2.txt;4;0;2;6;130;0.03;0.0;0.02
3990_2.txt;4;2;0;6;120;0.03;0.02;0.0
504_3.txt;10;0;0;10;347;0.03;0.0;0.0
9394_2.txt;2;1;2;5;450;0.0;0.0;0.0
1374_1.txt;3;0;0;3;165;0.02;0.0;0.0
11961_1.txt;2;1;0;3;272;0.01;0.0;0.0
9251_3.txt;0;0;0;0;89;0.0;0.0;0.0
8536_4.txt;15;0;0;15;343;0.04;0.0;0.0
12039_4.txt;12;15;2;29;532;0.02;0.03;0.0
11299_4.txt;8;4;2;14;195;0.04;0.02;0.01
8678_4.txt;6;3;0;9;228;0.03;0.01;0.0
503_2.txt;0;0;0;0;120;0.0;0.0;0.0
10478_3.txt;2;0;0;2;121;0.02;0.0;0.0
10292_3.txt;1;3;0;4;259;0.0;0.01;0.0
2211_3.txt;0;0;0;0;174;0.0;0.0;0.0
3889_2.txt;3;0;0;3;364;0.01;0.0;0.0
12393_4.txt;0;1;0;1;209;0.0;0.0;0.0
131_4.txt;4;3;0;7;176;0.02;0.02;0.0
11738_2.txt;17;6;3;26;471;0.04;0.01;0.01
4457_4.txt;19;8;4;31;827;0.02;0.01;0.0
8461_1.txt;2;1;0;3;138;0.01;0.01;0.0
1540_4.txt;0;0;0;0;44;0.0;0.0;0.0
4340_2.txt;7;2;0;9;293;0.02;0.01;0.0
2918_3.txt;18;0;0;18;645;0.03;0.0;0.0
1242_1.txt;0;0;0;0;62;0.0;0.0;0.0
2807_3.txt;2;0;0;2;152;0.01;0.0;0.0
4966_2.txt;1;0;0;1;156;0.01;0.0;0.0
11841_1.txt;5;0;0;5;117;0.04;0.0;0.0
11181_4.txt;5;0;0;5;185;0.03;0.0;0.0
1346_1.txt;2;0;0;2;156;0.01;0.0;0.0
10864_1.txt;2;1;2;5;204;0.01;0.0;0.01
7912_4.txt;9;5;0;14;891;0.01;0.01;0.0
27_1.txt;4;0;0;4;172;0.02;0.0;0.0
4211_4.txt;10;0;0;10;139;0.07;0.0;0.0
11559_4.txt;26;3;2;31;561;0.05;0.01;0.0
3583_1.txt;2;0;0;2;72;0.03;0.0;0.0
2299_1.txt;7;0;0;7;308;0.02;0.0;0.0
9300_1.txt;2;0;0;2;241;0.01;0.0;0.0
11858_2.txt;2;2;0;4;149;0.01;0.01;0.0
1064_2.txt;0;0;0;0;132;0.0;0.0;0.0
10858_1.txt;0;0;0;0;81;0.0;0.0;0.0
8749_1.txt;5;0;4;9;114;0.04;0.0;0.04
2699_2.txt;3;0;0;3;226;0.01;0.0;0.0
11001_1.txt;3;0;0;3;88;0.03;0.0;0.0
1964_1.txt;14;0;2;16;529;0.03;0.0;0.0
4995_3.txt;0;0;0;0;129;0.0;0.0;0.0
10002_1.txt;3;0;0;3;182;0.02;0.0;0.0
3312_3.txt;2;2;1;5;193;0.01;0.01;0.01
6716_3.txt;0;1;0;1;142;0.0;0.01;0.0
3435_1.txt;0;0;0;0;235;0.0;0.0;0.0
1330_1.txt;13;3;0;16;268;0.05;0.01;0.0
72_4.txt;18;0;0;18;514;0.04;0.0;0.0
3484_4.txt;2;0;0;2;208;0.01;0.0;0.0
3401_2.txt;1;1;0;2;265;0.0;0.0;0.0
5869_1.txt;1;0;0;1;203;0.0;0.0;0.0
4278_1.txt;4;1;3;8;202;0.02;0.0;0.01
7914_2.txt;11;0;0;11;302;0.04;0.0;0.0
3744_4.txt;10;0;0;10;377;0.03;0.0;0.0
8188_1.txt;8;3;0;11;327;0.02;0.01;0.0
5493_3.txt;4;0;0;4;36;0.11;0.0;0.0
5689_2.txt;16;0;0;16;516;0.03;0.0;0.0
2184_1.txt;0;0;0;0;250;0.0;0.0;0.0
9956_2.txt;5;0;0;5;180;0.03;0.0;0.0
2589_1.txt;1;0;4;5;576;0.0;0.0;0.01
1222_1.txt;4;0;0;4;145;0.03;0.0;0.0
2912_1.txt;6;0;2;8;145;0.04;0.0;0.01
5004_3.txt;4;0;0;4;177;0.02;0.0;0.0
8600_1.txt;0;0;0;0;96;0.0;0.0;0.0
2890_3.txt;0;0;0;0;204;0.0;0.0;0.0
3503_1.txt;2;0;0;2;161;0.01;0.0;0.0
5038_1.txt;0;0;0;0;47;0.0;0.0;0.0
1661_1.txt;0;0;0;0;120;0.0;0.0;0.0
5232_2.txt;5;0;1;6;166;0.03;0.0;0.01
7645_4.txt;12;0;0;12;145;0.08;0.0;0.0
11384_2.txt;2;2;1;5;224;0.01;0.01;0.0
523_1.txt;0;0;0;0;158;0.0;0.0;0.0
4361_2.txt;1;0;0;1;139;0.01;0.0;0.0
4051_4.txt;9;2;0;11;196;0.05;0.01;0.0
3629_1.txt;56;1;0;57;753;0.07;0.0;0.0
5518_1.txt;8;0;0;8;237;0.03;0.0;0.0
9173_1.txt;4;0;0;4;293;0.01;0.0;0.0
8300_4.txt;5;0;0;5;147;0.03;0.0;0.0
4606_3.txt;25;0;0;25;578;0.04;0.0;0.0
2078_1.txt;2;0;0;2;152;0.01;0.0;0.0
1454_1.txt;4;2;0;6;343;0.01;0.01;0.0
1023_3.txt;7;1;0;8;505;0.01;0.0;0.0
11714_1.txt;3;3;0;6;139;0.02;0.02;0.0
10861_4.txt;10;0;0;10;222;0.05;0.0;0.0
8159_1.txt;0;0;0;0;74;0.0;0.0;0.0
11708_3.txt;0;0;0;0;161;0.0;0.0;0.0
5028_4.txt;16;3;0;19;759;0.02;0.0;0.0
6340_1.txt;12;0;0;12;199;0.06;0.0;0.0
6075_2.txt;3;0;0;3;142;0.02;0.0;0.0
2023_1.txt;1;0;0;1;188;0.01;0.0;0.0
6407_1.txt;0;0;0;0;71;0.0;0.0;0.0
1952_3.txt;4;0;1;5;224;0.02;0.0;0.0
3518_1.txt;1;3;0;4;107;0.01;0.03;0.0
7120_4.txt;0;1;0;1;81;0.0;0.01;0.0
10810_1.txt;4;0;0;4;76;0.05;0.0;0.0
1873_3.txt;12;1;0;13;282;0.04;0.0;0.0
10930_1.txt;6;0;0;6;187;0.03;0.0;0.0
1282_4.txt;3;0;0;3;130;0.02;0.0;0.0
9557_1.txt;0;0;0;0;230;0.0;0.0;0.0
4242_2.txt;0;0;0;0;176;0.0;0.0;0.0
3394_4.txt;6;2;0;8;92;0.07;0.02;0.0
7286_2.txt;1;0;0;1;213;0.0;0.0;0.0
4775_3.txt;3;0;0;3;149;0.02;0.0;0.0
2471_2.txt;1;0;0;1;238;0.0;0.0;0.0
7371_1.txt;3;0;0;3;144;0.02;0.0;0.0
9453_1.txt;1;0;0;1;172;0.01;0.0;0.0
4275_1.txt;3;1;0;4;221;0.01;0.0;0.0
3625_2.txt;0;0;3;3;202;0.0;0.0;0.01
8920_1.txt;6;4;0;10;135;0.04;0.03;0.0
11998_3.txt;10;0;0;10;304;0.03;0.0;0.0
9442_4.txt;0;0;0;0;250;0.0;0.0;0.0
8989_1.txt;23;3;0;26;414;0.06;0.01;0.0
129_3.txt;3;0;0;3;198;0.02;0.0;0.0
922_1.txt;0;1;2;3;204;0.0;0.0;0.01
30_1.txt;4;0;2;6;161;0.02;0.0;0.01
2323_3.txt;4;0;0;4;74;0.05;0.0;0.0
9603_4.txt;16;0;0;16;296;0.05;0.0;0.0
596_4.txt;2;1;2;5;261;0.01;0.0;0.01
10298_4.txt;8;0;0;8;183;0.04;0.0;0.0
11269_1.txt;0;0;0;0;105;0.0;0.0;0.0
8928_4.txt;35;0;2;37;607;0.06;0.0;0.0
10222_4.txt;18;0;0;18;199;0.09;0.0;0.0
12218_1.txt;5;3;0;8;423;0.01;0.01;0.0
9955_1.txt;4;0;0;4;167;0.02;0.0;0.0
5178_1.txt;0;0;0;0;213;0.0;0.0;0.0
11414_1.txt;0;0;0;0;62;0.0;0.0;0.0
10313_4.txt;4;0;0;4;170;0.02;0.0;0.0
7705_2.txt;2;0;0;2;109;0.02;0.0;0.0
9857_1.txt;0;0;0;0;152;0.0;0.0;0.0
8102_1.txt;0;0;0;0;188;0.0;0.0;0.0
3066_2.txt;0;0;0;0;268;0.0;0.0;0.0
7545_1.txt;2;1;0;3;295;0.01;0.0;0.0
9892_1.txt;10;0;0;10;154;0.06;0.0;0.0
7745_1.txt;0;0;0;0;141;0.0;0.0;0.0
1195_1.txt;1;0;0;1;293;0.0;0.0;0.0
12293_3.txt;7;0;0;7;87;0.08;0.0;0.0
1104_1.txt;2;0;1;3;296;0.01;0.0;0.0
6499_2.txt;4;0;0;4;155;0.03;0.0;0.0
4774_3.txt;0;0;0;0;448;0.0;0.0;0.0
4532_1.txt;12;0;0;12;290;0.04;0.0;0.0
7221_1.txt;0;0;0;0;147;0.0;0.0;0.0
3083_1.txt;0;0;0;0;69;0.0;0.0;0.0
11837_2.txt;4;1;1;6;150;0.03;0.01;0.01
7594_2.txt;6;0;0;6;302;0.02;0.0;0.0
5647_3.txt;4;2;4;10;364;0.01;0.01;0.01
6118_1.txt;9;0;0;9;153;0.06;0.0;0.0
8968_1.txt;0;0;0;0;394;0.0;0.0;0.0
3124_3.txt;22;1;0;23;551;0.04;0.0;0.0
8296_4.txt;6;0;2;8;288;0.02;0.0;0.01
8434_1.txt;5;2;0;7;104;0.05;0.02;0.0
7668_1.txt;6;0;0;6;153;0.04;0.0;0.0
8913_2.txt;5;1;3;9;363;0.01;0.0;0.01
7312_1.txt;18;0;0;18;852;0.02;0.0;0.0
11307_1.txt;4;0;0;4;68;0.06;0.0;0.0
1998_4.txt;7;0;2;9;384;0.02;0.0;0.01
3082_1.txt;1;0;0;1;169;0.01;0.0;0.0
1558_1.txt;0;0;0;0;68;0.0;0.0;0.0
9513_1.txt;0;0;0;0;146;0.0;0.0;0.0
843_1.txt;11;4;10;25;345;0.03;0.01;0.03
491_1.txt;0;0;0;0;112;0.0;0.0;0.0
3226_1.txt;3;0;0;3;409;0.01;0.0;0.0
3520_2.txt;13;1;2;16;591;0.02;0.0;0.0
786_3.txt;20;0;0;20;551;0.04;0.0;0.0
12024_2.txt;0;2;0;2;113;0.0;0.02;0.0
9584_4.txt;0;1;0;1;43;0.0;0.02;0.0
4526_4.txt;14;2;0;16;350;0.04;0.01;0.0
10319_1.txt;0;1;4;5;254;0.0;0.0;0.02
10850_3.txt;4;0;0;4;289;0.01;0.0;0.0
6730_3.txt;0;0;0;0;98;0.0;0.0;0.0
8241_2.txt;0;0;0;0;136;0.0;0.0;0.0
3760_1.txt;1;0;0;1;232;0.0;0.0;0.0
9502_3.txt;1;0;0;1;153;0.01;0.0;0.0
5597_3.txt;2;0;0;2;158;0.01;0.0;0.0
5668_3.txt;4;0;2;6;225;0.02;0.0;0.01
11357_3.txt;2;1;0;3;184;0.01;0.01;0.0
5638_4.txt;2;0;0;2;291;0.01;0.0;0.0
2243_4.txt;0;0;0;0;105;0.0;0.0;0.0
4462_4.txt;0;2;0;2;165;0.0;0.01;0.0
8791_1.txt;7;3;2;12;372;0.02;0.01;0.01
9825_1.txt;0;0;0;0;68;0.0;0.0;0.0
524_1.txt;3;0;0;3;209;0.01;0.0;0.0
9425_1.txt;0;0;0;0;215;0.0;0.0;0.0
9599_1.txt;0;0;0;0;34;0.0;0.0;0.0
6329_1.txt;1;0;1;2;198;0.01;0.0;0.01
5445_1.txt;8;0;2;10;191;0.04;0.0;0.01
2203_3.txt;3;0;2;5;271;0.01;0.0;0.01
3641_4.txt;15;6;0;21;636;0.02;0.01;0.0
4208_3.txt;0;0;0;0;169;0.0;0.0;0.0
2646_3.txt;10;1;0;11;259;0.04;0.0;0.0
181_2.txt;0;0;0;0;161;0.0;0.0;0.0
4021_1.txt;2;0;0;2;188;0.01;0.0;0.0
646_1.txt;0;1;0;1;159;0.0;0.01;0.0
606_4.txt;0;0;0;0;158;0.0;0.0;0.0
12299_1.txt;37;1;2;40;692;0.05;0.0;0.0
3976_1.txt;2;0;0;2;110;0.02;0.0;0.0
8244_1.txt;0;0;3;3;334;0.0;0.0;0.01
9637_2.txt;1;1;0;2;153;0.01;0.01;0.0
5090_4.txt;15;1;0;16;227;0.07;0.0;0.0
6969_2.txt;4;1;0;5;138;0.03;0.01;0.0
2130_3.txt;9;1;0;10;442;0.02;0.0;0.0
5712_1.txt;4;2;0;6;309;0.01;0.01;0.0
9287_1.txt;14;3;0;17;377;0.04;0.01;0.0
8695_3.txt;2;1;2;5;141;0.01;0.01;0.01
7494_2.txt;85;11;6;102;1167;0.07;0.01;0.01
6151_1.txt;5;1;0;6;629;0.01;0.0;0.0
1913_3.txt;7;0;0;7;253;0.03;0.0;0.0
5574_4.txt;1;4;0;5;174;0.01;0.02;0.0
10817_3.txt;61;12;1;74;1075;0.06;0.01;0.0
6820_1.txt;2;0;0;2;131;0.02;0.0;0.0
9186_1.txt;2;0;0;2;390;0.01;0.0;0.0
12110_4.txt;6;1;0;7;216;0.03;0.0;0.0
7153_3.txt;20;0;0;20;496;0.04;0.0;0.0
9178_1.txt;4;2;0;6;114;0.04;0.02;0.0
4309_3.txt;17;0;4;21;183;0.09;0.0;0.02
8826_2.txt;4;1;0;5;338;0.01;0.0;0.0
7166_2.txt;2;0;0;2;128;0.02;0.0;0.0
830_1.txt;6;0;0;6;113;0.05;0.0;0.0
8798_3.txt;0;1;0;1;245;0.0;0.0;0.0
4062_1.txt;0;0;0;0;138;0.0;0.0;0.0
7346_1.txt;0;0;0;0;191;0.0;0.0;0.0
5132_2.txt;28;1;0;29;542;0.05;0.0;0.0
1733_4.txt;15;2;2;19;187;0.08;0.01;0.01
7513_3.txt;2;0;0;2;89;0.02;0.0;0.0
12319_1.txt;0;0;0;0;191;0.0;0.0;0.0
2900_1.txt;1;0;0;1;274;0.0;0.0;0.0
719_4.txt;14;3;1;18;571;0.02;0.01;0.0
8270_1.txt;2;1;0;3;151;0.01;0.01;0.0
8140_2.txt;1;0;0;1;186;0.01;0.0;0.0
4655_4.txt;5;0;2;7;413;0.01;0.0;0.0
9529_2.txt;7;0;5;12;149;0.05;0.0;0.03
7135_3.txt;4;0;0;4;284;0.01;0.0;0.0
7110_1.txt;0;0;0;0;139;0.0;0.0;0.0
5526_3.txt;0;0;0;0;237;0.0;0.0;0.0
8602_2.txt;0;0;0;0;236;0.0;0.0;0.0
3841_1.txt;1;0;0;1;49;0.02;0.0;0.0
8063_2.txt;0;0;0;0;120;0.0;0.0;0.0
8624_4.txt;4;4;3;11;229;0.02;0.02;0.01
3533_1.txt;25;1;0;26;396;0.06;0.0;0.0
6001_2.txt;0;0;0;0;144;0.0;0.0;0.0
7206_1.txt;5;0;0;5;130;0.04;0.0;0.0
11553_4.txt;6;0;0;6;151;0.04;0.0;0.0
617_1.txt;1;0;0;1;194;0.01;0.0;0.0
7669_1.txt;9;0;0;9;371;0.02;0.0;0.0
11772_1.txt;0;1;0;1;185;0.0;0.01;0.0
7228_2.txt;3;0;0;3;398;0.01;0.0;0.0
10899_3.txt;0;0;0;0;122;0.0;0.0;0.0
10927_1.txt;3;0;0;3;175;0.02;0.0;0.0
10070_3.txt;36;0;5;41;174;0.21;0.0;0.03
5606_1.txt;3;0;1;4;386;0.01;0.0;0.0
1940_3.txt;3;1;1;5;258;0.01;0.0;0.0
1810_3.txt;0;0;0;0;125;0.0;0.0;0.0
2887_1.txt;0;0;0;0;256;0.0;0.0;0.0
5744_2.txt;2;0;0;2;291;0.01;0.0;0.0
9342_3.txt;8;0;9;17;320;0.03;0.0;0.03
9936_4.txt;3;1;0;4;144;0.02;0.01;0.0
6313_4.txt;2;6;0;8;205;0.01;0.03;0.0
9304_1.txt;1;0;0;1;155;0.01;0.0;0.0
8721_1.txt;0;0;0;0;107;0.0;0.0;0.0
4150_2.txt;3;2;0;5;465;0.01;0.0;0.0
4689_1.txt;2;0;2;4;169;0.01;0.0;0.01
2802_1.txt;0;0;0;0;193;0.0;0.0;0.0
6552_3.txt;22;0;2;24;272;0.08;0.0;0.01
10710_1.txt;15;2;0;17;247;0.06;0.01;0.0
3719_3.txt;12;1;0;13;358;0.03;0.0;0.0
82_1.txt;0;0;0;0;163;0.0;0.0;0.0
5387_3.txt;0;0;0;0;113;0.0;0.0;0.0
11575_1.txt;5;0;0;5;219;0.02;0.0;0.0
12356_1.txt;3;1;0;4;113;0.03;0.01;0.0
9748_4.txt;13;0;3;16;597;0.02;0.0;0.01
8201_1.txt;0;0;0;0;129;0.0;0.0;0.0
8057_1.txt;2;0;0;2;398;0.01;0.0;0.0
11327_4.txt;20;0;0;20;495;0.04;0.0;0.0
10744_3.txt;0;0;0;0;166;0.0;0.0;0.0
8490_3.txt;0;0;0;0;180;0.0;0.0;0.0
1651_2.txt;2;0;0;2;119;0.02;0.0;0.0
10683_1.txt;1;2;2;5;554;0.0;0.0;0.0
4688_3.txt;2;0;0;2;354;0.01;0.0;0.0
10171_3.txt;6;0;0;6;204;0.03;0.0;0.0
190_1.txt;0;0;0;0;183;0.0;0.0;0.0
3234_4.txt;0;0;0;0;277;0.0;0.0;0.0
7636_2.txt;4;0;0;4;331;0.01;0.0;0.0
9029_1.txt;3;0;0;3;168;0.02;0.0;0.0
9696_3.txt;4;2;0;6;118;0.03;0.02;0.0
11918_2.txt;2;4;0;6;239;0.01;0.02;0.0
12067_1.txt;5;0;0;5;292;0.02;0.0;0.0
6540_3.txt;0;0;0;0;176;0.0;0.0;0.0
9274_4.txt;0;0;0;0;160;0.0;0.0;0.0
6194_2.txt;12;1;3;16;308;0.04;0.0;0.01
7695_2.txt;7;1;0;8;152;0.05;0.01;0.0
1794_4.txt;0;0;0;0;132;0.0;0.0;0.0
5354_3.txt;15;0;0;15;344;0.04;0.0;0.0
10764_3.txt;6;0;1;7;153;0.04;0.0;0.01
7976_2.txt;9;1;1;11;271;0.03;0.0;0.0
8520_1.txt;13;2;0;15;142;0.09;0.01;0.0
11318_1.txt;0;0;0;0;56;0.0;0.0;0.0
10089_1.txt;14;5;4;23;762;0.02;0.01;0.01
2924_4.txt;6;0;0;6;182;0.03;0.0;0.0
2349_1.txt;10;5;3;18;268;0.04;0.02;0.01
6554_1.txt;2;0;0;2;254;0.01;0.0;0.0
3767_1.txt;0;0;3;3;146;0.0;0.0;0.02
12006_4.txt;41;0;1;42;388;0.11;0.0;0.0
11739_4.txt;16;2;0;18;308;0.05;0.01;0.0
5369_4.txt;10;2;2;14;303;0.03;0.01;0.01
3811_1.txt;4;0;0;4;139;0.03;0.0;0.0
2303_1.txt;3;1;0;4;344;0.01;0.0;0.0
10176_1.txt;15;0;0;15;707;0.02;0.0;0.0
5020_3.txt;2;0;0;2;158;0.01;0.0;0.0
3073_4.txt;2;0;0;2;146;0.01;0.0;0.0
442_1.txt;0;0;2;2;132;0.0;0.0;0.02
10618_1.txt;14;0;0;14;384;0.04;0.0;0.0
11209_3.txt;4;1;0;5;185;0.02;0.01;0.0
486_1.txt;1;1;0;2;212;0.0;0.0;0.0
10712_1.txt;3;0;0;3;171;0.02;0.0;0.0
9860_1.txt;0;0;0;0;153;0.0;0.0;0.0
3212_3.txt;0;0;3;3;193;0.0;0.0;0.02
6904_2.txt;5;5;2;12;420;0.01;0.01;0.0
10376_1.txt;0;2;0;2;148;0.0;0.01;0.0
9703_2.txt;0;0;4;4;175;0.0;0.0;0.02
9373_4.txt;8;1;0;9;176;0.05;0.01;0.0
3647_4.txt;1;1;0;2;127;0.01;0.01;0.0
7276_2.txt;43;1;5;49;844;0.05;0.0;0.01
8817_1.txt;2;2;1;5;470;0.0;0.0;0.0
2258_2.txt;2;1;0;3;129;0.02;0.01;0.0
3879_4.txt;0;0;2;2;184;0.0;0.0;0.01
12092_3.txt;2;0;0;2;261;0.01;0.0;0.0
811_1.txt;0;0;0;0;76;0.0;0.0;0.0
7676_2.txt;0;0;0;0;258;0.0;0.0;0.0
5590_1.txt;9;0;1;10;225;0.04;0.0;0.0
4326_2.txt;27;8;4;39;566;0.05;0.01;0.01
2102_1.txt;1;0;0;1;60;0.02;0.0;0.0
5596_3.txt;12;0;0;12;839;0.01;0.0;0.0
7557_1.txt;1;0;0;1;283;0.0;0.0;0.0
7241_2.txt;5;0;0;5;474;0.01;0.0;0.0
8171_3.txt;0;2;1;3;1087;0.0;0.0;0.0
4301_1.txt;0;0;0;0;167;0.0;0.0;0.0
4979_3.txt;6;0;0;6;284;0.02;0.0;0.0
11533_2.txt;9;2;1;12;281;0.03;0.01;0.0
5773_1.txt;5;4;8;17;390;0.01;0.01;0.02
1451_2.txt;16;5;0;21;583;0.03;0.01;0.0
10228_3.txt;5;0;0;5;204;0.02;0.0;0.0
8125_1.txt;4;0;0;4;163;0.02;0.0;0.0
177_1.txt;0;0;0;0;143;0.0;0.0;0.0
3735_4.txt;10;0;0;10;211;0.05;0.0;0.0
171_1.txt;2;0;0;2;84;0.02;0.0;0.0
12398_2.txt;0;0;0;0;155;0.0;0.0;0.0
1400_1.txt;2;0;1;3;146;0.01;0.0;0.01
10522_4.txt;2;0;0;2;456;0.0;0.0;0.0
3129_1.txt;13;1;0;14;393;0.03;0.0;0.0
11101_4.txt;11;2;0;13;527;0.02;0.0;0.0
9297_1.txt;0;0;0;0;75;0.0;0.0;0.0
2266_1.txt;6;0;0;6;197;0.03;0.0;0.0
12010_4.txt;28;3;0;31;214;0.13;0.01;0.0
2143_4.txt;2;0;2;4;316;0.01;0.0;0.01
2286_4.txt;11;1;2;14;552;0.02;0.0;0.0
4911_2.txt;18;0;0;18;366;0.05;0.0;0.0
7622_4.txt;23;0;1;24;509;0.05;0.0;0.0
11169_1.txt;2;0;5;7;139;0.01;0.0;0.04
1722_1.txt;15;0;0;15;191;0.08;0.0;0.0
1529_1.txt;0;0;0;0;79;0.0;0.0;0.0
9900_4.txt;30;1;0;31;326;0.09;0.0;0.0
8617_1.txt;0;1;0;1;181;0.0;0.01;0.0
3388_1.txt;3;2;0;5;203;0.01;0.01;0.0
4094_2.txt;9;0;4;13;523;0.02;0.0;0.01
6495_3.txt;10;0;0;10;286;0.03;0.0;0.0
8707_4.txt;0;0;0;0;185;0.0;0.0;0.0
1032_1.txt;3;0;0;3;179;0.02;0.0;0.0
10380_4.txt;29;2;2;33;528;0.05;0.0;0.0
5276_3.txt;5;0;1;6;410;0.01;0.0;0.0
7539_1.txt;3;0;0;3;164;0.02;0.0;0.0
5836_2.txt;2;0;0;2;92;0.02;0.0;0.0
7946_4.txt;0;0;0;0;103;0.0;0.0;0.0
8297_1.txt;3;0;2;5;164;0.02;0.0;0.01
6412_1.txt;0;1;0;1;161;0.0;0.01;0.0
4514_2.txt;19;10;7;36;1008;0.02;0.01;0.01
4915_4.txt;13;0;0;13;232;0.06;0.0;0.0
7685_4.txt;18;0;0;18;207;0.09;0.0;0.0
8214_4.txt;15;0;0;15;567;0.03;0.0;0.0
9467_1.txt;3;0;0;3;114;0.03;0.0;0.0
4302_2.txt;6;13;24;43;659;0.01;0.02;0.04
11775_2.txt;1;0;0;1;135;0.01;0.0;0.0
5182_4.txt;0;2;1;3;211;0.0;0.01;0.0
403_3.txt;11;0;0;11;184;0.06;0.0;0.0
5129_1.txt;4;1;0;5;103;0.04;0.01;0.0
10699_4.txt;3;0;0;3;345;0.01;0.0;0.0
2478_1.txt;0;0;0;0;289;0.0;0.0;0.0
12471_1.txt;4;3;0;7;132;0.03;0.02;0.0
4745_1.txt;5;5;2;12;288;0.02;0.02;0.01
1148_4.txt;12;0;4;16;137;0.09;0.0;0.03
4716_1.txt;4;0;0;4;209;0.02;0.0;0.0
6769_3.txt;4;3;2;9;169;0.02;0.02;0.01
9546_3.txt;2;1;0;3;130;0.02;0.01;0.0
12142_1.txt;4;0;0;4;193;0.02;0.0;0.0
1493_1.txt;0;1;0;1;372;0.0;0.0;0.0
6685_3.txt;0;7;3;10;136;0.0;0.05;0.02
1068_1.txt;28;10;0;38;736;0.04;0.01;0.0
8644_1.txt;1;7;0;8;177;0.01;0.04;0.0
11726_4.txt;13;5;2;20;230;0.06;0.02;0.01
1742_1.txt;9;4;1;14;431;0.02;0.01;0.0
12454_3.txt;2;0;1;3;145;0.01;0.0;0.01
3764_1.txt;0;0;3;3;233;0.0;0.0;0.01
694_2.txt;0;0;0;0;208;0.0;0.0;0.0
8511_1.txt;0;0;0;0;154;0.0;0.0;0.0
8894_4.txt;1;6;0;7;207;0.0;0.03;0.0
10241_1.txt;0;1;2;3;167;0.0;0.01;0.01
9610_4.txt;7;1;1;9;150;0.05;0.01;0.01
170_1.txt;2;0;3;5;529;0.0;0.0;0.01
5018_1.txt;2;0;0;2;175;0.01;0.0;0.0
7356_1.txt;13;1;0;14;218;0.06;0.0;0.0
5579_2.txt;2;0;0;2;249;0.01;0.0;0.0
11843_2.txt;7;0;0;7;197;0.04;0.0;0.0
9045_1.txt;0;0;1;1;137;0.0;0.0;0.01
12340_4.txt;11;3;0;14;304;0.04;0.01;0.0
9114_1.txt;2;0;0;2;243;0.01;0.0;0.0
229_1.txt;6;0;1;7;210;0.03;0.0;0.0
1051_4.txt;27;5;0;32;280;0.1;0.02;0.0
7859_2.txt;0;0;0;0;344;0.0;0.0;0.0
8756_4.txt;19;0;0;19;256;0.07;0.0;0.0
11960_1.txt;9;0;0;9;333;0.03;0.0;0.0
5293_1.txt;5;0;0;5;243;0.02;0.0;0.0
10204_2.txt;0;0;0;0;182;0.0;0.0;0.0
12418_4.txt;2;5;0;7;651;0.0;0.01;0.0
9711_4.txt;2;18;5;25;477;0.0;0.04;0.01
1731_3.txt;0;1;2;3;195;0.0;0.01;0.01
1684_1.txt;30;8;2;40;751;0.04;0.01;0.0
2301_3.txt;2;0;0;2;146;0.01;0.0;0.0
7025_1.txt;2;0;0;2;424;0.0;0.0;0.0
2893_2.txt;10;0;0;10;216;0.05;0.0;0.0
3659_3.txt;12;1;0;13;474;0.03;0.0;0.0
10063_1.txt;1;0;0;1;144;0.01;0.0;0.0
2660_1.txt;0;0;0;0;159;0.0;0.0;0.0
10857_1.txt;0;1;0;1;172;0.0;0.01;0.0
8117_2.txt;3;0;0;3;112;0.03;0.0;0.0
9561_2.txt;0;0;0;0;331;0.0;0.0;0.0
9769_2.txt;4;0;0;4;209;0.02;0.0;0.0
1184_3.txt;0;0;0;0;154;0.0;0.0;0.0
9365_1.txt;32;3;0;35;782;0.04;0.0;0.0
6595_2.txt;7;0;0;7;274;0.03;0.0;0.0
1995_1.txt;7;2;0;9;177;0.04;0.01;0.0
2092_3.txt;8;4;1;13;219;0.04;0.02;0.0
10512_1.txt;7;0;2;9;150;0.05;0.0;0.01
8714_1.txt;2;0;0;2;191;0.01;0.0;0.0
9397_3.txt;13;3;0;16;808;0.02;0.0;0.0
4756_3.txt;6;0;0;6;158;0.04;0.0;0.0
3285_1.txt;4;0;0;4;234;0.02;0.0;0.0
9018_3.txt;0;0;0;0;213;0.0;0.0;0.0
2331_1.txt;0;0;0;0;12;0.0;0.0;0.0
10000_4.txt;32;3;3;38;871;0.04;0.0;0.0
10570_1.txt;0;0;1;1;62;0.0;0.0;0.02
11731_4.txt;12;0;1;13;200;0.06;0.0;0.01
10770_1.txt;0;0;3;3;204;0.0;0.0;0.01
10832_2.txt;3;0;0;3;163;0.02;0.0;0.0
1241_1.txt;5;0;0;5;80;0.06;0.0;0.0
2878_1.txt;0;0;0;0;144;0.0;0.0;0.0
6936_2.txt;0;0;0;0;114;0.0;0.0;0.0
6772_4.txt;23;0;2;25;502;0.05;0.0;0.0
346_1.txt;4;0;0;4;64;0.06;0.0;0.0
11401_1.txt;2;0;0;2;208;0.01;0.0;0.0
7056_4.txt;2;0;0;2;185;0.01;0.0;0.0
67_2.txt;3;0;0;3;232;0.01;0.0;0.0
8970_3.txt;4;0;0;4;408;0.01;0.0;0.0
10303_1.txt;14;0;0;14;295;0.05;0.0;0.0
8119_3.txt;0;0;0;0;239;0.0;0.0;0.0
9689_3.txt;7;3;0;10;114;0.06;0.03;0.0
9108_1.txt;0;0;0;0;179;0.0;0.0;0.0
10690_2.txt;0;0;0;0;176;0.0;0.0;0.0
8506_1.txt;0;0;0;0;166;0.0;0.0;0.0
6767_4.txt;7;0;0;7;153;0.05;0.0;0.0
8787_4.txt;2;0;0;2;167;0.01;0.0;0.0
998_2.txt;4;1;0;5;387;0.01;0.0;0.0
11461_1.txt;0;0;0;0;206;0.0;0.0;0.0
9477_3.txt;7;1;1;9;133;0.05;0.01;0.01
10823_1.txt;39;4;1;44;437;0.09;0.01;0.0
4575_1.txt;0;0;0;0;352;0.0;0.0;0.0
12409_1.txt;0;0;0;0;114;0.0;0.0;0.0
11545_4.txt;19;3;0;22;212;0.09;0.01;0.0
1874_1.txt;17;0;0;17;419;0.04;0.0;0.0
4691_2.txt;4;0;0;4;143;0.03;0.0;0.0
11688_1.txt;16;1;1;18;517;0.03;0.0;0.0
5227_1.txt;2;0;2;4;285;0.01;0.0;0.01
5319_1.txt;0;0;1;1;92;0.0;0.0;0.01
6353_1.txt;8;0;0;8;148;0.05;0.0;0.0
3321_4.txt;0;1;0;1;314;0.0;0.0;0.0
2173_1.txt;0;0;0;0;500;0.0;0.0;0.0
5692_4.txt;3;1;0;4;126;0.02;0.01;0.0
3807_4.txt;10;4;3;17;287;0.03;0.01;0.01
5142_3.txt;11;0;0;11;166;0.07;0.0;0.0
3392_4.txt;0;1;0;1;179;0.0;0.01;0.0
11046_1.txt;2;2;0;4;183;0.01;0.01;0.0
4120_1.txt;11;1;0;12;129;0.09;0.01;0.0
2675_1.txt;0;0;0;0;56;0.0;0.0;0.0
7247_4.txt;11;3;0;14;328;0.03;0.01;0.0
12183_4.txt;3;3;0;6;158;0.02;0.02;0.0
11273_1.txt;2;0;0;2;103;0.02;0.0;0.0
1602_2.txt;3;0;2;5;173;0.02;0.0;0.01
5035_4.txt;19;0;4;23;317;0.06;0.0;0.01
10404_4.txt;0;0;0;0;129;0.0;0.0;0.0
5365_3.txt;2;0;0;2;244;0.01;0.0;0.0
7821_1.txt;7;1;0;8;192;0.04;0.01;0.0
6759_4.txt;5;0;0;5;220;0.02;0.0;0.0
973_4.txt;4;0;0;4;116;0.03;0.0;0.0
5307_3.txt;15;0;0;15;371;0.04;0.0;0.0
2169_2.txt;9;0;0;9;166;0.05;0.0;0.0
3146_4.txt;0;0;0;0;180;0.0;0.0;0.0
8929_2.txt;16;0;2;18;180;0.09;0.0;0.01
12461_1.txt;0;1;0;1;231;0.0;0.0;0.0
1804_2.txt;17;2;1;20;782;0.02;0.0;0.0
2290_4.txt;8;3;0;11;525;0.02;0.01;0.0
4425_2.txt;0;0;0;0;220;0.0;0.0;0.0
2923_4.txt;2;2;0;4;131;0.02;0.02;0.0
2783_1.txt;0;0;0;0;281;0.0;0.0;0.0
4039_2.txt;4;0;0;4;578;0.01;0.0;0.0
1486_4.txt;11;0;0;11;142;0.08;0.0;0.0
12264_1.txt;0;0;0;0;90;0.0;0.0;0.0
9290_4.txt;14;1;5;20;406;0.03;0.0;0.01
9869_3.txt;2;4;0;6;214;0.01;0.02;0.0
3717_3.txt;12;1;0;13;191;0.06;0.01;0.0
5344_3.txt;20;0;4;24;205;0.1;0.0;0.02
1717_3.txt;4;1;0;5;125;0.03;0.01;0.0
8074_4.txt;18;0;3;21;392;0.05;0.0;0.01
3288_1.txt;23;2;3;28;983;0.02;0.0;0.0
8449_4.txt;0;1;0;1;151;0.0;0.01;0.0
11035_4.txt;6;0;0;6;277;0.02;0.0;0.0
9152_1.txt;13;0;7;20;753;0.02;0.0;0.01
79_4.txt;1;0;0;1;164;0.01;0.0;0.0
9014_1.txt;1;0;0;1;121;0.01;0.0;0.0
7881_2.txt;7;0;0;7;488;0.01;0.0;0.0
1066_2.txt;23;9;2;34;488;0.05;0.02;0.0
8816_4.txt;0;0;2;2;141;0.0;0.0;0.01
8058_1.txt;7;0;2;9;241;0.03;0.0;0.01
5347_2.txt;37;6;0;43;943;0.04;0.01;0.0
6501_1.txt;0;0;0;0;153;0.0;0.0;0.0
3746_1.txt;6;0;5;11;407;0.01;0.0;0.01
7568_4.txt;7;0;0;7;326;0.02;0.0;0.0
6237_4.txt;12;2;0;14;301;0.04;0.01;0.0
8710_1.txt;2;1;0;3;200;0.01;0.01;0.0
10787_1.txt;8;0;2;10;184;0.04;0.0;0.01
3950_1.txt;3;0;5;8;184;0.02;0.0;0.03
5102_3.txt;12;0;2;14;165;0.07;0.0;0.01
11512_1.txt;17;1;1;19;489;0.03;0.0;0.0
204_4.txt;8;3;0;11;241;0.03;0.01;0.0
3531_1.txt;13;0;0;13;233;0.06;0.0;0.0
2118_1.txt;8;2;0;10;146;0.05;0.01;0.0
5265_1.txt;0;0;0;0;61;0.0;0.0;0.0
4113_1.txt;0;0;0;0;145;0.0;0.0;0.0
7735_1.txt;55;7;0;62;703;0.08;0.01;0.0
613_3.txt;0;0;0;0;171;0.0;0.0;0.0
1845_4.txt;18;0;0;18;302;0.06;0.0;0.0
10015_2.txt;3;0;2;5;101;0.03;0.0;0.02
8729_2.txt;5;3;1;9;202;0.02;0.01;0.0
8691_1.txt;1;2;0;3;144;0.01;0.01;0.0
7743_4.txt;10;2;4;16;169;0.06;0.01;0.02
4998_3.txt;5;0;0;5;146;0.03;0.0;0.0
11977_2.txt;23;1;0;24;165;0.14;0.01;0.0
5208_4.txt;8;0;0;8;206;0.04;0.0;0.0
1893_1.txt;2;0;0;2;95;0.02;0.0;0.0
7400_1.txt;1;0;0;1;165;0.01;0.0;0.0
5414_2.txt;12;0;0;12;159;0.08;0.0;0.0
3528_2.txt;3;0;3;6;142;0.02;0.0;0.02
4317_1.txt;2;0;0;2;149;0.01;0.0;0.0
9061_4.txt;1;0;0;1;151;0.01;0.0;0.0
4947_2.txt;5;2;2;9;477;0.01;0.0;0.0
324_1.txt;4;0;3;7;169;0.02;0.0;0.02
10866_1.txt;0;0;0;0;274;0.0;0.0;0.0
5929_2.txt;12;0;0;12;295;0.04;0.0;0.0
1553_3.txt;0;2;0;2;71;0.0;0.03;0.0
6722_2.txt;10;1;0;11;144;0.07;0.01;0.0
477_4.txt;6;1;3;10;171;0.04;0.01;0.02
11495_2.txt;4;0;0;4;133;0.03;0.0;0.0
10593_4.txt;20;1;0;21;513;0.04;0.0;0.0
11374_2.txt;0;0;0;0;139;0.0;0.0;0.0
12464_2.txt;4;1;0;5;129;0.03;0.01;0.0
9692_2.txt;13;1;0;14;316;0.04;0.0;0.0
3034_4.txt;4;0;0;4;143;0.03;0.0;0.0
5465_1.txt;2;1;3;6;247;0.01;0.0;0.01
6807_1.txt;17;3;3;23;833;0.02;0.0;0.0
11513_3.txt;14;1;0;15;399;0.04;0.0;0.0
2585_2.txt;0;0;0;0;120;0.0;0.0;0.0
4625_2.txt;0;0;0;0;116;0.0;0.0;0.0
8260_4.txt;1;0;0;1;224;0.0;0.0;0.0
11095_1.txt;2;0;0;2;53;0.04;0.0;0.0
12101_4.txt;6;2;1;9;456;0.01;0.0;0.0
4323_4.txt;8;2;2;12;149;0.05;0.01;0.01
10725_1.txt;0;2;0;2;163;0.0;0.01;0.0
8245_1.txt;0;0;0;0;214;0.0;0.0;0.0
7778_1.txt;4;1;0;5;137;0.03;0.01;0.0
9235_4.txt;4;0;0;4;74;0.05;0.0;0.0
10921_3.txt;1;0;0;1;259;0.0;0.0;0.0
7972_1.txt;0;0;0;0;188;0.0;0.0;0.0
4741_3.txt;10;0;1;11;142;0.07;0.0;0.01
3104_2.txt;9;0;0;9;208;0.04;0.0;0.0
11963_3.txt;9;1;0;10;216;0.04;0.0;0.0
5792_1.txt;2;3;2;7;209;0.01;0.01;0.01
1273_3.txt;5;0;0;5;187;0.03;0.0;0.0
8312_4.txt;1;0;0;1;295;0.0;0.0;0.0
4551_1.txt;2;2;0;4;405;0.0;0.0;0.0
2837_1.txt;8;0;0;8;123;0.07;0.0;0.0
87_4.txt;1;0;0;1;156;0.01;0.0;0.0
7873_1.txt;2;0;0;2;334;0.01;0.0;0.0
5471_3.txt;6;1;0;7;367;0.02;0.0;0.0
12179_2.txt;5;0;0;5;158;0.03;0.0;0.0
4893_1.txt;0;0;0;0;245;0.0;0.0;0.0
6625_1.txt;2;0;0;2;168;0.01;0.0;0.0
516_2.txt;18;0;3;21;280;0.06;0.0;0.01
5750_1.txt;0;0;0;0;348;0.0;0.0;0.0
8696_1.txt;12;5;0;17;361;0.03;0.01;0.0
705_2.txt;20;0;0;20;308;0.06;0.0;0.0
11686_1.txt;10;2;2;14;462;0.02;0.0;0.0
7311_2.txt;5;0;2;7;350;0.01;0.0;0.01
4106_4.txt;11;2;0;13;228;0.05;0.01;0.0
11057_3.txt;19;0;4;23;789;0.02;0.0;0.01
5160_1.txt;5;1;0;6;573;0.01;0.0;0.0
1040_1.txt;0;0;0;0;126;0.0;0.0;0.0
1665_3.txt;4;0;0;4;143;0.03;0.0;0.0
7784_1.txt;5;1;0;6;214;0.02;0.0;0.0
7846_2.txt;4;1;4;9;330;0.01;0.0;0.01
2547_1.txt;7;2;1;10;176;0.04;0.01;0.01
1839_1.txt;4;0;0;4;146;0.03;0.0;0.0
1482_1.txt;0;0;0;0;187;0.0;0.0;0.0
2824_2.txt;3;1;1;5;144;0.02;0.01;0.01
7249_1.txt;2;0;0;2;190;0.01;0.0;0.0
5925_3.txt;6;0;0;6;297;0.02;0.0;0.0
11197_1.txt;5;0;0;5;418;0.01;0.0;0.0
8946_1.txt;2;0;0;2;152;0.01;0.0;0.0
8773_1.txt;0;0;0;0;232;0.0;0.0;0.0
8788_3.txt;2;0;3;5;346;0.01;0.0;0.01
7581_2.txt;4;1;0;5;377;0.01;0.0;0.0
4363_1.txt;2;0;0;2;145;0.01;0.0;0.0
1508_1.txt;2;0;0;2;144;0.01;0.0;0.0
12033_3.txt;5;0;0;5;139;0.04;0.0;0.0
10669_2.txt;2;0;0;2;139;0.01;0.0;0.0
5447_4.txt;11;4;0;15;182;0.06;0.02;0.0
8480_3.txt;2;1;0;3;240;0.01;0.0;0.0
3319_4.txt;8;0;0;8;171;0.05;0.0;0.0
8937_1.txt;0;0;0;0;264;0.0;0.0;0.0
5525_4.txt;3;0;0;3;280;0.01;0.0;0.0
3580_4.txt;27;1;1;29;528;0.05;0.0;0.0
7377_3.txt;4;0;0;4;196;0.02;0.0;0.0
8533_2.txt;24;3;0;27;572;0.04;0.01;0.0
11532_3.txt;6;4;3;13;442;0.01;0.01;0.01
453_3.txt;6;7;0;13;215;0.03;0.03;0.0
3702_1.txt;0;0;0;0;55;0.0;0.0;0.0
11976_1.txt;1;0;3;4;258;0.0;0.0;0.01
10802_1.txt;7;1;1;9;230;0.03;0.0;0.0
9151_1.txt;10;0;3;13;864;0.01;0.0;0.0
8064_2.txt;0;0;0;0;70;0.0;0.0;0.0
8030_3.txt;2;0;0;2;149;0.01;0.0;0.0
3176_4.txt;30;2;1;33;173;0.17;0.01;0.01
6240_4.txt;2;0;2;4;231;0.01;0.0;0.01
7160_1.txt;6;0;0;6;705;0.01;0.0;0.0
4804_2.txt;0;0;0;0;189;0.0;0.0;0.0
262_4.txt;17;0;0;17;134;0.13;0.0;0.0
1984_1.txt;12;0;0;12;184;0.07;0.0;0.0
4298_1.txt;2;0;0;2;112;0.02;0.0;0.0
3268_1.txt;3;0;0;3;162;0.02;0.0;0.0
6958_1.txt;0;0;0;0;57;0.0;0.0;0.0
4474_1.txt;1;0;0;1;104;0.01;0.0;0.0
10375_1.txt;0;0;0;0;50;0.0;0.0;0.0
5399_1.txt;18;2;5;25;464;0.04;0.0;0.01
9371_4.txt;27;2;0;29;541;0.05;0.0;0.0
8763_2.txt;9;0;0;9;222;0.04;0.0;0.0
10205_2.txt;9;0;0;9;219;0.04;0.0;0.0
11926_1.txt;0;0;0;0;199;0.0;0.0;0.0
2674_2.txt;2;0;0;2;183;0.01;0.0;0.0
3042_1.txt;0;1;0;1;183;0.0;0.01;0.0
4325_4.txt;7;3;2;12;212;0.03;0.01;0.01
5646_1.txt;1;0;0;1;162;0.01;0.0;0.0
1266_1.txt;11;0;1;12;223;0.05;0.0;0.0
2689_1.txt;6;0;0;6;161;0.04;0.0;0.0
12147_1.txt;1;3;0;4;185;0.01;0.02;0.0
2039_2.txt;4;0;1;5;247;0.02;0.0;0.0
7366_3.txt;7;0;0;7;402;0.02;0.0;0.0
9122_1.txt;2;0;0;2;26;0.08;0.0;0.0
3851_1.txt;9;0;3;12;231;0.04;0.0;0.01
5243_4.txt;32;0;0;32;181;0.18;0.0;0.0
5320_2.txt;4;1;0;5;146;0.03;0.01;0.0
8598_1.txt;0;0;0;0;75;0.0;0.0;0.0
9707_3.txt;2;0;1;3;172;0.01;0.0;0.01
10378_2.txt;8;0;2;10;452;0.02;0.0;0.0
496_1.txt;0;0;0;0;86;0.0;0.0;0.0
10533_4.txt;31;0;0;31;366;0.08;0.0;0.0
11729_3.txt;3;0;0;3;140;0.02;0.0;0.0
5134_4.txt;13;4;0;17;134;0.1;0.03;0.0
9236_1.txt;11;0;0;11;182;0.06;0.0;0.0
7102_2.txt;0;0;0;0;336;0.0;0.0;0.0
6549_1.txt;0;0;0;0;149;0.0;0.0;0.0
1352_1.txt;3;1;0;4;285;0.01;0.0;0.0
11238_1.txt;0;0;0;0;100;0.0;0.0;0.0
7088_1.txt;2;0;0;2;95;0.02;0.0;0.0
8150_2.txt;1;0;1;2;215;0.0;0.0;0.0
5109_1.txt;3;0;1;4;256;0.01;0.0;0.0
4316_1.txt;24;0;0;24;617;0.04;0.0;0.0
11385_2.txt;1;2;0;3;537;0.0;0.0;0.0
3900_4.txt;11;3;0;14;314;0.04;0.01;0.0
6899_1.txt;0;4;2;6;143;0.0;0.03;0.01
9044_3.txt;3;0;7;10;348;0.01;0.0;0.02
513_1.txt;5;0;2;7;157;0.03;0.0;0.01
4422_4.txt;13;0;0;13;190;0.07;0.0;0.0
4668_1.txt;5;4;0;9;209;0.02;0.02;0.0
10181_3.txt;7;0;3;10;225;0.03;0.0;0.01
9951_4.txt;9;0;0;9;375;0.02;0.0;0.0
11870_1.txt;0;0;0;0;195;0.0;0.0;0.0
12228_1.txt;13;3;0;16;956;0.01;0.0;0.0
6872_2.txt;0;0;1;1;115;0.0;0.0;0.01
9673_1.txt;1;0;0;1;232;0.0;0.0;0.0
283_1.txt;0;0;0;0;164;0.0;0.0;0.0
8137_4.txt;2;0;0;2;220;0.01;0.0;0.0
5793_1.txt;7;1;0;8;245;0.03;0.0;0.0
9159_1.txt;0;1;1;2;125;0.0;0.01;0.01
63_1.txt;2;0;0;2;145;0.01;0.0;0.0
10036_1.txt;10;3;0;13;221;0.05;0.01;0.0
10485_1.txt;10;1;1;12;167;0.06;0.01;0.01
4666_2.txt;0;6;0;6;130;0.0;0.05;0.0
10009_1.txt;13;4;0;17;389;0.03;0.01;0.0
5166_1.txt;0;0;0;0;168;0.0;0.0;0.0
5305_4.txt;23;0;0;23;1115;0.02;0.0;0.0
8186_2.txt;8;0;0;8;141;0.06;0.0;0.0
5126_2.txt;1;0;0;1;138;0.01;0.0;0.0
1090_1.txt;3;0;0;3;151;0.02;0.0;0.0
9549_1.txt;3;2;0;5;144;0.02;0.01;0.0
12341_4.txt;1;3;0;4;304;0.0;0.01;0.0
1419_1.txt;2;0;0;2;203;0.01;0.0;0.0
1347_1.txt;13;0;0;13;687;0.02;0.0;0.0
2213_1.txt;8;6;0;14;490;0.02;0.01;0.0
5422_4.txt;5;0;0;5;312;0.02;0.0;0.0
1224_1.txt;0;0;0;0;149;0.0;0.0;0.0
9210_1.txt;0;0;0;0;81;0.0;0.0;0.0
4664_3.txt;1;1;0;2;134;0.01;0.01;0.0
1939_1.txt;0;1;0;1;132;0.0;0.01;0.0
6808_1.txt;0;0;3;3;589;0.0;0.0;0.01
2533_4.txt;2;0;0;2;193;0.01;0.0;0.0
11261_4.txt;4;0;0;4;167;0.02;0.0;0.0
10426_1.txt;2;0;0;2;61;0.03;0.0;0.0
7729_4.txt;5;2;0;7;290;0.02;0.01;0.0
8011_1.txt;5;1;0;6;220;0.02;0.0;0.0
5418_4.txt;20;2;0;22;352;0.06;0.01;0.0
4207_4.txt;22;6;0;28;732;0.03;0.01;0.0
7769_3.txt;6;0;2;8;353;0.02;0.0;0.01
4972_3.txt;0;1;0;1;162;0.0;0.01;0.0
10839_2.txt;0;0;0;0;170;0.0;0.0;0.0
3773_1.txt;3;0;3;6;239;0.01;0.0;0.01
1473_4.txt;31;0;0;31;410;0.08;0.0;0.0
7367_1.txt;3;0;0;3;288;0.01;0.0;0.0
3881_2.txt;6;0;1;7;808;0.01;0.0;0.0
3584_4.txt;19;0;4;23;299;0.06;0.0;0.01
6009_2.txt;2;0;0;2;136;0.01;0.0;0.0
565_4.txt;4;0;0;4;313;0.01;0.0;0.0
6305_2.txt;2;2;2;6;157;0.01;0.01;0.01
1495_1.txt;1;0;0;1;193;0.01;0.0;0.0
5858_1.txt;19;1;12;32;468;0.04;0.0;0.03
163_4.txt;1;0;1;2;71;0.01;0.0;0.01
11465_1.txt;9;0;0;9;260;0.03;0.0;0.0
1615_2.txt;12;8;3;23;376;0.03;0.02;0.01
4918_2.txt;11;0;2;13;114;0.1;0.0;0.02
2983_2.txt;28;1;7;36;1086;0.03;0.0;0.01
10611_1.txt;3;1;0;4;216;0.01;0.0;0.0
4022_1.txt;8;1;0;9;189;0.04;0.01;0.0
91_1.txt;0;0;1;1;174;0.0;0.0;0.01
7463_1.txt;2;0;0;2;89;0.02;0.0;0.0
4126_4.txt;3;0;0;3;151;0.02;0.0;0.0
8194_4.txt;7;1;0;8;188;0.04;0.01;0.0
9327_1.txt;0;0;0;0;163;0.0;0.0;0.0
11214_3.txt;1;0;0;1;197;0.01;0.0;0.0
4802_1.txt;8;0;0;8;165;0.05;0.0;0.0
69_4.txt;6;0;0;6;137;0.04;0.0;0.0
2466_3.txt;6;0;0;6;499;0.01;0.0;0.0
7956_1.txt;3;0;0;3;184;0.02;0.0;0.0
2886_1.txt;0;0;0;0;155;0.0;0.0;0.0
3340_1.txt;1;0;0;1;246;0.0;0.0;0.0
2270_1.txt;0;0;0;0;125;0.0;0.0;0.0
9843_1.txt;13;0;2;15;177;0.07;0.0;0.01
1348_3.txt;2;0;0;2;145;0.01;0.0;0.0
4850_1.txt;0;1;2;3;179;0.0;0.01;0.01
5687_1.txt;5;0;0;5;110;0.05;0.0;0.0
11378_1.txt;1;2;0;3;190;0.01;0.01;0.0
10694_1.txt;3;0;0;3;48;0.06;0.0;0.0
8605_4.txt;0;0;0;0;150;0.0;0.0;0.0
7485_4.txt;10;4;0;14;214;0.05;0.02;0.0
1069_3.txt;10;2;1;13;142;0.07;0.01;0.01
3264_1.txt;6;1;0;7;72;0.08;0.01;0.0
11173_4.txt;2;0;0;2;118;0.02;0.0;0.0
2287_4.txt;8;0;2;10;138;0.06;0.0;0.01
5351_2.txt;5;0;2;7;153;0.03;0.0;0.01
9125_2.txt;6;0;0;6;309;0.02;0.0;0.0
1710_2.txt;11;0;0;11;521;0.02;0.0;0.0
1089_1.txt;3;0;0;3;74;0.04;0.0;0.0
9568_2.txt;0;0;0;0;53;0.0;0.0;0.0
10652_2.txt;4;1;0;5;336;0.01;0.0;0.0
386_4.txt;36;8;0;44;478;0.08;0.02;0.0
6742_4.txt;15;1;0;16;237;0.06;0.0;0.0
1416_1.txt;0;0;0;0;154;0.0;0.0;0.0
8154_3.txt;4;0;0;4;159;0.03;0.0;0.0
408_2.txt;2;0;0;2;53;0.04;0.0;0.0
2594_3.txt;0;0;0;0;157;0.0;0.0;0.0
1004_4.txt;53;0;3;56;304;0.17;0.0;0.01
8530_1.txt;27;1;4;32;505;0.05;0.0;0.01
10681_1.txt;4;2;0;6;186;0.02;0.01;0.0
518_3.txt;10;11;0;21;218;0.05;0.05;0.0
1408_2.txt;9;0;0;9;204;0.04;0.0;0.0
11090_1.txt;2;1;1;4;74;0.03;0.01;0.01
9863_2.txt;4;0;1;5;171;0.02;0.0;0.01
6672_1.txt;0;0;0;0;181;0.0;0.0;0.0
4905_1.txt;3;0;0;3;182;0.02;0.0;0.0
9971_1.txt;8;0;2;10;507;0.02;0.0;0.0
971_3.txt;0;0;0;0;275;0.0;0.0;0.0
7297_2.txt;2;0;0;2;271;0.01;0.0;0.0
1388_2.txt;0;0;0;0;82;0.0;0.0;0.0
3008_3.txt;0;0;0;0;114;0.0;0.0;0.0
3971_1.txt;0;0;0;0;167;0.0;0.0;0.0
11222_3.txt;8;0;0;8;180;0.04;0.0;0.0
7610_3.txt;10;0;0;10;176;0.06;0.0;0.0
6583_4.txt;5;0;0;5;138;0.04;0.0;0.0
137_4.txt;4;0;2;6;460;0.01;0.0;0.0
9776_3.txt;0;5;1;6;376;0.0;0.01;0.0
5464_2.txt;0;0;0;0;44;0.0;0.0;0.0
10675_2.txt;3;2;0;5;145;0.02;0.01;0.0
9566_1.txt;0;0;0;0;180;0.0;0.0;0.0
9616_1.txt;0;0;0;0;140;0.0;0.0;0.0
11351_1.txt;2;0;1;3;260;0.01;0.0;0.0
2676_1.txt;0;0;0;0;93;0.0;0.0;0.0
10229_3.txt;2;2;0;4;137;0.01;0.01;0.0
6752_3.txt;2;0;0;2;218;0.01;0.0;0.0
7217_1.txt;0;0;0;0;213;0.0;0.0;0.0
10726_1.txt;1;0;0;1;200;0.01;0.0;0.0
12077_1.txt;0;0;0;0;13;0.0;0.0;0.0
927_1.txt;8;0;0;8;192;0.04;0.0;0.0
10470_1.txt;1;0;1;2;167;0.01;0.0;0.01
7296_1.txt;6;0;0;6;125;0.05;0.0;0.0
7060_1.txt;0;0;0;0;141;0.0;0.0;0.0
8850_4.txt;9;1;2;12;193;0.05;0.01;0.01
10297_3.txt;9;0;1;10;1084;0.01;0.0;0.0
10254_1.txt;8;1;0;9;591;0.01;0.0;0.0
2097_4.txt;0;3;0;3;226;0.0;0.01;0.0
9954_1.txt;4;0;0;4;110;0.04;0.0;0.0
7264_1.txt;2;0;0;2;122;0.02;0.0;0.0
7443_4.txt;0;0;0;0;167;0.0;0.0;0.0
9219_2.txt;16;1;0;17;465;0.03;0.0;0.0
6114_1.txt;6;0;0;6;383;0.02;0.0;0.0
7138_1.txt;0;0;0;0;208;0.0;0.0;0.0
10640_3.txt;9;0;0;9;441;0.02;0.0;0.0
10806_1.txt;4;0;0;4;84;0.05;0.0;0.0
11633_1.txt;2;0;0;2;139;0.01;0.0;0.0
4084_1.txt;5;1;0;6;288;0.02;0.0;0.0
3217_4.txt;4;0;0;4;315;0.01;0.0;0.0
696_4.txt;0;0;0;0;235;0.0;0.0;0.0
10822_1.txt;7;0;0;7;169;0.04;0.0;0.0
2803_2.txt;1;0;1;2;341;0.0;0.0;0.0
11778_3.txt;43;6;5;54;1009;0.04;0.01;0.0
7941_2.txt;13;0;0;13;311;0.04;0.0;0.0
3193_2.txt;3;0;0;3;63;0.05;0.0;0.0
1780_1.txt;3;0;0;3;174;0.02;0.0;0.0
3940_1.txt;2;0;0;2;173;0.01;0.0;0.0
1857_4.txt;25;1;0;26;665;0.04;0.0;0.0
5051_1.txt;4;6;6;16;279;0.01;0.02;0.02
6157_2.txt;3;0;0;3;139;0.02;0.0;0.0
9528_2.txt;1;0;0;1;182;0.01;0.0;0.0
8505_3.txt;3;0;0;3;151;0.02;0.0;0.0
8023_3.txt;3;1;0;4;297;0.01;0.0;0.0
4809_3.txt;10;6;0;16;480;0.02;0.01;0.0
3505_1.txt;18;0;0;18;402;0.04;0.0;0.0
3750_3.txt;3;2;0;5;178;0.02;0.01;0.0
8786_1.txt;10;0;4;14;497;0.02;0.0;0.01
10048_4.txt;14;1;0;15;752;0.02;0.0;0.0
9168_4.txt;39;4;3;46;373;0.1;0.01;0.01
12242_3.txt;15;4;0;19;400;0.04;0.01;0.0
6246_1.txt;4;0;0;4;188;0.02;0.0;0.0
1927_2.txt;32;5;0;37;809;0.04;0.01;0.0
7178_1.txt;0;0;0;0;137;0.0;0.0;0.0
8258_2.txt;6;3;2;11;198;0.03;0.02;0.01
10558_4.txt;5;0;0;5;215;0.02;0.0;0.0
11251_2.txt;27;5;1;33;544;0.05;0.01;0.0
1641_1.txt;0;0;0;0;150;0.0;0.0;0.0
1560_2.txt;2;0;0;2;121;0.02;0.0;0.0
4727_4.txt;15;0;1;16;413;0.04;0.0;0.0
3183_1.txt;6;1;0;7;136;0.04;0.01;0.0
10588_1.txt;2;0;0;2;53;0.04;0.0;0.0
2467_4.txt;0;0;0;0;361;0.0;0.0;0.0
6992_1.txt;3;0;0;3;178;0.02;0.0;0.0
3655_2.txt;16;3;0;19;390;0.04;0.01;0.0
9664_1.txt;4;0;0;4;140;0.03;0.0;0.0
10760_1.txt;2;0;0;2;469;0.0;0.0;0.0
11765_4.txt;6;0;0;6;137;0.04;0.0;0.0
1978_1.txt;0;0;0;0;154;0.0;0.0;0.0
3771_1.txt;0;0;0;0;156;0.0;0.0;0.0
2427_2.txt;6;0;1;7;292;0.02;0.0;0.0
8401_3.txt;3;0;1;4;208;0.01;0.0;0.0
11158_1.txt;8;0;0;8;146;0.05;0.0;0.0
7355_4.txt;9;0;0;9;192;0.05;0.0;0.0
3643_1.txt;5;0;1;6;477;0.01;0.0;0.0
3995_1.txt;10;7;0;17;416;0.02;0.02;0.0
11240_4.txt;9;3;0;12;305;0.03;0.01;0.0
7149_1.txt;4;0;0;4;150;0.03;0.0;0.0
2668_1.txt;0;0;0;0;108;0.0;0.0;0.0
3141_2.txt;7;0;0;7;349;0.02;0.0;0.0
4907_3.txt;1;0;0;1;414;0.0;0.0;0.0
2830_3.txt;16;2;7;25;242;0.07;0.01;0.03
5927_4.txt;12;2;6;20;363;0.03;0.01;0.02
11596_3.txt;13;0;0;13;316;0.04;0.0;0.0
3845_4.txt;11;0;0;11;208;0.05;0.0;0.0
10125_1.txt;33;4;0;37;651;0.05;0.01;0.0
4529_4.txt;2;0;3;5;149;0.01;0.0;0.02
11992_4.txt;16;1;2;19;622;0.03;0.0;0.0
3549_3.txt;0;0;0;0;168;0.0;0.0;0.0
11905_3.txt;8;4;3;15;220;0.04;0.02;0.01
11801_3.txt;11;1;0;12;168;0.07;0.01;0.0
4076_1.txt;1;0;0;1;222;0.0;0.0;0.0
1421_4.txt;11;0;0;11;953;0.01;0.0;0.0
2141_2.txt;0;0;0;0;134;0.0;0.0;0.0
8379_1.txt;0;0;0;0;282;0.0;0.0;0.0
9459_1.txt;10;1;0;11;149;0.07;0.01;0.0
5258_1.txt;0;0;0;0;145;0.0;0.0;0.0
6369_3.txt;13;0;2;15;178;0.07;0.0;0.01
9100_1.txt;4;1;0;5;352;0.01;0.0;0.0
9661_4.txt;0;0;0;0;152;0.0;0.0;0.0
12397_4.txt;2;0;0;2;173;0.01;0.0;0.0
7836_3.txt;4;0;0;4;217;0.02;0.0;0.0
6270_1.txt;4;0;0;4;349;0.01;0.0;0.0
11695_1.txt;5;0;0;5;288;0.02;0.0;0.0
2000_3.txt;2;0;0;2;128;0.02;0.0;0.0
9383_3.txt;0;0;0;0;179;0.0;0.0;0.0
890_2.txt;16;6;8;30;508;0.03;0.01;0.02
5995_1.txt;8;0;1;9;208;0.04;0.0;0.0
5754_2.txt;0;1;5;6;157;0.0;0.01;0.03
4292_3.txt;7;0;0;7;184;0.04;0.0;0.0
1728_3.txt;2;6;0;8;658;0.0;0.01;0.0
6642_1.txt;0;1;0;1;132;0.0;0.01;0.0
1386_3.txt;4;0;0;4;60;0.07;0.0;0.0
10845_3.txt;0;0;0;0;195;0.0;0.0;0.0
3315_1.txt;7;2;0;9;354;0.02;0.01;0.0
2027_4.txt;0;1;1;2;302;0.0;0.0;0.0
5168_1.txt;1;0;2;3;376;0.0;0.0;0.01
10897_1.txt;2;0;0;2;162;0.01;0.0;0.0
12473_1.txt;0;0;0;0;137;0.0;0.0;0.0
9279_1.txt;0;2;0;2;148;0.0;0.01;0.0
2907_4.txt;10;1;2;13;247;0.04;0.0;0.01
6089_4.txt;4;0;1;5;572;0.01;0.0;0.0
333_3.txt;4;0;0;4;317;0.01;0.0;0.0
11705_3.txt;3;0;0;3;73;0.04;0.0;0.0
12273_2.txt;25;1;0;26;353;0.07;0.0;0.0
2939_2.txt;10;3;0;13;221;0.05;0.01;0.0
8755_2.txt;10;0;0;10;165;0.06;0.0;0.0
1640_1.txt;2;0;0;2;97;0.02;0.0;0.0
10080_2.txt;0;0;0;0;146;0.0;0.0;0.0
12144_2.txt;2;0;0;2;246;0.01;0.0;0.0
6954_2.txt;0;0;0;0;473;0.0;0.0;0.0
722_4.txt;13;0;0;13;235;0.06;0.0;0.0
3213_1.txt;2;2;1;5;854;0.0;0.0;0.0
1126_3.txt;2;0;0;2;99;0.02;0.0;0.0
5559_1.txt;3;0;1;4;134;0.02;0.0;0.01
670_1.txt;3;1;0;4;352;0.01;0.0;0.0
5724_2.txt;0;3;0;3;134;0.0;0.02;0.0
8978_3.txt;6;0;0;6;136;0.04;0.0;0.0
11226_4.txt;10;0;0;10;399;0.03;0.0;0.0
3119_4.txt;9;0;0;9;324;0.03;0.0;0.0
642_1.txt;3;2;0;5;230;0.01;0.01;0.0
10932_1.txt;0;0;0;0;132;0.0;0.0;0.0
3993_3.txt;1;0;0;1;193;0.01;0.0;0.0
11534_4.txt;25;2;0;27;790;0.03;0.0;0.0
10828_1.txt;4;0;0;4;374;0.01;0.0;0.0
10183_1.txt;6;1;0;7;159;0.04;0.01;0.0
12073_3.txt;17;2;0;19;509;0.03;0.0;0.0
10974_2.txt;6;6;0;12;367;0.02;0.02;0.0
8832_2.txt;0;0;0;0;151;0.0;0.0;0.0
12212_3.txt;15;6;2;23;674;0.02;0.01;0.0
5330_1.txt;0;0;3;3;155;0.0;0.0;0.02
6003_2.txt;2;0;0;2;249;0.01;0.0;0.0
9048_3.txt;0;0;1;1;223;0.0;0.0;0.0
6178_3.txt;3;0;0;3;139;0.02;0.0;0.0
3374_1.txt;2;0;0;2;167;0.01;0.0;0.0
10524_4.txt;19;0;0;19;350;0.05;0.0;0.0
206_2.txt;5;0;0;5;157;0.03;0.0;0.0
9370_4.txt;0;0;0;0;135;0.0;0.0;0.0
2071_4.txt;3;3;0;6;154;0.02;0.02;0.0
8144_3.txt;2;0;0;2;135;0.01;0.0;0.0
7606_2.txt;4;2;0;6;398;0.01;0.01;0.0
2394_3.txt;0;0;0;0;144;0.0;0.0;0.0
7970_1.txt;0;0;0;0;175;0.0;0.0;0.0
11418_4.txt;19;1;0;20;100;0.19;0.01;0.0
2697_1.txt;33;2;4;39;600;0.06;0.0;0.01
10128_1.txt;7;0;0;7;377;0.02;0.0;0.0
9224_3.txt;9;2;0;11;425;0.02;0.0;0.0
1445_2.txt;4;4;1;9;209;0.02;0.02;0.0
8980_1.txt;2;2;0;4;138;0.01;0.01;0.0
1999_3.txt;9;0;0;9;152;0.06;0.0;0.0
10104_1.txt;4;0;0;4;340;0.01;0.0;0.0
4296_1.txt;2;0;0;2;214;0.01;0.0;0.0
660_1.txt;2;1;0;3;352;0.01;0.0;0.0
1138_2.txt;1;0;0;1;85;0.01;0.0;0.0
1906_1.txt;2;0;0;2;151;0.01;0.0;0.0
10778_3.txt;2;0;0;2;54;0.04;0.0;0.0
1391_4.txt;13;3;1;17;399;0.03;0.01;0.0
11939_4.txt;0;2;0;2;468;0.0;0.0;0.0
6179_1.txt;6;0;0;6;161;0.04;0.0;0.0
9082_1.txt;2;1;2;5;147;0.01;0.01;0.01
11782_1.txt;0;0;0;0;121;0.0;0.0;0.0
6869_1.txt;10;0;1;11;487;0.02;0.0;0.0
8736_3.txt;8;0;0;8;649;0.01;0.0;0.0
8426_4.txt;12;3;0;15;473;0.03;0.01;0.0
6076_4.txt;19;0;0;19;278;0.07;0.0;0.0
1204_4.txt;6;0;1;7;211;0.03;0.0;0.0
9521_3.txt;8;0;1;9;133;0.06;0.0;0.01
6929_1.txt;1;0;0;1;280;0.0;0.0;0.0
5151_3.txt;0;0;0;0;244;0.0;0.0;0.0
6584_1.txt;2;1;0;3;324;0.01;0.0;0.0
11736_2.txt;2;4;0;6;159;0.01;0.03;0.0
3994_4.txt;18;3;0;21;463;0.04;0.01;0.0
11516_4.txt;34;0;0;34;970;0.04;0.0;0.0
10463_1.txt;1;1;0;2;248;0.0;0.0;0.0
11368_1.txt;0;0;0;0;131;0.0;0.0;0.0
8951_4.txt;16;1;5;22;367;0.04;0.0;0.01
10644_3.txt;11;0;0;11;213;0.05;0.0;0.0
5974_1.txt;0;2;0;2;204;0.0;0.01;0.0
7281_2.txt;21;1;1;23;562;0.04;0.0;0.0
6458_1.txt;45;1;0;46;818;0.06;0.0;0.0
9001_1.txt;0;0;0;0;208;0.0;0.0;0.0
1201_2.txt;2;0;0;2;63;0.03;0.0;0.0
10342_2.txt;12;0;2;14;101;0.12;0.0;0.02
2347_1.txt;2;0;0;2;251;0.01;0.0;0.0
4597_1.txt;15;6;2;23;314;0.05;0.02;0.01
2988_2.txt;2;0;4;6;132;0.02;0.0;0.03
11591_2.txt;10;0;0;10;229;0.04;0.0;0.0
2165_4.txt;11;0;0;11;385;0.03;0.0;0.0
7870_1.txt;0;0;0;0;99;0.0;0.0;0.0
882_4.txt;4;0;0;4;89;0.04;0.0;0.0
6818_3.txt;1;0;0;1;214;0.0;0.0;0.0
9361_1.txt;3;0;0;3;173;0.02;0.0;0.0
7437_1.txt;0;0;0;0;151;0.0;0.0;0.0
8322_1.txt;3;0;0;3;344;0.01;0.0;0.0
11929_2.txt;0;2;0;2;125;0.0;0.02;0.0
11979_4.txt;93;2;22;117;1159;0.08;0.0;0.02
86_4.txt;6;0;0;6;148;0.04;0.0;0.0
11350_1.txt;3;0;1;4;158;0.02;0.0;0.01
6885_1.txt;9;0;0;9;182;0.05;0.0;0.0
1982_1.txt;3;0;0;3;75;0.04;0.0;0.0
7704_4.txt;0;0;0;0;116;0.0;0.0;0.0
11026_1.txt;8;0;0;8;192;0.04;0.0;0.0
1693_2.txt;0;2;0;2;165;0.0;0.01;0.0
9906_4.txt;17;0;0;17;563;0.03;0.0;0.0
43_4.txt;24;2;0;26;298;0.08;0.01;0.0
3428_4.txt;8;0;4;12;189;0.04;0.0;0.02
10705_4.txt;5;0;0;5;398;0.01;0.0;0.0
4256_4.txt;23;0;0;23;195;0.12;0.0;0.0
11292_2.txt;5;1;1;7;164;0.03;0.01;0.01
5226_2.txt;4;0;0;4;133;0.03;0.0;0.0
9281_1.txt;5;0;0;5;431;0.01;0.0;0.0
8231_2.txt;0;0;0;0;334;0.0;0.0;0.0
12102_4.txt;9;0;0;9;454;0.02;0.0;0.0
7801_1.txt;2;0;0;2;172;0.01;0.0;0.0
8236_1.txt;0;0;0;0;148;0.0;0.0;0.0
4456_1.txt;3;2;0;5;631;0.0;0.0;0.0
10851_2.txt;7;0;0;7;593;0.01;0.0;0.0
9422_1.txt;2;1;0;3;131;0.02;0.01;0.0
11439_3.txt;5;0;0;5;150;0.03;0.0;0.0
11215_1.txt;0;0;0;0;230;0.0;0.0;0.0
5547_4.txt;3;0;1;4;252;0.01;0.0;0.0
9032_4.txt;7;0;0;7;178;0.04;0.0;0.0
9310_1.txt;1;0;0;1;164;0.01;0.0;0.0
586_1.txt;10;0;1;11;150;0.07;0.0;0.01
11245_2.txt;2;0;0;2;480;0.0;0.0;0.0
10796_1.txt;4;1;0;5;86;0.05;0.01;0.0
9355_4.txt;5;0;1;6;162;0.03;0.0;0.01
10486_3.txt;12;3;1;16;326;0.04;0.01;0.0
10990_1.txt;13;5;3;21;448;0.03;0.01;0.01
2850_2.txt;4;3;0;7;115;0.03;0.03;0.0
12415_4.txt;20;0;3;23;226;0.09;0.0;0.01
6405_3.txt;4;0;0;4;192;0.02;0.0;0.0
10006_4.txt;11;0;1;12;176;0.06;0.0;0.01
6983_3.txt;6;0;0;6;194;0.03;0.0;0.0
9699_3.txt;18;1;0;19;419;0.04;0.0;0.0
6379_4.txt;0;0;0;0;114;0.0;0.0;0.0
4129_1.txt;0;0;0;0;132;0.0;0.0;0.0
8792_2.txt;3;0;0;3;155;0.02;0.0;0.0
10244_2.txt;4;2;0;6;197;0.02;0.01;0.0
5484_4.txt;1;1;1;3;155;0.01;0.01;0.01
10208_3.txt;15;1;0;16;281;0.05;0.0;0.0
4916_4.txt;36;2;3;41;393;0.09;0.01;0.01
1290_2.txt;0;1;0;1;193;0.0;0.01;0.0
12320_1.txt;6;3;2;11;152;0.04;0.02;0.01
2934_3.txt;22;6;0;28;219;0.1;0.03;0.0
8493_1.txt;4;0;0;4;258;0.02;0.0;0.0
625_4.txt;0;0;0;0;407;0.0;0.0;0.0
8400_2.txt;0;0;0;0;90;0.0;0.0;0.0
3317_2.txt;10;2;0;12;148;0.07;0.01;0.0
10242_3.txt;1;4;0;5;359;0.0;0.01;0.0
2708_1.txt;8;0;0;8;309;0.03;0.0;0.0
2840_1.txt;2;1;2;5;305;0.01;0.0;0.01
6258_4.txt;10;0;0;10;225;0.04;0.0;0.0
11449_1.txt;16;0;0;16;520;0.03;0.0;0.0
934_4.txt;3;0;1;4;146;0.02;0.0;0.01
7408_4.txt;1;0;0;1;344;0.0;0.0;0.0
12219_4.txt;0;0;0;0;162;0.0;0.0;0.0
6840_4.txt;2;0;2;4;150;0.01;0.0;0.01
3671_4.txt;2;0;0;2;116;0.02;0.0;0.0
10555_1.txt;2;0;2;4;346;0.01;0.0;0.01
6257_1.txt;9;0;0;9;324;0.03;0.0;0.0
9710_2.txt;20;0;4;24;606;0.03;0.0;0.01
4687_3.txt;10;0;0;10;457;0.02;0.0;0.0
4899_3.txt;9;0;0;9;149;0.06;0.0;0.0
10757_4.txt;5;1;1;7;279;0.02;0.0;0.0
711_4.txt;3;2;1;6;207;0.01;0.01;0.0
6749_2.txt;2;0;0;2;136;0.01;0.0;0.0
5279_1.txt;0;0;0;0;187;0.0;0.0;0.0
10325_1.txt;0;0;3;3;165;0.0;0.0;0.02
8942_1.txt;0;4;0;4;485;0.0;0.01;0.0
7254_1.txt;0;0;0;0;210;0.0;0.0;0.0
11683_3.txt;6;0;0;6;233;0.03;0.0;0.0
5472_2.txt;6;1;1;8;1034;0.01;0.0;0.0
3722_1.txt;2;0;0;2;103;0.02;0.0;0.0
5461_3.txt;0;0;0;0;170;0.0;0.0;0.0
5146_4.txt;1;1;0;2;108;0.01;0.01;0.0
6612_1.txt;15;0;0;15;212;0.07;0.0;0.0
11038_3.txt;17;1;3;21;417;0.04;0.0;0.01
8770_2.txt;13;1;0;14;159;0.08;0.01;0.0
7251_1.txt;0;0;0;0;148;0.0;0.0;0.0
2652_1.txt;2;2;0;4;461;0.0;0.0;0.0
4797_4.txt;20;1;1;22;302;0.07;0.0;0.0
390_4.txt;2;0;0;2;151;0.01;0.0;0.0
5266_3.txt;0;0;0;0;71;0.0;0.0;0.0
3467_1.txt;7;1;0;8;235;0.03;0.0;0.0
9685_4.txt;11;0;0;11;417;0.03;0.0;0.0
11017_4.txt;9;0;0;9;129;0.07;0.0;0.0
11546_4.txt;33;1;4;38;1117;0.03;0.0;0.0
78_4.txt;0;0;0;0;150;0.0;0.0;0.0
6648_1.txt;4;0;0;4;130;0.03;0.0;0.0
3094_2.txt;6;0;0;6;201;0.03;0.0;0.0
1841_4.txt;12;0;0;12;356;0.03;0.0;0.0
8649_1.txt;0;2;0;2;154;0.0;0.01;0.0
6318_1.txt;0;0;0;0;51;0.0;0.0;0.0
320_1.txt;7;0;0;7;167;0.04;0.0;0.0
8959_1.txt;0;0;0;0;147;0.0;0.0;0.0
180_4.txt;22;1;0;23;442;0.05;0.0;0.0
6339_1.txt;10;2;0;12;275;0.04;0.01;0.0
7602_1.txt;0;0;0;0;301;0.0;0.0;0.0
5198_3.txt;0;0;0;0;130;0.0;0.0;0.0
3865_2.txt;0;0;0;0;164;0.0;0.0;0.0
6265_1.txt;0;0;0;0;153;0.0;0.0;0.0
8237_1.txt;0;0;0;0;172;0.0;0.0;0.0
2920_4.txt;2;0;0;2;108;0.02;0.0;0.0
3458_1.txt;2;0;0;2;143;0.01;0.0;0.0
4478_1.txt;9;4;1;14;281;0.03;0.01;0.0
4081_1.txt;2;0;0;2;69;0.03;0.0;0.0
9479_2.txt;0;1;0;1;161;0.0;0.01;0.0
2548_1.txt;0;1;0;1;133;0.0;0.01;0.0
4134_1.txt;0;0;0;0;431;0.0;0.0;0.0
1095_3.txt;3;0;0;3;461;0.01;0.0;0.0
6029_1.txt;0;2;4;6;199;0.0;0.01;0.02
4755_4.txt;0;0;0;0;163;0.0;0.0;0.0
4167_2.txt;6;0;0;6;166;0.04;0.0;0.0
5820_1.txt;0;0;0;0;197;0.0;0.0;0.0
10906_2.txt;2;0;0;2;87;0.02;0.0;0.0
2351_1.txt;0;0;0;0;184;0.0;0.0;0.0
6213_1.txt;4;0;1;5;256;0.02;0.0;0.0
5264_4.txt;25;4;0;29;753;0.03;0.01;0.0
7828_1.txt;0;1;0;1;81;0.0;0.01;0.0
891_2.txt;2;10;0;12;361;0.01;0.03;0.0
7053_1.txt;8;1;0;9;159;0.05;0.01;0.0
9802_1.txt;0;0;2;2;169;0.0;0.0;0.01
12311_1.txt;21;0;5;26;194;0.11;0.0;0.03
9833_2.txt;31;0;2;33;162;0.19;0.0;0.01
745_1.txt;6;0;1;7;392;0.02;0.0;0.0
3661_1.txt;7;0;0;7;144;0.05;0.0;0.0
12258_1.txt;58;1;0;59;851;0.07;0.0;0.0
7472_2.txt;2;0;0;2;127;0.02;0.0;0.0
3604_2.txt;3;2;7;12;418;0.01;0.0;0.02
6655_3.txt;21;3;0;24;327;0.06;0.01;0.0
1637_4.txt;1;0;0;1;60;0.02;0.0;0.0
2255_4.txt;5;0;0;5;225;0.02;0.0;0.0
9007_1.txt;2;0;0;2;129;0.02;0.0;0.0
7995_3.txt;0;0;0;0;204;0.0;0.0;0.0
9638_1.txt;36;1;0;37;522;0.07;0.0;0.0
3105_3.txt;2;0;0;2;96;0.02;0.0;0.0
9077_1.txt;0;0;5;5;100;0.0;0.0;0.05
5186_3.txt;8;1;2;11;191;0.04;0.01;0.01
597_3.txt;2;0;3;5;273;0.01;0.0;0.01
4152_1.txt;1;0;0;1;700;0.0;0.0;0.0
10598_1.txt;0;0;0;0;103;0.0;0.0;0.0
5945_1.txt;3;0;0;3;167;0.02;0.0;0.0
6322_1.txt;0;4;0;4;142;0.0;0.03;0.0
8193_3.txt;6;0;0;6;326;0.02;0.0;0.0
6429_1.txt;0;4;0;4;116;0.0;0.03;0.0
12119_3.txt;54;0;2;56;1053;0.05;0.0;0.0
4639_3.txt;0;0;0;0;158;0.0;0.0;0.0
9020_1.txt;0;1;0;1;133;0.0;0.01;0.0
6302_2.txt;10;3;0;13;322;0.03;0.01;0.0
11717_4.txt;5;1;0;6;159;0.03;0.01;0.0
12017_3.txt;17;2;2;21;407;0.04;0.0;0.0
6553_4.txt;9;1;3;13;460;0.02;0.0;0.01
3258_2.txt;8;0;0;8;237;0.03;0.0;0.0
4854_1.txt;18;5;0;23;777;0.02;0.01;0.0
5361_1.txt;2;0;0;2;175;0.01;0.0;0.0
12268_1.txt;0;0;0;0;322;0.0;0.0;0.0
4282_1.txt;9;1;0;10;188;0.05;0.01;0.0
9780_2.txt;2;4;1;7;171;0.01;0.02;0.01
1483_2.txt;0;2;0;2;141;0.0;0.01;0.0
8470_2.txt;2;0;0;2;214;0.01;0.0;0.0
6819_3.txt;1;0;0;1;214;0.0;0.0;0.0
8879_4.txt;3;0;0;3;236;0.01;0.0;0.0
506_2.txt;2;3;0;5;144;0.01;0.02;0.0
6263_1.txt;2;0;0;2;119;0.02;0.0;0.0
6706_1.txt;0;0;0;0;124;0.0;0.0;0.0
881_1.txt;19;11;0;30;343;0.06;0.03;0.0
3417_4.txt;4;1;0;5;178;0.02;0.01;0.0
12157_1.txt;16;0;2;18;655;0.02;0.0;0.0
5425_4.txt;3;0;0;3;159;0.02;0.0;0.0
3924_3.txt;2;0;0;2;116;0.02;0.0;0.0
4350_2.txt;7;2;0;9;558;0.01;0.0;0.0
5085_1.txt;0;1;0;1;132;0.0;0.01;0.0
601_4.txt;1;2;0;3;296;0.0;0.01;0.0
12404_1.txt;5;0;0;5;175;0.03;0.0;0.0
11020_4.txt;39;0;0;39;412;0.09;0.0;0.0
12276_2.txt;4;0;0;4;131;0.03;0.0;0.0
1100_3.txt;45;1;3;49;685;0.07;0.0;0.0
8648_1.txt;4;1;3;8;166;0.02;0.01;0.02
6523_1.txt;2;0;2;4;488;0.0;0.0;0.0
6882_1.txt;14;11;0;25;326;0.04;0.03;0.0
9653_2.txt;0;2;0;2;197;0.0;0.01;0.0
768_4.txt;3;0;0;3;148;0.02;0.0;0.0
10074_2.txt;7;0;0;7;60;0.12;0.0;0.0
10612_3.txt;8;2;0;10;275;0.03;0.01;0.0
11106_1.txt;2;0;0;2;544;0.0;0.0;0.0
12490_1.txt;0;0;0;0;212;0.0;0.0;0.0
4815_2.txt;6;1;2;9;363;0.02;0.0;0.01
532_2.txt;14;0;2;16;213;0.07;0.0;0.01
150_1.txt;7;0;0;7;155;0.05;0.0;0.0
4251_1.txt;3;0;0;3;87;0.03;0.0;0.0
8845_3.txt;0;0;1;1;147;0.0;0.0;0.01
5391_4.txt;0;2;0;2;209;0.0;0.01;0.0
6875_2.txt;2;2;0;4;164;0.01;0.01;0.0
3377_2.txt;11;4;0;15;582;0.02;0.01;0.0
2882_1.txt;0;2;0;2;142;0.0;0.01;0.0
11562_2.txt;20;0;0;20;139;0.14;0.0;0.0
3836_2.txt;7;0;0;7;210;0.03;0.0;0.0
11426_1.txt;5;0;0;5;299;0.02;0.0;0.0
9337_4.txt;8;2;0;10;401;0.02;0.0;0.0
11387_4.txt;2;7;4;13;255;0.01;0.03;0.02
6460_2.txt;21;1;1;23;647;0.03;0.0;0.0
2083_1.txt;25;0;4;29;500;0.05;0.0;0.01
5678_1.txt;0;0;0;0;149;0.0;0.0;0.0
10572_1.txt;0;0;0;0;320;0.0;0.0;0.0
34_1.txt;0;0;0;0;59;0.0;0.0;0.0
4801_4.txt;2;0;0;2;114;0.02;0.0;0.0
7421_4.txt;5;6;1;12;233;0.02;0.03;0.0
464_2.txt;0;0;0;0;163;0.0;0.0;0.0
10887_2.txt;0;0;0;0;131;0.0;0.0;0.0
752_1.txt;20;3;3;26;1141;0.02;0.0;0.0
1903_1.txt;6;3;0;9;483;0.01;0.01;0.0
4923_1.txt;6;0;0;6;211;0.03;0.0;0.0
123_1.txt;2;2;0;4;372;0.01;0.01;0.0
8043_1.txt;0;0;0;0;276;0.0;0.0;0.0
3819_4.txt;9;2;3;14;234;0.04;0.01;0.01
6381_1.txt;0;2;0;2;152;0.0;0.01;0.0
4884_2.txt;3;0;2;5;283;0.01;0.0;0.01
1967_4.txt;26;0;2;28;646;0.04;0.0;0.0
11482_1.txt;2;0;0;2;158;0.01;0.0;0.0
5393_4.txt;8;0;0;8;82;0.1;0.0;0.0
4936_1.txt;0;0;0;0;137;0.0;0.0;0.0
11124_1.txt;0;0;0;0;387;0.0;0.0;0.0
1527_1.txt;1;0;6;7;261;0.0;0.0;0.02
3077_1.txt;2;0;0;2;117;0.02;0.0;0.0
9620_2.txt;0;0;0;0;291;0.0;0.0;0.0
810_1.txt;6;0;1;7;173;0.03;0.0;0.01
6778_3.txt;11;0;2;13;296;0.04;0.0;0.01
10447_1.txt;0;0;0;0;193;0.0;0.0;0.0
2392_1.txt;6;0;0;6;261;0.02;0.0;0.0
10050_2.txt;8;0;0;8;192;0.04;0.0;0.0
2821_1.txt;7;0;0;7;110;0.06;0.0;0.0
6975_3.txt;0;0;0;0;94;0.0;0.0;0.0
8377_1.txt;0;0;0;0;232;0.0;0.0;0.0
10818_1.txt;12;3;0;15;239;0.05;0.01;0.0
2943_1.txt;4;0;0;4;64;0.06;0.0;0.0
11704_3.txt;6;0;0;6;104;0.06;0.0;0.0
9847_1.txt;18;1;0;19;347;0.05;0.0;0.0
7369_1.txt;1;0;0;1;153;0.01;0.0;0.0
1092_2.txt;20;3;4;27;406;0.05;0.01;0.01
12145_1.txt;5;0;0;5;420;0.01;0.0;0.0
10035_1.txt;1;0;0;1;129;0.01;0.0;0.0
11396_2.txt;2;0;2;4;150;0.01;0.0;0.01
10146_1.txt;4;0;0;4;208;0.02;0.0;0.0
6562_4.txt;29;3;4;36;547;0.05;0.01;0.01
10649_4.txt;31;2;2;35;579;0.05;0.0;0.0
3731_1.txt;1;0;0;1;160;0.01;0.0;0.0
3548_3.txt;21;5;1;27;578;0.04;0.01;0.0
2502_1.txt;0;4;0;4;328;0.0;0.01;0.0
2728_3.txt;36;9;11;56;449;0.08;0.02;0.02
9945_1.txt;0;0;0;0;105;0.0;0.0;0.0
6669_1.txt;7;0;0;7;253;0.03;0.0;0.0
8053_3.txt;4;0;0;4;99;0.04;0.0;0.0
7072_2.txt;5;0;0;5;200;0.03;0.0;0.0
2395_4.txt;4;0;0;4;108;0.04;0.0;0.0
5220_2.txt;2;0;0;2;353;0.01;0.0;0.0
6760_2.txt;15;2;0;17;121;0.12;0.02;0.0
2245_4.txt;11;0;0;11;148;0.07;0.0;0.0
5524_2.txt;6;1;0;7;381;0.02;0.0;0.0
10026_2.txt;4;1;0;5;271;0.01;0.0;0.0
9376_1.txt;6;2;0;8;217;0.03;0.01;0.0
4183_1.txt;5;0;1;6;196;0.03;0.0;0.01
6577_4.txt;1;0;0;1;86;0.01;0.0;0.0
5942_4.txt;4;0;2;6;363;0.01;0.0;0.01
7313_1.txt;7;0;0;7;324;0.02;0.0;0.0
9157_1.txt;9;4;0;13;241;0.04;0.02;0.0
12100_4.txt;13;0;0;13;410;0.03;0.0;0.0
6487_1.txt;13;0;2;15;358;0.04;0.0;0.01
2762_1.txt;10;0;4;14;543;0.02;0.0;0.01
9808_1.txt;0;0;10;10;323;0.0;0.0;0.03
4386_3.txt;2;0;0;2;203;0.01;0.0;0.0
10137_1.txt;1;0;0;1;201;0.0;0.0;0.0
9071_1.txt;23;0;0;23;216;0.11;0.0;0.0
2977_1.txt;34;3;4;41;1057;0.03;0.0;0.0
7886_1.txt;0;0;0;0;209;0.0;0.0;0.0
700_4.txt;0;1;0;1;153;0.0;0.01;0.0
10688_1.txt;1;0;0;1;160;0.01;0.0;0.0
6791_1.txt;4;0;0;4;145;0.03;0.0;0.0
3656_4.txt;22;5;3;30;429;0.05;0.01;0.01
3197_3.txt;19;3;2;24;487;0.04;0.01;0.0
6780_4.txt;16;4;1;21;210;0.08;0.02;0.0
616_1.txt;0;0;0;0;415;0.0;0.0;0.0
9481_3.txt;12;1;0;13;236;0.05;0.0;0.0
5278_1.txt;4;0;0;4;330;0.01;0.0;0.0
10097_1.txt;0;0;0;0;244;0.0;0.0;0.0
4414_3.txt;12;1;0;13;208;0.06;0.0;0.0
1322_1.txt;8;1;0;9;344;0.02;0.0;0.0
8465_1.txt;2;1;1;4;216;0.01;0.0;0.0
147_4.txt;10;0;0;10;257;0.04;0.0;0.0
3310_4.txt;0;0;0;0;56;0.0;0.0;0.0
8804_4.txt;14;1;0;15;220;0.06;0.0;0.0
6414_1.txt;4;0;2;6;149;0.03;0.0;0.01
522_1.txt;2;1;0;3;177;0.01;0.01;0.0
10863_1.txt;3;0;1;4;127;0.02;0.0;0.01
5600_4.txt;0;0;0;0;117;0.0;0.0;0.0
7966_4.txt;15;0;2;17;794;0.02;0.0;0.0
8915_1.txt;6;0;0;6;379;0.02;0.0;0.0
11016_1.txt;0;0;1;1;156;0.0;0.0;0.01
5834_4.txt;16;0;6;22;191;0.08;0.0;0.03
2411_3.txt;7;1;2;10;323;0.02;0.0;0.01
3180_2.txt;4;1;0;5;148;0.03;0.01;0.0
7386_1.txt;4;0;0;4;168;0.02;0.0;0.0
2103_2.txt;5;0;0;5;160;0.03;0.0;0.0
3669_2.txt;0;0;0;0;96;0.0;0.0;0.0
6074_3.txt;3;0;0;3;130;0.02;0.0;0.0
10848_1.txt;9;0;3;12;400;0.02;0.0;0.01
8469_1.txt;0;0;0;0;101;0.0;0.0;0.0
196_3.txt;4;3;0;7;172;0.02;0.02;0.0
10188_2.txt;5;1;3;9;344;0.01;0.0;0.01
10689_4.txt;11;2;0;13;194;0.06;0.01;0.0
5777_4.txt;8;1;1;10;217;0.04;0.0;0.0
454_4.txt;7;0;0;7;200;0.04;0.0;0.0
5637_2.txt;3;1;0;4;323;0.01;0.0;0.0
11940_4.txt;14;0;0;14;447;0.03;0.0;0.0
1745_2.txt;13;4;0;17;185;0.07;0.02;0.0
3532_1.txt;0;1;0;1;137;0.0;0.01;0.0
10926_4.txt;7;0;0;7;185;0.04;0.0;0.0
4175_3.txt;4;0;0;4;182;0.02;0.0;0.0
7389_2.txt;0;0;0;0;249;0.0;0.0;0.0
2145_1.txt;2;0;0;2;176;0.01;0.0;0.0
7333_3.txt;5;1;0;6;176;0.03;0.01;0.0
3618_1.txt;3;0;0;3;152;0.02;0.0;0.0
6476_4.txt;2;2;5;9;155;0.01;0.01;0.03
10811_1.txt;1;0;0;1;65;0.02;0.0;0.0
8298_1.txt;0;0;0;0;83;0.0;0.0;0.0
8884_4.txt;2;0;0;2;90;0.02;0.0;0.0
11151_3.txt;26;2;2;30;741;0.04;0.0;0.0
687_4.txt;12;0;0;12;340;0.04;0.0;0.0
11515_1.txt;9;0;0;9;139;0.06;0.0;0.0
2979_4.txt;6;0;0;6;315;0.02;0.0;0.0
668_4.txt;0;0;0;0;149;0.0;0.0;0.0
9203_1.txt;16;0;0;16;316;0.05;0.0;0.0
11031_4.txt;0;0;0;0;242;0.0;0.0;0.0
898_1.txt;6;0;0;6;119;0.05;0.0;0.0
9973_4.txt;4;0;0;4;164;0.02;0.0;0.0
11178_3.txt;3;0;0;3;125;0.02;0.0;0.0
816_4.txt;11;0;1;12;346;0.03;0.0;0.0
9175_1.txt;0;0;0;0;122;0.0;0.0;0.0
9452_1.txt;5;0;0;5;134;0.04;0.0;0.0
7902_4.txt;14;0;0;14;316;0.04;0.0;0.0
12227_1.txt;4;1;0;5;189;0.02;0.01;0.0
9323_2.txt;3;0;0;3;342;0.01;0.0;0.0
919_1.txt;2;0;0;2;198;0.01;0.0;0.0
2060_3.txt;7;0;2;9;184;0.04;0.0;0.01
11678_4.txt;15;1;0;16;430;0.03;0.0;0.0
9953_1.txt;10;0;0;10;185;0.05;0.0;0.0
4041_1.txt;13;1;0;14;499;0.03;0.0;0.0
1915_2.txt;10;2;0;12;233;0.04;0.01;0.0
2094_1.txt;0;0;0;0;160;0.0;0.0;0.0
3418_1.txt;7;5;0;12;516;0.01;0.01;0.0
6876_1.txt;0;4;1;5;318;0.0;0.01;0.0
11840_4.txt;12;4;5;21;573;0.02;0.01;0.01
10475_1.txt;0;0;0;0;113;0.0;0.0;0.0
5880_1.txt;0;0;0;0;167;0.0;0.0;0.0
2951_1.txt;10;0;0;10;240;0.04;0.0;0.0
4034_2.txt;0;0;0;0;158;0.0;0.0;0.0
4276_4.txt;22;0;3;25;706;0.03;0.0;0.0
12032_1.txt;2;0;0;2;177;0.01;0.0;0.0
2635_2.txt;6;0;0;6;177;0.03;0.0;0.0
8291_1.txt;0;0;0;0;85;0.0;0.0;0.0
3947_2.txt;12;0;0;12;182;0.07;0.0;0.0
6880_2.txt;5;1;0;6;389;0.01;0.0;0.0
1726_1.txt;5;7;3;15;580;0.01;0.01;0.01
5479_3.txt;13;5;3;21;229;0.06;0.02;0.01
7529_3.txt;12;4;0;16;226;0.05;0.02;0.0
8503_1.txt;3;0;0;3;185;0.02;0.0;0.0
9764_1.txt;7;1;0;8;358;0.02;0.0;0.0
9266_1.txt;3;0;0;3;544;0.01;0.0;0.0
7916_4.txt;20;3;5;28;1050;0.02;0.0;0.0
11518_1.txt;18;1;0;19;699;0.03;0.0;0.0
5225_4.txt;11;0;0;11;170;0.06;0.0;0.0
3055_2.txt;1;3;0;4;53;0.02;0.06;0.0
3214_3.txt;4;0;5;9;406;0.01;0.0;0.01
8680_3.txt;7;1;0;8;329;0.02;0.0;0.0
1563_1.txt;0;0;0;0;133;0.0;0.0;0.0
3946_3.txt;7;0;0;7;433;0.02;0.0;0.0
1556_1.txt;7;2;0;9;159;0.04;0.01;0.0
12369_1.txt;7;0;0;7;247;0.03;0.0;0.0
4872_4.txt;18;0;0;18;126;0.14;0.0;0.0
5145_4.txt;0;0;0;0;56;0.0;0.0;0.0
8812_3.txt;2;0;0;2;169;0.01;0.0;0.0
9116_1.txt;23;0;0;23;477;0.05;0.0;0.0
9645_4.txt;25;8;7;40;458;0.05;0.02;0.02
839_1.txt;1;0;3;4;151;0.01;0.0;0.02
8152_2.txt;31;2;0;33;412;0.08;0.0;0.0
5267_1.txt;0;0;0;0;69;0.0;0.0;0.0
4003_2.txt;4;2;0;6;169;0.02;0.01;0.0
1811_1.txt;10;0;0;10;533;0.02;0.0;0.0
661_1.txt;10;0;0;10;919;0.01;0.0;0.0
8715_4.txt;4;2;3;9;279;0.01;0.01;0.01
1507_3.txt;2;0;0;2;48;0.04;0.0;0.0
9134_4.txt;6;0;0;6;213;0.03;0.0;0.0
1160_1.txt;6;0;0;6;113;0.05;0.0;0.0
1233_1.txt;0;0;0;0;141;0.0;0.0;0.0
9068_2.txt;0;0;0;0;81;0.0;0.0;0.0
2319_3.txt;14;0;0;14;431;0.03;0.0;0.0
725_2.txt;0;0;0;0;178;0.0;0.0;0.0
10359_1.txt;1;0;2;3;204;0.0;0.0;0.01
11480_2.txt;2;0;0;2;305;0.01;0.0;0.0
1663_1.txt;4;0;0;4;252;0.02;0.0;0.0
1591_3.txt;33;0;0;33;579;0.06;0.0;0.0
7358_1.txt;0;0;4;4;1155;0.0;0.0;0.0
1835_2.txt;5;0;0;5;162;0.03;0.0;0.0
7397_4.txt;2;0;0;2;96;0.02;0.0;0.0
7335_1.txt;17;1;0;18;315;0.05;0.0;0.0
831_2.txt;0;0;6;6;565;0.0;0.0;0.01
1965_1.txt;3;3;0;6;355;0.01;0.01;0.0
2531_4.txt;0;3;5;8;737;0.0;0.0;0.01
2706_2.txt;0;0;0;0;397;0.0;0.0;0.0
6723_2.txt;2;2;0;4;133;0.02;0.02;0.0
7958_3.txt;5;0;2;7;278;0.02;0.0;0.01
5911_4.txt;6;0;1;7;417;0.01;0.0;0.0
3035_2.txt;13;3;3;19;549;0.02;0.01;0.01
3968_1.txt;4;0;0;4;178;0.02;0.0;0.0
3000_3.txt;8;0;0;8;343;0.02;0.0;0.0
5005_1.txt;2;0;0;2;134;0.01;0.0;0.0
8825_1.txt;0;0;0;0;149;0.0;0.0;0.0
4690_2.txt;4;0;0;4;327;0.01;0.0;0.0
463_4.txt;4;0;0;4;166;0.02;0.0;0.0
2028_3.txt;3;0;1;4;673;0.0;0.0;0.0
5250_4.txt;6;0;0;6;201;0.03;0.0;0.0
8445_4.txt;3;1;0;4;272;0.01;0.0;0.0
8315_3.txt;0;2;0;2;289;0.0;0.01;0.0
2307_1.txt;4;0;0;4;131;0.03;0.0;0.0
2737_1.txt;0;0;0;0;128;0.0;0.0;0.0
5116_1.txt;1;1;0;2;180;0.01;0.01;0.0
10709_1.txt;2;0;0;2;166;0.01;0.0;0.0
3070_2.txt;5;3;0;8;337;0.01;0.01;0.0
8195_4.txt;11;4;2;17;220;0.05;0.02;0.01
11362_2.txt;0;0;1;1;214;0.0;0.0;0.0
2833_1.txt;8;0;2;10;151;0.05;0.0;0.01
3086_1.txt;0;0;0;0;185;0.0;0.0;0.0
7290_3.txt;2;0;1;3;109;0.02;0.0;0.01
9350_1.txt;1;0;0;1;313;0.0;0.0;0.0
10971_2.txt;3;1;0;4;179;0.02;0.01;0.0
9433_3.txt;3;0;0;3;483;0.01;0.0;0.0
926_1.txt;5;0;0;5;194;0.03;0.0;0.0
3376_3.txt;25;5;0;30;555;0.05;0.01;0.0
2422_3.txt;0;0;0;0;136;0.0;0.0;0.0
7811_2.txt;16;0;2;18;694;0.02;0.0;0.0
2794_3.txt;0;0;1;1;149;0.0;0.0;0.01
2370_4.txt;40;5;4;49;904;0.04;0.01;0.0
5610_3.txt;1;0;1;2;119;0.01;0.0;0.01
6652_3.txt;11;5;0;16;144;0.08;0.03;0.0
2013_3.txt;3;0;0;3;121;0.02;0.0;0.0
7672_1.txt;6;0;2;8;282;0.02;0.0;0.01
9416_3.txt;28;2;8;38;285;0.1;0.01;0.03
323_1.txt;2;0;0;2;144;0.01;0.0;0.0
6436_2.txt;3;0;0;3;139;0.02;0.0;0.0
2208_4.txt;35;0;0;35;739;0.05;0.0;0.0
10815_2.txt;19;0;0;19;202;0.09;0.0;0.0
11194_1.txt;2;0;0;2;95;0.02;0.0;0.0
2285_1.txt;0;1;0;1;143;0.0;0.01;0.0
3243_4.txt;3;0;0;3;195;0.02;0.0;0.0
911_1.txt;0;0;0;0;134;0.0;0.0;0.0
3020_3.txt;23;7;3;33;1115;0.02;0.01;0.0
2511_4.txt;19;0;0;19;143;0.13;0.0;0.0
1974_4.txt;0;4;0;4;176;0.0;0.02;0.0
3093_2.txt;7;0;1;8;543;0.01;0.0;0.0
7785_3.txt;2;0;0;2;155;0.01;0.0;0.0
3932_4.txt;4;0;2;6;121;0.03;0.0;0.02
6032_2.txt;6;0;0;6;305;0.02;0.0;0.0
7488_1.txt;8;1;0;9;192;0.04;0.01;0.0
10634_1.txt;7;2;2;11;323;0.02;0.01;0.01
5460_4.txt;7;0;0;7;305;0.02;0.0;0.0
11679_4.txt;2;0;0;2;143;0.01;0.0;0.0
10129_1.txt;3;0;0;3;202;0.01;0.0;0.0
9948_2.txt;16;0;0;16;67;0.24;0.0;0.0
1568_1.txt;1;0;0;1;80;0.01;0.0;0.0
480_3.txt;20;0;2;22;570;0.04;0.0;0.0
10184_1.txt;1;1;1;3;158;0.01;0.01;0.01
9559_1.txt;0;0;0;0;295;0.0;0.0;0.0
11469_4.txt;14;0;3;17;179;0.08;0.0;0.02
8998_4.txt;4;2;0;6;155;0.03;0.01;0.0
5999_3.txt;4;1;4;9;491;0.01;0.0;0.01
8576_1.txt;11;0;0;11;114;0.1;0.0;0.0
5585_1.txt;0;1;0;1;151;0.0;0.01;0.0
4852_1.txt;2;0;3;5;425;0.0;0.0;0.01
299_1.txt;6;0;0;6;131;0.05;0.0;0.0
2522_4.txt;0;0;0;0;137;0.0;0.0;0.0
1701_4.txt;9;4;0;13;250;0.04;0.02;0.0
1986_1.txt;0;0;0;0;158;0.0;0.0;0.0
7368_1.txt;4;0;1;5;268;0.01;0.0;0.0
3712_3.txt;10;0;0;10;377;0.03;0.0;0.0
5190_4.txt;14;5;0;19;532;0.03;0.01;0.0
2051_1.txt;2;0;0;2;271;0.01;0.0;0.0
8090_3.txt;2;0;0;2;244;0.01;0.0;0.0
3486_2.txt;14;2;1;17;461;0.03;0.0;0.0
608_3.txt;4;0;1;5;531;0.01;0.0;0.0
1414_3.txt;2;0;0;2;149;0.01;0.0;0.0
4902_4.txt;19;9;10;38;664;0.03;0.01;0.02
7807_1.txt;4;0;0;4;157;0.03;0.0;0.0
1162_1.txt;8;0;0;8;145;0.06;0.0;0.0
7334_1.txt;4;0;0;4;174;0.02;0.0;0.0
11933_1.txt;2;0;0;2;256;0.01;0.0;0.0
2124_1.txt;2;0;0;2;199;0.01;0.0;0.0
8130_3.txt;2;0;0;2;171;0.01;0.0;0.0
12176_2.txt;24;2;0;26;510;0.05;0.0;0.0
10493_4.txt;1;0;2;3;151;0.01;0.0;0.01
2340_2.txt;0;1;0;1;77;0.0;0.01;0.0
10552_1.txt;0;0;0;0;135;0.0;0.0;0.0
11893_3.txt;4;4;1;9;152;0.03;0.03;0.01
12336_3.txt;12;4;0;16;259;0.05;0.02;0.0
469_2.txt;9;0;0;9;219;0.04;0.0;0.0
10855_1.txt;0;0;1;1;461;0.0;0.0;0.0
2022_4.txt;5;1;0;6;171;0.03;0.01;0.0
11125_1.txt;5;1;0;6;154;0.03;0.01;0.0
1635_3.txt;5;0;0;5;508;0.01;0.0;0.0
5398_1.txt;20;0;3;23;608;0.03;0.0;0.0
4488_1.txt;0;0;0;0;44;0.0;0.0;0.0
3241_2.txt;3;0;0;3;206;0.01;0.0;0.0
10831_2.txt;4;0;0;4;105;0.04;0.0;0.0
3157_4.txt;1;2;0;3;158;0.01;0.01;0.0
6155_4.txt;2;0;0;2;52;0.04;0.0;0.0
8925_3.txt;3;1;1;5;149;0.02;0.01;0.01
10410_1.txt;6;1;0;7;288;0.02;0.0;0.0
445_4.txt;5;2;1;8;232;0.02;0.01;0.0
4732_4.txt;8;0;0;8;397;0.02;0.0;0.0
9093_4.txt;0;0;0;0;123;0.0;0.0;0.0
1737_4.txt;11;2;2;15;146;0.08;0.01;0.01
2885_1.txt;0;0;0;0;164;0.0;0.0;0.0
6496_1.txt;6;0;0;6;165;0.04;0.0;0.0
8410_3.txt;7;1;0;8;420;0.02;0.0;0.0
8216_4.txt;2;0;0;2;554;0.0;0.0;0.0
4300_1.txt;1;0;0;1;68;0.01;0.0;0.0
7308_1.txt;1;0;0;1;412;0.0;0.0;0.0
7067_2.txt;0;0;0;0;178;0.0;0.0;0.0
10341_1.txt;13;0;0;13;237;0.05;0.0;0.0
12214_3.txt;0;0;0;0;164;0.0;0.0;0.0
3897_4.txt;8;1;2;11;132;0.06;0.01;0.02
10938_3.txt;2;0;0;2;200;0.01;0.0;0.0
6475_3.txt;12;2;6;20;669;0.02;0.0;0.01
4721_1.txt;2;1;1;4;177;0.01;0.01;0.01
6440_3.txt;32;0;2;34;361;0.09;0.0;0.01
1706_3.txt;0;0;0;0;169;0.0;0.0;0.0
9926_2.txt;5;0;0;5;186;0.03;0.0;0.0
7111_1.txt;0;0;0;0;321;0.0;0.0;0.0
3224_1.txt;6;1;0;7;136;0.04;0.01;0.0
5851_1.txt;0;0;0;0;229;0.0;0.0;0.0
12445_4.txt;12;2;0;14;494;0.02;0.0;0.0
9980_2.txt;2;0;0;2;131;0.02;0.0;0.0
4353_4.txt;11;0;0;11;172;0.06;0.0;0.0
1259_3.txt;0;1;0;1;260;0.0;0.0;0.0
10393_4.txt;15;4;0;19;677;0.02;0.01;0.0
5915_1.txt;9;3;0;12;174;0.05;0.02;0.0
1387_4.txt;4;2;2;8;164;0.02;0.01;0.01
7051_4.txt;12;5;0;17;185;0.06;0.03;0.0
1015_2.txt;6;0;0;6;114;0.05;0.0;0.0
3493_1.txt;0;0;4;4;162;0.0;0.0;0.02
9553_1.txt;6;1;0;7;133;0.05;0.01;0.0
818_4.txt;12;1;0;13;263;0.05;0.0;0.0
8872_3.txt;2;0;0;2;67;0.03;0.0;0.0
6531_4.txt;0;1;0;1;323;0.0;0.0;0.0
7582_2.txt;1;1;0;2;239;0.0;0.0;0.0
5426_2.txt;20;1;0;21;322;0.06;0.0;0.0
9390_4.txt;13;0;1;14;498;0.03;0.0;0.0
1883_1.txt;0;2;2;4;505;0.0;0.0;0.0
5747_2.txt;2;0;0;2;155;0.01;0.0;0.0
12001_1.txt;0;0;2;2;132;0.0;0.0;0.02
12361_4.txt;5;2;0;7;260;0.02;0.01;0.0
4614_4.txt;12;3;1;16;379;0.03;0.01;0.0
5000_1.txt;4;0;0;4;139;0.03;0.0;0.0
10196_1.txt;5;0;1;6;123;0.04;0.0;0.01
7105_3.txt;0;0;0;0;53;0.0;0.0;0.0
6250_1.txt;11;2;1;14;608;0.02;0.0;0.0
6108_2.txt;12;1;0;13;180;0.07;0.01;0.0
2296_3.txt;8;0;0;8;310;0.03;0.0;0.0
70_2.txt;0;0;1;1;158;0.0;0.0;0.01
4672_3.txt;7;3;3;13;105;0.07;0.03;0.03
3882_2.txt;3;0;0;3;348;0.01;0.0;0.0
10368_1.txt;0;0;0;0;284;0.0;0.0;0.0
7159_2.txt;6;2;3;11;327;0.02;0.01;0.01
2661_2.txt;12;0;1;13;496;0.02;0.0;0.0
7203_2.txt;0;0;0;0;62;0.0;0.0;0.0
4811_3.txt;2;6;0;8;410;0.0;0.01;0.0
4507_3.txt;4;3;2;9;269;0.01;0.01;0.01
7014_3.txt;2;0;0;2;87;0.02;0.0;0.0
1645_1.txt;0;0;0;0;225;0.0;0.0;0.0
6247_1.txt;9;6;1;16;1010;0.01;0.01;0.0
1325_2.txt;12;0;0;12;210;0.06;0.0;0.0
11084_4.txt;0;0;1;1;72;0.0;0.0;0.01
5516_3.txt;42;9;0;51;635;0.07;0.01;0.0
610_1.txt;3;0;0;3;320;0.01;0.0;0.0
3539_1.txt;5;0;0;5;268;0.02;0.0;0.0
5832_4.txt;5;0;0;5;572;0.01;0.0;0.0
4504_1.txt;1;0;0;1;205;0.0;0.0;0.0
698_3.txt;2;0;0;2;79;0.03;0.0;0.0
3199_2.txt;13;2;0;15;272;0.05;0.01;0.0
9614_4.txt;18;0;1;19;242;0.07;0.0;0.0
7372_1.txt;7;0;0;7;247;0.03;0.0;0.0
5213_3.txt;10;0;0;10;464;0.02;0.0;0.0
2622_4.txt;17;0;0;17;149;0.11;0.0;0.0
6239_1.txt;4;1;1;6;205;0.02;0.0;0.0
8587_3.txt;31;2;0;33;600;0.05;0.0;0.0
12444_3.txt;6;0;3;9;119;0.05;0.0;0.03
12221_2.txt;0;0;0;0;175;0.0;0.0;0.0
16_3.txt;8;0;0;8;464;0.02;0.0;0.0
6920_2.txt;6;1;0;7;208;0.03;0.0;0.0
10112_1.txt;2;0;2;4;284;0.01;0.0;0.01
2377_1.txt;0;0;0;0;38;0.0;0.0;0.0
3563_4.txt;5;0;0;5;139;0.04;0.0;0.0
5133_1.txt;0;0;0;0;256;0.0;0.0;0.0
3628_1.txt;3;0;0;3;143;0.02;0.0;0.0
10474_3.txt;1;0;0;1;73;0.01;0.0;0.0
5856_3.txt;6;0;0;6;226;0.03;0.0;0.0
5938_2.txt;0;0;0;0;140;0.0;0.0;0.0
5084_1.txt;3;3;0;6;185;0.02;0.02;0.0
10624_1.txt;10;0;3;13;372;0.03;0.0;0.01
2553_1.txt;2;0;0;2;205;0.01;0.0;0.0
5433_1.txt;24;2;8;34;600;0.04;0.0;0.01
9013_3.txt;0;2;0;2;145;0.0;0.01;0.0
8681_4.txt;21;2;0;23;598;0.04;0.0;0.0
8886_3.txt;7;3;2;12;290;0.02;0.01;0.01
7118_3.txt;4;0;0;4;259;0.02;0.0;0.0
5034_4.txt;0;0;0;0;130;0.0;0.0;0.0
10963_1.txt;5;0;0;5;144;0.03;0.0;0.0
10136_2.txt;3;6;1;10;251;0.01;0.02;0.0
10253_1.txt;2;0;0;2;67;0.03;0.0;0.0
2702_1.txt;7;0;0;7;453;0.02;0.0;0.0
7832_1.txt;4;0;1;5;181;0.02;0.0;0.01
2823_2.txt;5;0;1;6;248;0.02;0.0;0.0
5268_1.txt;0;0;0;0;70;0.0;0.0;0.0
11305_1.txt;12;9;0;21;197;0.06;0.05;0.0
4333_2.txt;1;0;0;1;161;0.01;0.0;0.0
9510_1.txt;0;0;1;1;124;0.0;0.0;0.01
1310_3.txt;0;0;0;0;233;0.0;0.0;0.0
490_3.txt;1;0;0;1;230;0.0;0.0;0.0
10746_4.txt;16;0;0;16;425;0.04;0.0;0.0
6196_3.txt;0;1;0;1;440;0.0;0.0;0.0
7638_1.txt;0;0;0;0;192;0.0;0.0;0.0
11317_2.txt;5;3;0;8;82;0.06;0.04;0.0
7841_4.txt;4;0;0;4;222;0.02;0.0;0.0
9917_3.txt;5;2;1;8;156;0.03;0.01;0.01
7074_4.txt;24;0;2;26;220;0.11;0.0;0.01
2006_3.txt;0;0;0;0;242;0.0;0.0;0.0
1496_2.txt;0;0;3;3;218;0.0;0.0;0.01
3986_1.txt;10;2;0;12;134;0.07;0.01;0.0
3291_1.txt;13;0;0;13;141;0.09;0.0;0.0
12455_4.txt;14;1;1;16;347;0.04;0.0;0.0
8437_3.txt;6;0;0;6;221;0.03;0.0;0.0
7106_1.txt;13;0;0;13;304;0.04;0.0;0.0
10398_3.txt;0;1;0;1;64;0.0;0.02;0.0
11675_3.txt;16;0;4;20;338;0.05;0.0;0.01
2759_1.txt;0;0;0;0;190;0.0;0.0;0.0
4574_1.txt;1;1;0;2;305;0.0;0.0;0.0
7926_2.txt;3;0;0;3;183;0.02;0.0;0.0
3051_2.txt;11;5;3;19;554;0.02;0.01;0.01
10164_4.txt;0;0;0;0;152;0.0;0.0;0.0
11557_1.txt;4;0;0;4;176;0.02;0.0;0.0
1065_1.txt;0;1;0;1;147;0.0;0.01;0.0
7617_3.txt;1;0;0;1;182;0.01;0.0;0.0
6741_1.txt;3;1;0;4;375;0.01;0.0;0.0
10014_2.txt;0;0;0;0;80;0.0;0.0;0.0
4168_4.txt;4;0;0;4;154;0.03;0.0;0.0
6576_1.txt;2;0;0;2;167;0.01;0.0;0.0
12362_1.txt;0;2;0;2;106;0.0;0.02;0.0
4739_3.txt;14;3;0;17;585;0.02;0.01;0.0
6177_1.txt;9;0;9;18;287;0.03;0.0;0.03
8387_1.txt;1;7;0;8;247;0.0;0.03;0.0
5756_3.txt;4;0;0;4;178;0.02;0.0;0.0
4266_3.txt;14;1;0;15;408;0.03;0.0;0.0
4711_1.txt;3;0;0;3;192;0.02;0.0;0.0
5886_1.txt;9;0;0;9;213;0.04;0.0;0.0
6362_4.txt;8;0;0;8;269;0.03;0.0;0.0
2592_3.txt;2;0;10;12;882;0.0;0.0;0.01
10915_1.txt;0;1;0;1;131;0.0;0.01;0.0
8741_2.txt;2;0;1;3;132;0.02;0.0;0.01
8550_3.txt;19;4;6;29;499;0.04;0.01;0.01
9315_1.txt;1;0;0;1;228;0.0;0.0;0.0
2109_4.txt;15;1;0;16;143;0.1;0.01;0.0
3425_1.txt;12;0;0;12;148;0.08;0.0;0.0
6849_3.txt;2;1;0;3;215;0.01;0.0;0.0
11126_2.txt;1;2;0;3;333;0.0;0.01;0.0
11698_3.txt;2;0;0;2;279;0.01;0.0;0.0
7412_3.txt;0;0;0;0;129;0.0;0.0;0.0
2858_1.txt;0;0;3;3;209;0.0;0.0;0.01
12121_4.txt;26;6;0;32;500;0.05;0.01;0.0
6172_4.txt;19;10;1;30;430;0.04;0.02;0.0
8856_3.txt;16;3;0;19;380;0.04;0.01;0.0
6897_1.txt;0;0;0;0;146;0.0;0.0;0.0
3790_1.txt;0;0;0;0;137;0.0;0.0;0.0
8566_3.txt;5;0;2;7;651;0.01;0.0;0.0
10401_2.txt;0;0;0;0;477;0.0;0.0;0.0
9382_1.txt;0;0;0;0;49;0.0;0.0;0.0
7754_2.txt;4;0;0;4;359;0.01;0.0;0.0
9597_3.txt;0;0;1;1;186;0.0;0.0;0.01
9197_1.txt;13;3;0;16;618;0.02;0.0;0.0
1696_1.txt;4;0;0;4;587;0.01;0.0;0.0
4218_3.txt;1;0;2;3;236;0.0;0.0;0.01
5975_1.txt;2;1;0;3;346;0.01;0.0;0.0
8279_4.txt;10;0;0;10;191;0.05;0.0;0.0
1053_4.txt;2;1;0;3;93;0.02;0.01;0.0
11212_1.txt;0;0;0;0;128;0.0;0.0;0.0
6617_1.txt;4;0;0;4;135;0.03;0.0;0.0
4624_4.txt;2;0;0;2;201;0.01;0.0;0.0
3443_1.txt;1;0;0;1;314;0.0;0.0;0.0
865_1.txt;0;0;0;0;116;0.0;0.0;0.0
7489_1.txt;1;3;0;4;198;0.01;0.02;0.0
820_1.txt;19;0;2;21;109;0.17;0.0;0.02
11628_4.txt;8;2;4;14;303;0.03;0.01;0.01
4511_1.txt;2;1;0;3;131;0.02;0.01;0.0
5088_1.txt;0;0;0;0;130;0.0;0.0;0.0
771_4.txt;2;2;0;4;60;0.03;0.03;0.0
11139_1.txt;0;0;0;0;114;0.0;0.0;0.0
11573_3.txt;2;0;1;3;343;0.01;0.0;0.0
5745_3.txt;0;0;1;1;351;0.0;0.0;0.0
4406_4.txt;10;2;1;13;206;0.05;0.01;0.0
3667_1.txt;0;0;0;0;360;0.0;0.0;0.0
2246_4.txt;9;0;0;9;160;0.06;0.0;0.0
7116_1.txt;0;0;0;0;133;0.0;0.0;0.0
2025_1.txt;4;0;0;4;116;0.03;0.0;0.0
1932_2.txt;12;5;10;27;805;0.01;0.01;0.01
2766_2.txt;0;0;2;2;465;0.0;0.0;0.0
1353_1.txt;7;0;0;7;178;0.04;0.0;0.0
11312_2.txt;4;0;0;4;132;0.03;0.0;0.0
9668_1.txt;0;1;0;1;107;0.0;0.01;0.0
12169_1.txt;8;8;0;16;557;0.01;0.01;0.0
5561_3.txt;1;0;0;1;156;0.01;0.0;0.0
1711_2.txt;0;0;0;0;244;0.0;0.0;0.0
10389_4.txt;11;2;4;17;475;0.02;0.0;0.01
3092_2.txt;0;0;0;0;114;0.0;0.0;0.0
9791_3.txt;4;0;2;6;275;0.01;0.0;0.01
186_1.txt;26;15;3;44;1033;0.03;0.01;0.0
10723_4.txt;2;0;0;2;293;0.01;0.0;0.0
8799_4.txt;7;0;1;8;300;0.02;0.0;0.0
2479_3.txt;9;0;0;9;165;0.05;0.0;0.0
3934_2.txt;25;0;0;25;241;0.1;0.0;0.0
3261_4.txt;53;11;1;65;1048;0.05;0.01;0.0
1193_1.txt;2;0;2;4;136;0.01;0.0;0.01
7115_3.txt;0;0;0;0;181;0.0;0.0;0.0
3106_1.txt;2;0;0;2;443;0.0;0.0;0.0
98_1.txt;13;0;0;13;398;0.03;0.0;0.0
8771_4.txt;0;0;0;0;242;0.0;0.0;0.0
12061_4.txt;10;0;0;10;74;0.14;0.0;0.0
775_4.txt;12;0;0;12;241;0.05;0.0;0.0
8737_1.txt;5;0;0;5;748;0.01;0.0;0.0
9385_2.txt;9;1;0;10;321;0.03;0.0;0.0
11752_3.txt;2;0;0;2;82;0.02;0.0;0.0
10853_2.txt;2;0;0;2;470;0.0;0.0;0.0
10267_1.txt;0;0;0;0;51;0.0;0.0;0.0
7433_4.txt;36;1;0;37;207;0.17;0.0;0.0
11454_4.txt;0;0;0;0;179;0.0;0.0;0.0
10537_1.txt;30;0;0;30;150;0.2;0.0;0.0
3244_3.txt;0;0;0;0;228;0.0;0.0;0.0
8454_3.txt;0;0;0;0;142;0.0;0.0;0.0
7230_1.txt;7;0;0;7;291;0.02;0.0;0.0
1660_4.txt;10;0;0;10;229;0.04;0.0;0.0
12317_1.txt;1;0;1;2;116;0.01;0.0;0.01
5271_4.txt;4;0;0;4;462;0.01;0.0;0.0
1383_3.txt;0;1;0;1;135;0.0;0.01;0.0
6231_4.txt;5;0;0;5;215;0.02;0.0;0.0
8586_3.txt;2;0;0;2;145;0.01;0.0;0.0
3804_2.txt;3;2;2;7;163;0.02;0.01;0.01
244_4.txt;3;0;2;5;59;0.05;0.0;0.03
5977_1.txt;2;1;0;3;200;0.01;0.01;0.0
5566_2.txt;8;0;0;8;75;0.11;0.0;0.0
7900_4.txt;6;0;0;6;168;0.04;0.0;0.0
5698_1.txt;0;4;1;5;174;0.0;0.02;0.01
1943_4.txt;5;0;0;5;123;0.04;0.0;0.0
365_1.txt;3;0;0;3;124;0.02;0.0;0.0
3806_4.txt;10;1;2;13;203;0.05;0.0;0.01
6038_3.txt;0;0;0;0;120;0.0;0.0;0.0
7324_1.txt;4;0;0;4;241;0.02;0.0;0.0
2176_1.txt;6;0;0;6;140;0.04;0.0;0.0
94_1.txt;10;0;0;10;215;0.05;0.0;0.0
3265_2.txt;15;0;0;15;157;0.1;0.0;0.0
4630_1.txt;1;0;0;1;304;0.0;0.0;0.0
9509_1.txt;0;0;0;0;61;0.0;0.0;0.0
8676_3.txt;0;5;4;9;82;0.0;0.06;0.05
12105_4.txt;4;0;0;4;72;0.06;0.0;0.0
9136_1.txt;3;1;1;5;532;0.01;0.0;0.0
1768_4.txt;0;0;0;0;250;0.0;0.0;0.0
9957_1.txt;15;0;0;15;624;0.02;0.0;0.0
6505_1.txt;0;0;0;0;203;0.0;0.0;0.0
7739_4.txt;5;1;3;9;163;0.03;0.01;0.02
9352_2.txt;5;0;0;5;188;0.03;0.0;0.0
7942_1.txt;17;1;0;18;488;0.03;0.0;0.0
158_3.txt;4;4;4;12;131;0.03;0.03;0.03
8882_4.txt;25;2;0;27;218;0.11;0.01;0.0
7213_3.txt;5;0;0;5;287;0.02;0.0;0.0
11980_4.txt;30;0;1;31;443;0.07;0.0;0.0
2402_3.txt;10;0;0;10;71;0.14;0.0;0.0
8429_4.txt;2;1;0;3;162;0.01;0.01;0.0
4616_3.txt;0;0;0;0;205;0.0;0.0;0.0
5313_4.txt;22;5;0;27;708;0.03;0.01;0.0
3178_4.txt;2;0;0;2;147;0.01;0.0;0.0
1751_2.txt;7;3;0;10;146;0.05;0.02;0.0
373_4.txt;4;0;4;8;181;0.02;0.0;0.02
776_1.txt;1;0;0;1;182;0.01;0.0;0.0
4164_3.txt;6;3;0;9;324;0.02;0.01;0.0
815_2.txt;30;3;1;34;996;0.03;0.0;0.0
4195_3.txt;15;0;1;16;322;0.05;0.0;0.0
7176_1.txt;5;0;0;5;157;0.03;0.0;0.0
2959_1.txt;1;0;0;1;266;0.0;0.0;0.0
1549_2.txt;6;0;0;6;91;0.07;0.0;0.0
352_4.txt;4;0;0;4;111;0.04;0.0;0.0
1976_1.txt;0;0;0;0;144;0.0;0.0;0.0
11092_4.txt;15;3;4;22;623;0.02;0.0;0.01
1481_2.txt;0;0;0;0;121;0.0;0.0;0.0
12007_2.txt;4;0;1;5;194;0.02;0.0;0.01
6628_1.txt;4;0;0;4;189;0.02;0.0;0.0
1136_3.txt;3;3;5;11;183;0.02;0.02;0.03
11200_4.txt;38;7;2;47;717;0.05;0.01;0.0
4581_1.txt;4;1;3;8;377;0.01;0.0;0.01
8504_1.txt;21;4;6;31;816;0.03;0.0;0.01
953_4.txt;8;2;2;12;255;0.03;0.01;0.01
4199_3.txt;2;0;0;2;84;0.02;0.0;0.0
4443_3.txt;22;2;0;24;736;0.03;0.0;0.0
7_3.txt;3;0;0;3;352;0.01;0.0;0.0
4253_2.txt;4;0;0;4;200;0.02;0.0;0.0
8068_1.txt;0;0;0;0;387;0.0;0.0;0.0
11804_4.txt;43;0;0;43;441;0.1;0.0;0.0
7417_2.txt;2;3;0;5;148;0.01;0.02;0.0
6919_2.txt;10;3;1;14;349;0.03;0.01;0.0
4450_3.txt;7;0;0;7;162;0.04;0.0;0.0
11663_2.txt;16;3;4;23;187;0.09;0.02;0.02
3880_2.txt;0;0;0;0;337;0.0;0.0;0.0
1567_1.txt;0;0;0;0;78;0.0;0.0;0.0
6845_1.txt;8;0;0;8;234;0.03;0.0;0.0
4724_2.txt;9;0;1;10;142;0.06;0.0;0.01
11792_1.txt;12;3;0;15;198;0.06;0.02;0.0
11974_4.txt;1;0;0;1;324;0.0;0.0;0.0
11279_1.txt;1;0;0;1;149;0.01;0.0;0.0
11377_3.txt;0;0;0;0;155;0.0;0.0;0.0
11204_1.txt;4;0;0;4;288;0.01;0.0;0.0
1695_1.txt;0;1;0;1;210;0.0;0.0;0.0
11259_1.txt;7;0;0;7;88;0.08;0.0;0.0
632_1.txt;2;0;0;2;201;0.01;0.0;0.0
7798_1.txt;4;0;0;4;220;0.02;0.0;0.0
11298_3.txt;44;0;3;47;537;0.08;0.0;0.01
0_3.txt;7;0;0;7;123;0.06;0.0;0.0
11_3.txt;6;0;0;6;165;0.04;0.0;0.0
4652_1.txt;2;0;0;2;179;0.01;0.0;0.0
4948_2.txt;3;0;5;8;216;0.01;0.0;0.02
4783_4.txt;0;1;0;1;98;0.0;0.01;0.0
6449_2.txt;1;0;0;1;218;0.0;0.0;0.0
6134_1.txt;7;0;0;7;111;0.06;0.0;0.0
9428_2.txt;0;0;0;0;337;0.0;0.0;0.0
11403_3.txt;0;0;0;0;428;0.0;0.0;0.0
2568_3.txt;13;1;0;14;468;0.03;0.0;0.0
10193_1.txt;3;0;0;3;293;0.01;0.0;0.0
12025_1.txt;6;0;0;6;390;0.02;0.0;0.0
9687_3.txt;22;2;2;26;534;0.04;0.0;0.0
878_3.txt;11;0;0;11;178;0.06;0.0;0.0
1830_1.txt;0;0;0;0;148;0.0;0.0;0.0
8021_2.txt;0;0;0;0;151;0.0;0.0;0.0
1632_3.txt;5;0;0;5;180;0.03;0.0;0.0
12252_1.txt;0;0;0;0;199;0.0;0.0;0.0
1655_2.txt;3;2;0;5;344;0.01;0.01;0.0
6447_1.txt;2;3;0;5;171;0.01;0.02;0.0
1901_1.txt;2;1;0;3;215;0.01;0.0;0.0
1990_2.txt;7;0;0;7;154;0.05;0.0;0.0
10870_3.txt;21;4;5;30;224;0.09;0.02;0.02
12080_3.txt;1;0;0;1;213;0.0;0.0;0.0
2194_3.txt;1;0;0;1;169;0.01;0.0;0.0
638_2.txt;2;0;0;2;127;0.02;0.0;0.0
9088_4.txt;7;4;5;16;235;0.03;0.02;0.02
360_4.txt;8;2;0;10;214;0.04;0.01;0.0
8631_2.txt;2;1;0;3;103;0.02;0.01;0.0
6851_4.txt;0;0;0;0;401;0.0;0.0;0.0
4054_3.txt;7;2;0;9;385;0.02;0.01;0.0
963_4.txt;23;0;0;23;193;0.12;0.0;0.0
5984_4.txt;5;0;0;5;221;0.02;0.0;0.0
12275_2.txt;3;1;0;4;251;0.01;0.0;0.0
12308_3.txt;6;0;0;6;114;0.05;0.0;0.0
1338_3.txt;2;0;0;2;179;0.01;0.0;0.0
2806_2.txt;0;1;0;1;136;0.0;0.01;0.0
1154_3.txt;26;1;0;27;239;0.11;0.0;0.0
10962_3.txt;0;0;0;0;11;0.0;0.0;0.0
1844_3.txt;0;0;0;0;151;0.0;0.0;0.0
10798_1.txt;11;1;0;12;550;0.02;0.0;0.0
8104_3.txt;0;0;0;0;213;0.0;0.0;0.0
3945_4.txt;8;0;0;8;260;0.03;0.0;0.0
10664_3.txt;3;0;0;3;105;0.03;0.0;0.0
5173_3.txt;0;3;0;3;222;0.0;0.01;0.0
10581_1.txt;7;1;0;8;151;0.05;0.01;0.0
11554_1.txt;2;3;0;5;198;0.01;0.02;0.0
11529_1.txt;0;0;4;4;209;0.0;0.0;0.02
11846_2.txt;0;0;0;0;202;0.0;0.0;0.0
9659_4.txt;0;0;0;0;255;0.0;0.0;0.0
5098_1.txt;3;0;0;3;300;0.01;0.0;0.0
10880_1.txt;4;0;0;4;129;0.03;0.0;0.0
11690_2.txt;2;0;0;2;142;0.01;0.0;0.0
8958_3.txt;2;0;0;2;441;0.0;0.0;0.0
4280_1.txt;0;1;0;1;119;0.0;0.01;0.0
4372_2.txt;9;0;1;10;294;0.03;0.0;0.0
10413_1.txt;4;0;0;4;157;0.03;0.0;0.0
1887_2.txt;4;5;0;9;368;0.01;0.01;0.0
6903_1.txt;0;0;0;0;91;0.0;0.0;0.0
9880_1.txt;0;0;0;0;129;0.0;0.0;0.0
10608_2.txt;4;0;0;4;155;0.03;0.0;0.0
5153_4.txt;2;0;0;2;36;0.06;0.0;0.0
2252_3.txt;7;0;0;7;308;0.02;0.0;0.0
11869_4.txt;0;0;0;0;86;0.0;0.0;0.0
9729_1.txt;4;1;0;5;177;0.02;0.01;0.0
10544_4.txt;14;0;0;14;405;0.03;0.0;0.0
2857_1.txt;3;8;0;11;390;0.01;0.02;0.0
7697_4.txt;1;0;0;1;310;0.0;0.0;0.0
2956_1.txt;5;0;0;5;127;0.04;0.0;0.0
3150_1.txt;5;1;0;6;60;0.08;0.02;0.0
9756_4.txt;5;0;1;6;198;0.03;0.0;0.01
4384_1.txt;1;0;0;1;381;0.0;0.0;0.0
4825_1.txt;2;0;0;2;137;0.01;0.0;0.0
2069_1.txt;13;1;0;14;230;0.06;0.0;0.0
10460_3.txt;1;0;0;1;53;0.02;0.0;0.0
7099_4.txt;0;0;0;0;50;0.0;0.0;0.0
2768_2.txt;0;0;0;0;122;0.0;0.0;0.0
4990_1.txt;0;0;0;0;139;0.0;0.0;0.0
2100_3.txt;1;1;1;3;181;0.01;0.01;0.01
1007_1.txt;9;0;0;9;239;0.04;0.0;0.0
2228_1.txt;9;2;2;13;195;0.05;0.01;0.01
1123_1.txt;0;0;0;0;62;0.0;0.0;0.0
7851_2.txt;12;0;0;12;404;0.03;0.0;0.0
5735_2.txt;0;1;0;1;258;0.0;0.0;0.0
7019_4.txt;3;2;0;5;357;0.01;0.01;0.0
3099_1.txt;1;0;0;1;210;0.0;0.0;0.0
6887_3.txt;10;0;0;10;148;0.07;0.0;0.0
5420_4.txt;15;2;1;18;182;0.08;0.01;0.01
1021_1.txt;10;0;0;10;271;0.04;0.0;0.0
12417_1.txt;1;1;0;2;155;0.01;0.01;0.0
7289_1.txt;0;0;0;0;109;0.0;0.0;0.0
4618_3.txt;19;2;1;22;1070;0.02;0.0;0.0
1759_4.txt;5;1;0;6;215;0.02;0.0;0.0
9585_1.txt;0;0;0;0;188;0.0;0.0;0.0
6613_4.txt;22;1;4;27;223;0.1;0.0;0.02
5760_4.txt;0;0;3;3;241;0.0;0.0;0.01
6704_1.txt;0;0;0;0;144;0.0;0.0;0.0
11167_1.txt;2;0;0;2;221;0.01;0.0;0.0
3922_3.txt;3;0;0;3;61;0.05;0.0;0.0
4341_1.txt;1;0;0;1;149;0.01;0.0;0.0
11257_1.txt;0;0;0;0;212;0.0;0.0;0.0
5552_1.txt;1;0;3;4;258;0.0;0.0;0.01
11522_2.txt;8;0;0;8;273;0.03;0.0;0.0
8861_1.txt;26;2;2;30;284;0.09;0.01;0.01
5725_3.txt;5;2;0;7;247;0.02;0.01;0.0
11882_1.txt;2;0;0;2;413;0.0;0.0;0.0
2687_1.txt;15;6;0;21;148;0.1;0.04;0.0
8375_1.txt;17;2;1;20;552;0.03;0.0;0.0
6801_4.txt;6;0;0;6;354;0.02;0.0;0.0
9996_4.txt;11;5;1;17;241;0.05;0.02;0.0
3732_4.txt;0;0;0;0;164;0.0;0.0;0.0
11289_4.txt;7;5;0;12;165;0.04;0.03;0.0
19_4.txt;8;0;0;8;205;0.04;0.0;0.0
7898_1.txt;0;0;0;0;151;0.0;0.0;0.0
2495_4.txt;12;0;0;12;741;0.02;0.0;0.0
238_4.txt;2;0;0;2;140;0.01;0.0;0.0
7394_2.txt;21;2;6;29;789;0.03;0.0;0.01
6459_3.txt;6;0;0;6;158;0.04;0.0;0.0
2754_1.txt;0;0;0;0;346;0.0;0.0;0.0
8615_2.txt;3;0;0;3;136;0.02;0.0;0.0
12059_3.txt;9;0;0;9;405;0.02;0.0;0.0
10028_2.txt;49;0;0;49;362;0.14;0.0;0.0
952_3.txt;13;1;0;14;229;0.06;0.0;0.0
4930_1.txt;0;0;0;0;65;0.0;0.0;0.0
10165_3.txt;2;16;0;18;419;0.0;0.04;0.0
6756_4.txt;26;0;5;31;538;0.05;0.0;0.01
7554_3.txt;2;1;0;3;168;0.01;0.01;0.0
1043_3.txt;0;0;0;0;144;0.0;0.0;0.0
3965_3.txt;0;0;0;0;396;0.0;0.0;0.0
4567_1.txt;0;0;2;2;198;0.0;0.0;0.01
10270_1.txt;7;0;0;7;271;0.03;0.0;0.0
12338_1.txt;4;0;0;4;189;0.02;0.0;0.0
8247_3.txt;2;0;0;2;121;0.02;0.0;0.0
1842_1.txt;8;0;0;8;175;0.05;0.0;0.0
5545_2.txt;4;0;2;6;459;0.01;0.0;0.0
6217_1.txt;13;1;1;15;995;0.01;0.0;0.0
8417_3.txt;34;2;0;36;328;0.1;0.01;0.0
10029_1.txt;19;4;0;23;333;0.06;0.01;0.0
9877_4.txt;18;0;0;18;272;0.07;0.0;0.0
6710_1.txt;0;0;0;0;69;0.0;0.0;0.0
6731_4.txt;0;0;0;0;182;0.0;0.0;0.0
607_3.txt;7;5;0;12;435;0.02;0.01;0.0
1254_4.txt;2;0;0;2;179;0.01;0.0;0.0
3495_1.txt;14;0;0;14;221;0.06;0.0;0.0
6667_4.txt;2;0;2;4;165;0.01;0.0;0.01
39_2.txt;0;1;0;1;309;0.0;0.0;0.0
11964_4.txt;11;0;0;11;155;0.07;0.0;0.0
7783_1.txt;2;1;0;3;132;0.02;0.01;0.0
4773_1.txt;2;0;0;2;139;0.01;0.0;0.0
4338_1.txt;1;1;3;5;191;0.01;0.01;0.02
8727_2.txt;5;0;0;5;394;0.01;0.0;0.0
6273_1.txt;0;0;0;0;138;0.0;0.0;0.0
2653_1.txt;3;0;0;3;159;0.02;0.0;0.0
11294_1.txt;4;1;0;5;226;0.02;0.0;0.0
619_1.txt;0;0;0;0;187;0.0;0.0;0.0
9898_1.txt;5;1;0;6;161;0.03;0.01;0.0
5801_1.txt;5;0;0;5;191;0.03;0.0;0.0
3108_3.txt;18;0;0;18;211;0.09;0.0;0.0
3592_3.txt;0;0;2;2;361;0.0;0.0;0.01
1178_2.txt;0;0;0;0;125;0.0;0.0;0.0
6987_1.txt;19;1;3;23;455;0.04;0.0;0.01
4416_4.txt;3;0;2;5;187;0.02;0.0;0.01
3838_3.txt;8;0;0;8;180;0.04;0.0;0.0
691_3.txt;0;0;0;0;142;0.0;0.0;0.0
9571_3.txt;2;0;0;2;1164;0.0;0.0;0.0
8874_2.txt;2;0;0;2;126;0.02;0.0;0.0
8963_1.txt;0;0;0;0;163;0.0;0.0;0.0
2990_2.txt;0;0;0;0;403;0.0;0.0;0.0
10189_4.txt;12;1;0;13;161;0.07;0.01;0.0
8192_1.txt;4;1;0;5;198;0.02;0.01;0.0
3700_2.txt;0;0;0;0;153;0.0;0.0;0.0
11098_1.txt;7;2;0;9;471;0.01;0.0;0.0
6284_4.txt;0;0;0;0;177;0.0;0.0;0.0
8732_1.txt;0;0;0;0;110;0.0;0.0;0.0
11762_1.txt;8;2;0;10;228;0.04;0.01;0.0
5934_2.txt;24;0;0;24;384;0.06;0.0;0.0
6368_4.txt;8;0;0;8;112;0.07;0.0;0.0
9909_3.txt;2;0;0;2;108;0.02;0.0;0.0
6592_1.txt;1;0;1;2;133;0.01;0.0;0.01
10223_4.txt;14;1;0;15;187;0.07;0.01;0.0
11171_3.txt;3;0;0;3;202;0.01;0.0;0.0
8554_1.txt;4;0;0;4;135;0.03;0.0;0.0
6907_2.txt;0;0;0;0;68;0.0;0.0;0.0
9099_1.txt;11;0;1;12;248;0.04;0.0;0.0
4305_3.txt;7;5;14;26;493;0.01;0.01;0.03
6490_1.txt;3;4;0;7;483;0.01;0.01;0.0
6856_3.txt;36;1;0;37;697;0.05;0.0;0.0
11415_1.txt;0;2;0;2;685;0.0;0.0;0.0
8327_1.txt;0;0;2;2;147;0.0;0.0;0.01
5998_1.txt;20;5;2;27;507;0.04;0.01;0.0
10941_1.txt;7;0;0;7;159;0.04;0.0;0.0
7994_4.txt;2;0;0;2;196;0.01;0.0;0.0
9763_4.txt;18;0;4;22;128;0.14;0.0;0.03
5074_2.txt;1;1;0;2;177;0.01;0.01;0.0
6288_3.txt;6;0;0;6;215;0.03;0.0;0.0
6935_2.txt;14;17;3;34;1076;0.01;0.02;0.0
7558_1.txt;4;0;0;4;154;0.03;0.0;0.0
6021_1.txt;0;0;1;1;162;0.0;0.0;0.01
11942_1.txt;8;0;0;8;214;0.04;0.0;0.0
1748_1.txt;12;5;3;20;385;0.03;0.01;0.01
11852_1.txt;2;0;0;2;275;0.01;0.0;0.0
6015_1.txt;3;1;2;6;574;0.01;0.0;0.0
7996_2.txt;3;0;0;3;183;0.02;0.0;0.0
11800_4.txt;35;0;2;37;524;0.07;0.0;0.0
2491_1.txt;0;0;2;2;128;0.0;0.0;0.02
1950_4.txt;1;0;0;1;142;0.01;0.0;0.0
8722_1.txt;6;0;0;6;200;0.03;0.0;0.0
903_3.txt;12;0;0;12;184;0.07;0.0;0.0
4988_2.txt;9;1;10;20;385;0.02;0.0;0.03
1783_2.txt;6;0;0;6;176;0.03;0.0;0.0
11324_3.txt;21;2;0;23;510;0.04;0.0;0.0
1960_1.txt;0;0;0;0;145;0.0;0.0;0.0
541_4.txt;7;0;0;7;150;0.05;0.0;0.0
12044_1.txt;16;0;0;16;444;0.04;0.0;0.0
715_2.txt;6;1;0;7;329;0.02;0.0;0.0
2224_3.txt;0;0;0;0;196;0.0;0.0;0.0
6184_4.txt;0;0;0;0;196;0.0;0.0;0.0
10040_2.txt;6;0;0;6;287;0.02;0.0;0.0
212_4.txt;4;3;0;7;219;0.02;0.01;0.0
400_2.txt;2;4;1;7;211;0.01;0.02;0.0
3302_3.txt;2;0;0;2;219;0.01;0.0;0.0
3691_3.txt;7;2;0;9;133;0.05;0.02;0.0
7179_1.txt;4;0;0;4;148;0.03;0.0;0.0
4937_2.txt;0;0;1;1;185;0.0;0.0;0.01
1953_2.txt;11;0;0;11;189;0.06;0.0;0.0
4725_1.txt;35;2;0;37;394;0.09;0.01;0.0
9143_2.txt;1;3;2;6;175;0.01;0.02;0.01
8182_1.txt;0;0;0;0;51;0.0;0.0;0.0
4194_3.txt;0;1;0;1;227;0.0;0.0;0.0
8389_1.txt;0;0;0;0;69;0.0;0.0;0.0
7924_1.txt;9;1;0;10;369;0.02;0.0;0.0
7803_2.txt;7;0;0;7;293;0.02;0.0;0.0
6659_1.txt;13;0;3;16;234;0.06;0.0;0.01
2231_1.txt;2;0;0;2;160;0.01;0.0;0.0
7761_2.txt;0;0;0;0;268;0.0;0.0;0.0
4578_1.txt;1;0;5;6;181;0.01;0.0;0.03
5249_1.txt;0;0;0;0;142;0.0;0.0;0.0
8342_4.txt;19;0;0;19;386;0.05;0.0;0.0
10326_1.txt;1;1;3;5;610;0.0;0.0;0.0
2101_4.txt;16;0;0;16;377;0.04;0.0;0.0
9455_1.txt;5;1;0;6;252;0.02;0.0;0.0
1005_3.txt;3;0;0;3;178;0.02;0.0;0.0
6166_1.txt;0;2;0;2;154;0.0;0.01;0.0
7605_4.txt;15;2;0;17;144;0.1;0.01;0.0
10805_2.txt;5;1;0;6;154;0.03;0.01;0.0
7961_4.txt;19;0;0;19;377;0.05;0.0;0.0
5627_4.txt;2;0;0;2;153;0.01;0.0;0.0
10711_4.txt;6;4;0;10;387;0.02;0.01;0.0
5787_4.txt;3;0;0;3;107;0.03;0.0;0.0
11477_4.txt;8;4;0;12;159;0.05;0.03;0.0
2379_1.txt;3;0;1;4;116;0.03;0.0;0.01
5459_2.txt;4;0;0;4;220;0.02;0.0;0.0
7093_1.txt;0;0;0;0;158;0.0;0.0;0.0
8606_2.txt;5;1;0;6;254;0.02;0.0;0.0
7079_1.txt;5;0;0;5;84;0.06;0.0;0.0
11431_1.txt;11;1;0;12;369;0.03;0.0;0.0
8940_3.txt;23;6;8;37;509;0.05;0.01;0.02
187_2.txt;0;0;0;0;50;0.0;0.0;0.0
5981_3.txt;4;0;0;4;127;0.03;0.0;0.0
9377_1.txt;0;0;0;0;58;0.0;0.0;0.0
8009_1.txt;2;1;0;3;69;0.03;0.01;0.0
6934_4.txt;6;0;0;6;232;0.03;0.0;0.0
10630_1.txt;0;2;1;3;499;0.0;0.0;0.0
7770_1.txt;6;0;0;6;222;0.03;0.0;0.0
12399_3.txt;0;0;0;0;76;0.0;0.0;0.0
7620_1.txt;2;0;1;3;404;0.0;0.0;0.0
2008_4.txt;11;0;0;11;236;0.05;0.0;0.0
10400_1.txt;0;0;0;0;198;0.0;0.0;0.0
9578_4.txt;0;0;0;0;103;0.0;0.0;0.0
10406_3.txt;10;0;0;10;410;0.02;0.0;0.0
1076_1.txt;3;0;0;3;87;0.03;0.0;0.0
3330_4.txt;7;0;0;7;125;0.06;0.0;0.0
6928_2.txt;5;2;0;7;211;0.02;0.01;0.0
12255_3.txt;4;0;4;8;222;0.02;0.0;0.02
11514_1.txt;3;0;0;3;164;0.02;0.0;0.0
93_1.txt;0;0;2;2;437;0.0;0.0;0.0
1996_3.txt;9;1;0;10;235;0.04;0.0;0.0
7531_4.txt;0;0;0;0;165;0.0;0.0;0.0
8898_3.txt;0;1;0;1;386;0.0;0.0;0.0
8776_2.txt;7;0;0;7;153;0.05;0.0;0.0
2788_4.txt;5;0;0;5;308;0.02;0.0;0.0
1547_1.txt;6;2;0;8;367;0.02;0.01;0.0
1437_1.txt;7;0;0;7;140;0.05;0.0;0.0
5137_4.txt;15;0;0;15;1139;0.01;0.0;0.0
6455_3.txt;6;0;0;6;253;0.02;0.0;0.0
8957_3.txt;4;9;0;13;385;0.01;0.02;0.0
10871_4.txt;27;5;2;34;896;0.03;0.01;0.0
3739_2.txt;5;0;1;6;183;0.03;0.0;0.01
9657_3.txt;0;3;0;3;173;0.0;0.02;0.0
11086_4.txt;13;0;0;13;205;0.06;0.0;0.0
10245_3.txt;2;1;0;3;150;0.01;0.01;0.0
8864_1.txt;8;0;0;8;171;0.05;0.0;0.0
9291_4.txt;0;0;0;0;267;0.0;0.0;0.0
73_1.txt;13;0;0;13;318;0.04;0.0;0.0
9336_4.txt;6;0;0;6;150;0.04;0.0;0.0
11115_1.txt;3;0;0;3;158;0.02;0.0;0.0
7069_4.txt;12;0;0;12;280;0.04;0.0;0.0
10019_3.txt;25;0;0;25;544;0.05;0.0;0.0
5946_4.txt;5;0;0;5;162;0.03;0.0;0.0
1870_1.txt;2;0;0;2;343;0.01;0.0;0.0
10282_2.txt;0;0;0;0;158;0.0;0.0;0.0
7925_1.txt;3;0;0;3;299;0.01;0.0;0.0
8281_1.txt;8;0;0;8;125;0.06;0.0;0.0
12138_1.txt;0;0;0;0;70;0.0;0.0;0.0
1225_3.txt;2;0;0;2;211;0.01;0.0;0.0
5521_1.txt;2;0;0;2;192;0.01;0.0;0.0
2814_3.txt;17;0;0;17;208;0.08;0.0;0.0
3509_4.txt;1;0;0;1;174;0.01;0.0;0.0
8070_3.txt;15;0;1;16;414;0.04;0.0;0.0
11045_1.txt;2;0;0;2;55;0.04;0.0;0.0
12330_4.txt;25;9;0;34;723;0.03;0.01;0.0
8354_2.txt;11;2;0;13;348;0.03;0.01;0.0
3890_2.txt;2;0;0;2;65;0.03;0.0;0.0
2036_4.txt;2;0;0;2;227;0.01;0.0;0.0
5857_1.txt;8;1;1;10;382;0.02;0.0;0.0
7413_2.txt;0;0;0;0;225;0.0;0.0;0.0
9034_2.txt;13;0;0;13;228;0.06;0.0;0.0
9358_4.txt;0;2;0;2;146;0.0;0.01;0.0
6253_2.txt;0;6;1;7;192;0.0;0.03;0.01
10799_1.txt;2;2;0;4;232;0.01;0.01;0.0
6796_1.txt;6;0;0;6;127;0.05;0.0;0.0
5902_4.txt;1;2;0;3;178;0.01;0.01;0.0
6853_1.txt;4;3;0;7;127;0.03;0.02;0.0
10372_3.txt;1;0;0;1;118;0.01;0.0;0.0
1305_1.txt;18;1;1;20;251;0.07;0.0;0.0
4267_3.txt;0;1;1;2;181;0.0;0.01;0.01
11121_1.txt;0;0;0;0;404;0.0;0.0;0.0
7365_4.txt;23;2;4;29;180;0.13;0.01;0.02
6192_1.txt;2;0;0;2;118;0.02;0.0;0.0
1916_1.txt;4;1;0;5;220;0.02;0.0;0.0
286_1.txt;14;1;2;17;606;0.02;0.0;0.0
85_2.txt;33;4;3;40;972;0.03;0.0;0.0
4877_2.txt;9;0;0;9;136;0.07;0.0;0.0
10790_3.txt;2;0;0;2;298;0.01;0.0;0.0
6599_1.txt;22;4;12;38;654;0.03;0.01;0.02
1798_1.txt;2;0;0;2;164;0.01;0.0;0.0
6526_2.txt;2;1;0;3;155;0.01;0.01;0.0
10957_3.txt;12;1;5;18;606;0.02;0.0;0.01
1843_1.txt;10;2;0;12;251;0.04;0.01;0.0
8458_1.txt;11;0;0;11;348;0.03;0.0;0.0
6751_1.txt;1;0;0;1;146;0.01;0.0;0.0
729_2.txt;0;0;1;1;132;0.0;0.0;0.01
2172_2.txt;0;3;1;4;185;0.0;0.02;0.01
9669_1.txt;0;1;0;1;66;0.0;0.02;0.0
11068_4.txt;3;0;0;3;203;0.01;0.0;0.0
8161_3.txt;4;0;0;4;180;0.02;0.0;0.0
802_4.txt;1;0;0;1;197;0.01;0.0;0.0
7923_1.txt;13;0;0;13;346;0.04;0.0;0.0
4925_1.txt;4;0;2;6;117;0.03;0.0;0.02
8779_4.txt;0;0;3;3;145;0.0;0.0;0.02
2987_2.txt;1;0;0;1;111;0.01;0.0;0.0
991_2.txt;2;0;0;2;129;0.02;0.0;0.0
5573_2.txt;1;2;0;3;475;0.0;0.0;0.0
7022_1.txt;14;0;0;14;199;0.07;0.0;0.0
11119_2.txt;11;0;5;16;270;0.04;0.0;0.02
10013_1.txt;5;1;0;6;148;0.03;0.01;0.0
1267_1.txt;0;1;0;1;157;0.0;0.01;0.0
5497_3.txt;0;0;0;0;53;0.0;0.0;0.0
6450_1.txt;0;0;0;0;143;0.0;0.0;0.0
12153_3.txt;14;0;0;14;397;0.04;0.0;0.0
7732_4.txt;7;0;0;7;126;0.06;0.0;0.0
8830_3.txt;0;0;0;0;154;0.0;0.0;0.0
1749_3.txt;2;0;0;2;117;0.02;0.0;0.0
7752_3.txt;1;0;0;1;203;0.0;0.0;0.0
9920_3.txt;12;1;2;15;328;0.04;0.0;0.01
3931_4.txt;17;3;7;27;937;0.02;0.0;0.01
8381_1.txt;16;1;5;22;310;0.05;0.0;0.02
7719_3.txt;15;5;6;26;446;0.03;0.01;0.01
6094_1.txt;0;0;0;0;359;0.0;0.0;0.0
8428_1.txt;2;2;0;4;247;0.01;0.01;0.0
7871_2.txt;17;1;0;18;325;0.05;0.0;0.0
1623_1.txt;11;0;4;15;194;0.06;0.0;0.02
6295_1.txt;2;0;0;2;117;0.02;0.0;0.0
792_1.txt;0;1;1;2;132;0.0;0.01;0.01
6289_1.txt;10;1;0;11;123;0.08;0.01;0.0
8822_3.txt;3;2;0;5;354;0.01;0.01;0.0
4047_1.txt;15;8;6;29;1135;0.01;0.01;0.01
11290_1.txt;2;0;0;2;174;0.01;0.0;0.0
11356_3.txt;0;0;1;1;127;0.0;0.0;0.01
747_1.txt;4;2;0;6;148;0.03;0.01;0.0
583_3.txt;12;0;1;13;401;0.03;0.0;0.0
11989_1.txt;2;0;0;2;204;0.01;0.0;0.0
9106_1.txt;19;2;0;21;320;0.06;0.01;0.0
8610_2.txt;2;0;0;2;67;0.03;0.0;0.0
2664_1.txt;2;1;0;3;74;0.03;0.01;0.0
1690_1.txt;4;0;0;4;141;0.03;0.0;0.0
1378_1.txt;3;0;0;3;148;0.02;0.0;0.0
467_1.txt;3;0;0;3;173;0.02;0.0;0.0
3398_3.txt;3;6;0;9;140;0.02;0.04;0.0
6614_4.txt;21;2;1;24;533;0.04;0.0;0.0
2526_3.txt;12;1;0;13;388;0.03;0.0;0.0
6932_4.txt;4;0;0;4;185;0.02;0.0;0.0
203_1.txt;26;2;0;28;1029;0.03;0.0;0.0
12235_2.txt;0;0;0;0;208;0.0;0.0;0.0
2593_2.txt;0;0;9;9;325;0.0;0.0;0.03
5191_2.txt;8;2;3;13;346;0.02;0.01;0.01
11367_2.txt;8;0;3;11;158;0.05;0.0;0.02
9132_4.txt;18;3;1;22;310;0.06;0.01;0.0
2391_2.txt;1;0;0;1;314;0.0;0.0;0.0
10465_2.txt;0;0;0;0;407;0.0;0.0;0.0
8017_3.txt;2;0;1;3;370;0.01;0.0;0.0
5644_2.txt;12;0;1;13;261;0.05;0.0;0.0
5037_4.txt;8;0;0;8;272;0.03;0.0;0.0
2710_1.txt;0;0;3;3;148;0.0;0.0;0.02
4289_3.txt;3;0;0;3;154;0.02;0.0;0.0
4544_1.txt;0;0;0;0;169;0.0;0.0;0.0
12306_2.txt;2;0;0;2;103;0.02;0.0;0.0
12486_2.txt;25;0;0;25;301;0.08;0.0;0.0
42_3.txt;15;1;1;17;301;0.05;0.0;0.0
3538_1.txt;6;2;1;9;645;0.01;0.0;0.0
4264_1.txt;0;0;0;0;161;0.0;0.0;0.0
12496_1.txt;0;0;0;0;220;0.0;0.0;0.0
8471_1.txt;0;0;0;0;50;0.0;0.0;0.0
10133_1.txt;1;0;0;1;149;0.01;0.0;0.0
9253_4.txt;2;2;0;4;264;0.01;0.01;0.0
4779_1.txt;1;0;2;3;149;0.01;0.0;0.01
11541_1.txt;0;0;2;2;315;0.0;0.0;0.01
683_4.txt;10;3;0;13;216;0.05;0.01;0.0
2161_4.txt;14;1;0;15;229;0.06;0.0;0.0
11959_2.txt;0;1;0;1;133;0.0;0.01;0.0
8061_2.txt;9;1;0;10;229;0.04;0.0;0.0
4961_2.txt;3;1;0;4;186;0.02;0.01;0.0
10419_1.txt;1;0;0;1;199;0.01;0.0;0.0
10363_2.txt;0;0;2;2;140;0.0;0.0;0.01
6276_3.txt;18;2;0;20;231;0.08;0.01;0.0
8177_3.txt;10;0;2;12;276;0.04;0.0;0.01
9759_2.txt;0;0;0;0;352;0.0;0.0;0.0
9257_4.txt;0;0;0;0;76;0.0;0.0;0.0
1113_2.txt;5;0;0;5;93;0.05;0.0;0.0
2709_2.txt;2;0;0;2;146;0.01;0.0;0.0
1859_3.txt;2;0;0;2;278;0.01;0.0;0.0
8746_2.txt;0;1;1;2;195;0.0;0.01;0.01
11993_1.txt;8;0;0;8;894;0.01;0.0;0.0
11774_3.txt;1;1;0;2;399;0.0;0.0;0.0
11799_2.txt;3;8;0;11;160;0.02;0.05;0.0
9096_1.txt;5;0;0;5;206;0.02;0.0;0.0
808_2.txt;25;2;2;29;325;0.08;0.01;0.01
1904_1.txt;7;0;0;7;355;0.02;0.0;0.0
5654_4.txt;28;2;3;33;287;0.1;0.01;0.01
5161_1.txt;0;0;0;0;129;0.0;0.0;0.0
5114_4.txt;0;0;0;0;86;0.0;0.0;0.0
10894_4.txt;0;0;0;0;211;0.0;0.0;0.0
6843_4.txt;14;1;0;15;150;0.09;0.01;0.0
3983_3.txt;8;0;4;12;166;0.05;0.0;0.02
7660_1.txt;25;0;0;25;171;0.15;0.0;0.0
6232_4.txt;6;5;0;11;395;0.02;0.01;0.0
3571_1.txt;15;1;0;16;196;0.08;0.01;0.0
11652_4.txt;3;2;0;5;213;0.01;0.01;0.0
8570_2.txt;8;0;0;8;287;0.03;0.0;0.0
6949_1.txt;5;1;1;7;433;0.01;0.0;0.0
7083_1.txt;9;0;0;9;152;0.06;0.0;0.0
6721_3.txt;0;2;0;2;52;0.0;0.04;0.0
9572_1.txt;0;0;0;0;62;0.0;0.0;0.0
9226_4.txt;0;0;0;0;151;0.0;0.0;0.0
1636_1.txt;0;0;0;0;80;0.0;0.0;0.0
12421_4.txt;7;0;0;7;241;0.03;0.0;0.0
7242_1.txt;3;4;0;7;105;0.03;0.04;0.0
2508_4.txt;0;0;4;4;204;0.0;0.0;0.02
8524_4.txt;10;29;0;39;1068;0.01;0.03;0.0
105_2.txt;3;0;1;4;193;0.02;0.0;0.01
4611_1.txt;5;0;1;6;209;0.02;0.0;0.0
7343_2.txt;0;0;0;0;195;0.0;0.0;0.0
2146_1.txt;2;0;2;4;168;0.01;0.0;0.01
5193_3.txt;19;1;5;25;295;0.06;0.0;0.02
2595_3.txt;0;0;0;0;90;0.0;0.0;0.0
11127_3.txt;8;0;0;8;207;0.04;0.0;0.0
2498_1.txt;1;0;2;3;402;0.0;0.0;0.0
11483_2.txt;8;2;0;10;273;0.03;0.01;0.0
10101_1.txt;0;0;0;0;223;0.0;0.0;0.0
3925_1.txt;7;0;0;7;211;0.03;0.0;0.0
10539_4.txt;16;2;7;25;543;0.03;0.0;0.01
11653_1.txt;1;0;0;1;73;0.01;0.0;0.0
10786_3.txt;2;0;0;2;147;0.01;0.0;0.0
6597_1.txt;7;1;3;11;233;0.03;0.0;0.01
5368_3.txt;9;2;2;13;342;0.03;0.01;0.01
5105_4.txt;7;1;0;8;166;0.04;0.01;0.0
9723_1.txt;1;2;0;3;190;0.01;0.01;0.0
11916_3.txt;2;0;0;2;203;0.01;0.0;0.0
10283_1.txt;2;2;1;5;645;0.0;0.0;0.0
226_4.txt;2;0;0;2;198;0.01;0.0;0.0
8931_4.txt;46;3;1;50;841;0.05;0.0;0.0
12034_3.txt;0;0;0;0;141;0.0;0.0;0.0
1497_2.txt;5;1;0;6;247;0.02;0.0;0.0
11445_3.txt;5;0;0;5;142;0.04;0.0;0.0
2801_2.txt;9;0;1;10;222;0.04;0.0;0.0
7749_1.txt;0;0;0;0;191;0.0;0.0;0.0
1364_4.txt;2;0;0;2;250;0.01;0.0;0.0
12334_4.txt;7;2;0;9;146;0.05;0.01;0.0
4989_3.txt;13;0;0;13;307;0.04;0.0;0.0
2397_4.txt;4;1;2;7;300;0.01;0.0;0.01
7585_3.txt;4;0;2;6;229;0.02;0.0;0.01
8819_1.txt;0;0;0;0;298;0.0;0.0;0.0
8246_3.txt;26;1;0;27;229;0.11;0.0;0.0
8091_4.txt;11;0;1;12;489;0.02;0.0;0.0
6024_1.txt;0;0;0;0;222;0.0;0.0;0.0
10408_1.txt;3;0;0;3;183;0.02;0.0;0.0
3814_1.txt;9;0;1;10;313;0.03;0.0;0.0
12287_3.txt;25;5;0;30;402;0.06;0.01;0.0
8213_4.txt;3;0;2;5;164;0.02;0.0;0.01
3646_1.txt;1;0;0;1;158;0.01;0.0;0.0
12423_2.txt;11;0;0;11;250;0.04;0.0;0.0
12437_1.txt;1;0;0;1;199;0.01;0.0;0.0
796_3.txt;3;0;1;4;64;0.05;0.0;0.02
3284_1.txt;16;4;0;20;339;0.05;0.01;0.0
1735_2.txt;9;0;0;9;356;0.03;0.0;0.0
6103_2.txt;12;0;0;12;213;0.06;0.0;0.0
10017_4.txt;0;0;2;2;215;0.0;0.0;0.01
3046_4.txt;0;5;3;8;205;0.0;0.02;0.01
3148_4.txt;13;0;1;14;154;0.08;0.0;0.01
8118_3.txt;2;0;0;2;214;0.01;0.0;0.0
9907_4.txt;19;2;2;23;520;0.04;0.0;0.0
10773_1.txt;0;0;0;0;139;0.0;0.0;0.0
172_1.txt;2;1;0;3;141;0.01;0.01;0.0
4572_1.txt;3;0;0;3;137;0.02;0.0;0.0
7877_4.txt;0;0;0;0;84;0.0;0.0;0.0
8259_1.txt;5;1;0;6;573;0.01;0.0;0.0
6915_4.txt;7;0;0;7;250;0.03;0.0;0.0
10700_3.txt;7;0;2;9;244;0.03;0.0;0.01
9140_2.txt;0;0;0;0;154;0.0;0.0;0.0
6162_1.txt;6;2;0;8;191;0.03;0.01;0.0
222_1.txt;2;0;0;2;182;0.01;0.0;0.0
4015_1.txt;1;1;3;5;146;0.01;0.01;0.02
7315_1.txt;0;0;0;0;365;0.0;0.0;0.0
269_1.txt;21;8;0;29;596;0.04;0.01;0.0
350_2.txt;3;0;0;3;146;0.02;0.0;0.0
5073_1.txt;0;5;0;5;352;0.0;0.01;0.0
2611_3.txt;0;0;0;0;49;0.0;0.0;0.0
5681_3.txt;5;0;0;5;294;0.02;0.0;0.0
10182_3.txt;0;0;0;0;161;0.0;0.0;0.0
8254_1.txt;0;0;1;1;137;0.0;0.0;0.01
4847_1.txt;0;2;0;2;332;0.0;0.01;0.0
2808_3.txt;4;1;5;10;154;0.03;0.01;0.03
9129_4.txt;11;2;1;14;165;0.07;0.01;0.01
3906_1.txt;0;0;0;0;78;0.0;0.0;0.0
6937_2.txt;4;0;0;4;318;0.01;0.0;0.0
925_1.txt;0;0;0;0;142;0.0;0.0;0.0
5817_1.txt;1;0;0;1;130;0.01;0.0;0.0
9744_1.txt;1;3;0;4;201;0.0;0.01;0.0
6283_2.txt;4;0;0;4;292;0.01;0.0;0.0
3907_3.txt;4;0;2;6;177;0.02;0.0;0.01
10251_3.txt;0;0;0;0;148;0.0;0.0;0.0
470_3.txt;1;0;0;1;191;0.01;0.0;0.0
9827_1.txt;3;0;0;3;205;0.01;0.0;0.0
111_4.txt;6;0;0;6;89;0.07;0.0;0.0
5152_1.txt;2;0;0;2;60;0.03;0.0;0.0
11574_3.txt;8;4;0;12;254;0.03;0.02;0.0
10501_4.txt;25;0;0;25;717;0.03;0.0;0.0
5031_3.txt;2;0;0;2;296;0.01;0.0;0.0
2222_4.txt;2;0;0;2;140;0.01;0.0;0.0
2828_3.txt;22;2;0;24;525;0.04;0.0;0.0
521_1.txt;1;0;0;1;160;0.01;0.0;0.0
3022_1.txt;7;0;4;11;321;0.02;0.0;0.01
10489_4.txt;7;0;0;7;246;0.03;0.0;0.0
1164_4.txt;3;1;0;4;637;0.0;0.0;0.0
10541_4.txt;22;8;1;31;703;0.03;0.01;0.0
12241_4.txt;10;0;0;10;203;0.05;0.0;0.0
10086_2.txt;2;0;0;2;64;0.03;0.0;0.0
2756_3.txt;0;1;0;1;388;0.0;0.0;0.0
10766_4.txt;1;2;0;3;115;0.01;0.02;0.0
6514_2.txt;0;2;0;2;77;0.0;0.03;0.0
2541_1.txt;0;0;2;2;260;0.0;0.0;0.01
11023_4.txt;28;1;0;29;755;0.04;0.0;0.0
6311_3.txt;0;0;0;0;216;0.0;0.0;0.0
7653_1.txt;0;0;0;0;243;0.0;0.0;0.0
10610_1.txt;30;0;1;31;880;0.03;0.0;0.0
6338_1.txt;1;0;0;1;47;0.02;0.0;0.0
8295_4.txt;6;0;0;6;193;0.03;0.0;0.0
6607_4.txt;9;1;2;12;266;0.03;0.0;0.01
9743_1.txt;4;2;0;6;188;0.02;0.01;0.0
457_3.txt;0;0;0;0;201;0.0;0.0;0.0
9515_2.txt;1;0;0;1;315;0.0;0.0;0.0
9993_4.txt;2;3;0;5;864;0.0;0.0;0.0
9815_2.txt;2;0;1;3;226;0.01;0.0;0.0
6406_4.txt;2;0;0;2;118;0.02;0.0;0.0
9631_4.txt;8;0;0;8;137;0.06;0.0;0.0
7134_1.txt;2;1;2;5;337;0.01;0.0;0.01
7239_2.txt;2;1;0;3;77;0.03;0.01;0.0
3474_2.txt;6;0;0;6;144;0.04;0.0;0.0
6916_2.txt;18;2;0;20;486;0.04;0.0;0.0
31_1.txt;2;0;2;4;197;0.01;0.0;0.01
12315_2.txt;11;1;0;12;186;0.06;0.01;0.0
5218_4.txt;7;0;1;8;213;0.03;0.0;0.0
10829_3.txt;6;0;0;6;325;0.02;0.0;0.0
9245_2.txt;6;0;3;9;80;0.07;0.0;0.04
10745_3.txt;0;0;0;0;64;0.0;0.0;0.0
3076_1.txt;16;0;0;16;294;0.05;0.0;0.0
2640_2.txt;27;1;4;32;418;0.06;0.0;0.01
11817_4.txt;0;0;0;0;172;0.0;0.0;0.0
9621_4.txt;12;0;0;12;308;0.04;0.0;0.0
12370_4.txt;0;3;0;3;202;0.0;0.01;0.0
1365_2.txt;7;0;0;7;297;0.02;0.0;0.0
7405_3.txt;1;0;0;1;136;0.01;0.0;0.0
3554_1.txt;0;0;0;0;205;0.0;0.0;0.0
4718_1.txt;14;18;1;33;871;0.02;0.02;0.0
3227_3.txt;2;3;0;5;242;0.01;0.01;0.0
12424_1.txt;11;1;0;12;184;0.06;0.01;0.0
10308_1.txt;4;0;1;5;164;0.02;0.0;0.01
7639_1.txt;2;0;0;2;158;0.01;0.0;0.0
573_1.txt;4;0;0;4;149;0.03;0.0;0.0
595_4.txt;1;2;0;3;435;0.0;0.0;0.0
3080_1.txt;6;0;0;6;249;0.02;0.0;0.0
630_2.txt;5;0;2;7;581;0.01;0.0;0.0
7723_4.txt;8;1;0;9;564;0.01;0.0;0.0
1515_1.txt;4;0;0;4;188;0.02;0.0;0.0
12259_1.txt;0;0;0;0;263;0.0;0.0;0.0
5228_1.txt;0;0;0;0;181;0.0;0.0;0.0
10147_1.txt;0;0;0;0;130;0.0;0.0;0.0
11956_3.txt;1;0;0;1;173;0.01;0.0;0.0
5630_1.txt;4;0;0;4;141;0.03;0.0;0.0
5841_1.txt;1;0;0;1;590;0.0;0.0;0.0
11284_1.txt;3;0;0;3;95;0.03;0.0;0.0
9588_4.txt;20;3;4;27;1136;0.02;0.0;0.0
546_2.txt;4;0;2;6;182;0.02;0.0;0.01
9807_2.txt;7;4;6;17;323;0.02;0.01;0.02
10163_4.txt;4;0;0;4;199;0.02;0.0;0.0
423_4.txt;4;0;3;7;155;0.03;0.0;0.02
2438_2.txt;11;2;0;13;807;0.01;0.0;0.0
468_4.txt;30;2;2;34;401;0.07;0.0;0.0
9903_2.txt;3;2;2;7;74;0.04;0.03;0.03
7354_4.txt;3;0;0;3;254;0.01;0.0;0.0
11955_4.txt;0;0;0;0;123;0.0;0.0;0.0
12372_3.txt;4;2;0;6;475;0.01;0.0;0.0
10889_1.txt;1;0;0;1;110;0.01;0.0;0.0
3611_4.txt;16;2;8;26;944;0.02;0.0;0.01
9753_4.txt;11;4;8;23;412;0.03;0.01;0.02
1532_1.txt;7;0;0;7;193;0.04;0.0;0.0
7193_2.txt;0;0;0;0;131;0.0;0.0;0.0
4682_4.txt;0;1;0;1;118;0.0;0.01;0.0
8543_3.txt;0;0;0;0;166;0.0;0.0;0.0
8487_1.txt;9;1;0;10;200;0.04;0.01;0.0
9199_3.txt;23;0;0;23;462;0.05;0.0;0.0
10207_2.txt;8;0;0;8;219;0.04;0.0;0.0
9820_2.txt;0;0;0;0;150;0.0;0.0;0.0
3777_4.txt;2;0;0;2;205;0.01;0.0;0.0
1000_4.txt;2;0;0;2;175;0.01;0.0;0.0
5308_2.txt;5;2;0;7;187;0.03;0.01;0.0
1806_4.txt;8;1;0;9;345;0.02;0.0;0.0
3143_1.txt;12;2;0;14;545;0.02;0.0;0.0
7391_2.txt;3;0;0;3;183;0.02;0.0;0.0
11083_3.txt;7;0;0;7;164;0.04;0.0;0.0
1151_1.txt;1;0;0;1;362;0.0;0.0;0.0
1787_2.txt;17;2;0;19;641;0.03;0.0;0.0
7298_1.txt;2;0;0;2;166;0.01;0.0;0.0
10358_1.txt;7;0;0;7;214;0.03;0.0;0.0
9171_1.txt;0;0;0;0;73;0.0;0.0;0.0
9212_1.txt;0;0;0;0;84;0.0;0.0;0.0
5029_3.txt;14;4;1;19;176;0.08;0.02;0.01
4092_3.txt;6;0;0;6;153;0.04;0.0;0.0
5655_1.txt;8;2;0;10;164;0.05;0.01;0.0
10264_4.txt;23;5;0;28;205;0.11;0.02;0.0
8427_1.txt;9;0;2;11;372;0.02;0.0;0.01
6214_4.txt;0;0;2;2;241;0.0;0.0;0.01
420_4.txt;0;0;0;0;168;0.0;0.0;0.0
8371_1.txt;0;0;0;0;215;0.0;0.0;0.0
2928_2.txt;10;0;1;11;474;0.02;0.0;0.0
1606_1.txt;12;1;4;17;276;0.04;0.0;0.01
10423_1.txt;0;0;0;0;151;0.0;0.0;0.0
5301_4.txt;3;1;0;4;203;0.01;0.0;0.0
6190_2.txt;57;19;0;76;1080;0.05;0.02;0.0
11896_4.txt;8;0;0;8;231;0.03;0.0;0.0
1522_1.txt;0;0;0;0;97;0.0;0.0;0.0
1361_4.txt;19;1;0;20;327;0.06;0.0;0.0
12383_2.txt;3;2;1;6;204;0.01;0.01;0.0
8266_4.txt;2;0;0;2;139;0.01;0.0;0.0
11694_4.txt;11;0;0;11;169;0.07;0.0;0.0
9560_1.txt;4;0;0;4;145;0.03;0.0;0.0
9028_3.txt;18;0;0;18;322;0.06;0.0;0.0
5002_1.txt;0;0;0;0;75;0.0;0.0;0.0
7575_4.txt;18;3;0;21;310;0.06;0.01;0.0
9398_4.txt;14;6;2;22;426;0.03;0.01;0.0
1357_4.txt;23;0;0;23;657;0.04;0.0;0.0
435_2.txt;6;0;0;6;237;0.03;0.0;0.0
7506_4.txt;2;0;0;2;63;0.03;0.0;0.0
692_2.txt;4;0;0;4;249;0.02;0.0;0.0
4790_1.txt;3;0;1;4;247;0.01;0.0;0.0
7272_4.txt;0;0;5;5;233;0.0;0.0;0.02
6342_3.txt;1;1;0;2;244;0.0;0.0;0.0
1220_4.txt;2;0;2;4;216;0.01;0.0;0.01
12335_3.txt;11;0;0;11;140;0.08;0.0;0.0
6010_1.txt;4;6;1;11;191;0.02;0.03;0.01
2732_1.txt;2;0;3;5;217;0.01;0.0;0.01
7156_1.txt;0;0;1;1;156;0.0;0.0;0.01
11734_1.txt;3;2;0;5;219;0.01;0.01;0.0
3191_1.txt;13;0;0;13;229;0.06;0.0;0.0
9198_1.txt;8;4;0;12;999;0.01;0.0;0.0
5427_3.txt;4;1;2;7;186;0.02;0.01;0.01
807_2.txt;3;0;0;3;165;0.02;0.0;0.0
2003_4.txt;0;4;0;4;267;0.0;0.01;0.0
11866_1.txt;0;2;1;3;260;0.0;0.01;0.0
4510_4.txt;7;1;0;8;143;0.05;0.01;0.0
3078_1.txt;0;0;0;0;76;0.0;0.0;0.0
10453_1.txt;3;0;0;3;167;0.02;0.0;0.0
3286_1.txt;18;0;0;18;365;0.05;0.0;0.0
10933_1.txt;2;0;0;2;141;0.01;0.0;0.0
2903_1.txt;5;0;0;5;273;0.02;0.0;0.0
2647_4.txt;18;1;0;19;298;0.06;0.0;0.0
1157_4.txt;11;0;0;11;365;0.03;0.0;0.0
11285_1.txt;4;0;0;4;196;0.02;0.0;0.0
4994_4.txt;0;0;0;0;183;0.0;0.0;0.0
5789_1.txt;1;0;0;1;148;0.01;0.0;0.0
11133_3.txt;0;0;0;0;75;0.0;0.0;0.0
135_4.txt;16;3;0;19;941;0.02;0.0;0.0
9244_3.txt;11;1;2;14;407;0.03;0.0;0.0
838_2.txt;79;24;5;108;980;0.08;0.02;0.01
5256_1.txt;0;0;0;0;63;0.0;0.0;0.0
11808_4.txt;24;1;1;26;503;0.05;0.0;0.0
4805_1.txt;7;0;0;7;256;0.03;0.0;0.0
1992_2.txt;2;0;0;2;196;0.01;0.0;0.0
157_1.txt;0;0;0;0;152;0.0;0.0;0.0
11159_3.txt;0;0;0;0;92;0.0;0.0;0.0
5458_4.txt;9;0;0;9;233;0.04;0.0;0.0
5940_4.txt;4;1;1;6;664;0.01;0.0;0.0
192_2.txt;9;0;0;9;243;0.04;0.0;0.0
11272_1.txt;2;0;0;2;145;0.01;0.0;0.0
10505_2.txt;8;0;0;8;204;0.04;0.0;0.0
12394_4.txt;0;1;0;1;209;0.0;0.0;0.0
4188_4.txt;3;1;0;4;253;0.01;0.0;0.0
7059_3.txt;3;0;0;3;509;0.01;0.0;0.0
1096_2.txt;0;0;0;0;191;0.0;0.0;0.0
7475_2.txt;0;0;0;0;174;0.0;0.0;0.0
12321_4.txt;0;0;0;0;176;0.0;0.0;0.0
6550_4.txt;14;1;0;15;513;0.03;0.0;0.0
3910_2.txt;13;4;10;27;323;0.04;0.01;0.03
5848_3.txt;11;1;0;12;465;0.02;0.0;0.0
7615_1.txt;0;0;0;0;174;0.0;0.0;0.0
9444_3.txt;2;1;0;3;139;0.01;0.01;0.0
6091_1.txt;0;0;0;0;167;0.0;0.0;0.0
4088_1.txt;2;0;0;2;154;0.01;0.0;0.0
3300_1.txt;0;0;0;0;84;0.0;0.0;0.0
1592_3.txt;7;0;1;8;253;0.03;0.0;0.0
8055_3.txt;22;2;2;26;554;0.04;0.0;0.0
199_1.txt;4;0;0;4;145;0.03;0.0;0.0
6976_4.txt;10;0;0;10;210;0.05;0.0;0.0
2851_4.txt;10;0;1;11;181;0.06;0.0;0.01
7089_1.txt;3;0;0;3;171;0.02;0.0;0.0
11566_2.txt;0;0;0;0;144;0.0;0.0;0.0
1281_3.txt;14;0;1;15;501;0.03;0.0;0.0
7762_4.txt;10;0;0;10;290;0.03;0.0;0.0
3033_2.txt;14;0;0;14;279;0.05;0.0;0.0
7837_4.txt;16;1;3;20;1196;0.01;0.0;0.0
11376_2.txt;6;9;2;17;460;0.01;0.02;0.0
11578_1.txt;0;0;0;0;43;0.0;0.0;0.0
10874_3.txt;2;0;0;2;123;0.02;0.0;0.0
8013_1.txt;0;0;0;0;222;0.0;0.0;0.0
4613_4.txt;7;0;0;7;177;0.04;0.0;0.0
3342_3.txt;21;0;0;21;357;0.06;0.0;0.0
12108_4.txt;2;0;0;2;107;0.02;0.0;0.0
10462_4.txt;0;0;0;0;82;0.0;0.0;0.0
10102_1.txt;0;0;0;0;248;0.0;0.0;0.0
11715_1.txt;1;0;0;1;587;0.0;0.0;0.0
12132_4.txt;14;0;0;14;192;0.07;0.0;0.0
8588_4.txt;3;2;0;5;271;0.01;0.01;0.0
6637_3.txt;0;0;0;0;145;0.0;0.0;0.0
3677_3.txt;1;0;0;1;64;0.02;0.0;0.0
1634_4.txt;6;0;0;6;161;0.04;0.0;0.0
8027_1.txt;1;0;0;1;114;0.01;0.0;0.0
448_1.txt;6;0;0;6;179;0.03;0.0;0.0
342_1.txt;0;0;0;0;40;0.0;0.0;0.0
2961_1.txt;0;0;1;1;129;0.0;0.0;0.01
2030_4.txt;9;0;2;11;411;0.02;0.0;0.0
8438_3.txt;9;2;3;14;216;0.04;0.01;0.01
11786_4.txt;10;0;0;10;161;0.06;0.0;0.0
9182_1.txt;1;0;1;2;91;0.01;0.0;0.01
10395_2.txt;18;2;7;27;444;0.04;0.0;0.02
361_4.txt;0;0;0;0;139;0.0;0.0;0.0
10824_2.txt;18;1;0;19;176;0.1;0.01;0.0
11851_1.txt;2;2;5;9;151;0.01;0.01;0.03
6297_1.txt;6;0;0;6;168;0.04;0.0;0.0
11467_2.txt;22;4;6;32;644;0.03;0.01;0.01
4235_4.txt;5;0;0;5;505;0.01;0.0;0.0
8488_4.txt;15;1;4;20;544;0.03;0.0;0.01
8316_2.txt;13;0;0;13;164;0.08;0.0;0.0
4594_1.txt;0;0;0;0;462;0.0;0.0;0.0
1351_1.txt;9;6;0;15;631;0.01;0.01;0.0
6005_4.txt;16;0;1;17;267;0.06;0.0;0.0
11463_1.txt;1;2;4;7;326;0.0;0.01;0.01
9326_2.txt;0;0;2;2;245;0.0;0.0;0.01
8049_1.txt;2;0;2;4;103;0.02;0.0;0.02
4569_1.txt;0;2;0;2;176;0.0;0.01;0.0
9384_4.txt;8;2;1;11;163;0.05;0.01;0.01
5200_1.txt;0;0;0;0;164;0.0;0.0;0.0
8527_2.txt;0;0;0;0;246;0.0;0.0;0.0
2017_1.txt;4;0;0;4;245;0.02;0.0;0.0
10135_2.txt;2;3;1;6;189;0.01;0.02;0.01
6468_3.txt;15;4;2;21;339;0.04;0.01;0.01
11183_2.txt;12;0;0;12;227;0.05;0.0;0.0
12365_1.txt;2;0;0;2;321;0.01;0.0;0.0
10599_2.txt;4;0;0;4;350;0.01;0.0;0.0
11812_1.txt;8;0;3;11;247;0.03;0.0;0.01
497_2.txt;2;1;0;3;187;0.01;0.01;0.0
10583_3.txt;0;0;0;0;177;0.0;0.0;0.0
4145_1.txt;10;1;0;11;704;0.01;0.0;0.0
1817_3.txt;46;5;0;51;462;0.1;0.01;0.0
3981_2.txt;1;0;0;1;118;0.01;0.0;0.0
9628_1.txt;3;0;0;3;120;0.03;0.0;0.0
970_1.txt;0;0;0;0;108;0.0;0.0;0.0
4517_3.txt;0;0;0;0;156;0.0;0.0;0.0
5972_3.txt;4;2;2;8;76;0.05;0.03;0.03
11727_4.txt;1;2;1;4;254;0.0;0.01;0.0
8828_4.txt;12;4;0;16;501;0.02;0.01;0.0
5966_3.txt;0;0;0;0;238;0.0;0.0;0.0
8814_4.txt;11;6;1;18;424;0.03;0.01;0.0
7269_3.txt;0;0;0;0;117;0.0;0.0;0.0
9913_3.txt;0;0;0;0;81;0.0;0.0;0.0
4257_4.txt;0;1;0;1;180;0.0;0.01;0.0
11875_4.txt;0;0;3;3;286;0.0;0.0;0.01
1720_2.txt;0;0;0;0;131;0.0;0.0;0.0
11494_4.txt;7;1;0;8;223;0.03;0.0;0.0
6621_1.txt;0;0;0;0;144;0.0;0.0;0.0
6031_3.txt;1;0;0;1;838;0.0;0.0;0.0
8110_1.txt;8;0;0;8;140;0.06;0.0;0.0
11815_3.txt;4;1;0;5;185;0.02;0.01;0.0
7029_3.txt;12;1;2;15;524;0.02;0.0;0.0
9189_1.txt;2;0;1;3;337;0.01;0.0;0.0
3071_4.txt;2;0;0;2;154;0.01;0.0;0.0
11369_1.txt;0;3;2;5;244;0.0;0.01;0.01
4570_1.txt;6;4;12;22;281;0.02;0.01;0.04
12408_2.txt;2;0;3;5;573;0.0;0.0;0.01
5043_3.txt;4;0;0;4;251;0.02;0.0;0.0
7839_4.txt;2;2;5;9;123;0.02;0.02;0.04
770_3.txt;25;2;0;27;232;0.11;0.01;0.0
9994_2.txt;0;2;0;2;638;0.0;0.0;0.0
11784_1.txt;0;0;0;0;75;0.0;0.0;0.0
6153_1.txt;0;0;0;0;187;0.0;0.0;0.0
6507_4.txt;1;0;0;1;236;0.0;0.0;0.0
1146_4.txt;8;0;1;9;141;0.06;0.0;0.01
5863_1.txt;0;0;0;0;119;0.0;0.0;0.0
2715_3.txt;0;0;0;0;224;0.0;0.0;0.0
3370_2.txt;4;1;0;5;171;0.02;0.01;0.0
6251_1.txt;6;0;0;6;201;0.03;0.0;0.0
4720_1.txt;2;12;1;15;216;0.01;0.06;0.0
11890_1.txt;9;2;0;11;789;0.01;0.0;0.0
7862_4.txt;13;1;0;14;940;0.01;0.0;0.0
3901_2.txt;11;4;0;15;135;0.08;0.03;0.0
12038_4.txt;2;0;0;2;107;0.02;0.0;0.0
4190_2.txt;2;3;0;5;236;0.01;0.01;0.0
6891_3.txt;4;0;0;4;170;0.02;0.0;0.0
3014_4.txt;3;0;0;3;157;0.02;0.0;0.0
1543_1.txt;0;0;0;0;72;0.0;0.0;0.0
6148_1.txt;3;0;0;3;205;0.01;0.0;0.0
4610_4.txt;5;0;0;5;169;0.03;0.0;0.0
7989_1.txt;2;0;2;4;372;0.01;0.0;0.01
7077_2.txt;33;2;0;35;497;0.07;0.0;0.0
3779_4.txt;0;0;0;0;181;0.0;0.0;0.0
4820_3.txt;4;3;0;7;467;0.01;0.01;0.0
1334_4.txt;1;0;0;1;383;0.0;0.0;0.0
5234_4.txt;0;0;1;1;140;0.0;0.0;0.01
6160_1.txt;3;0;0;3;94;0.03;0.0;0.0
10338_2.txt;11;0;0;11;261;0.04;0.0;0.0
488_4.txt;0;0;2;2;150;0.0;0.0;0.01
11190_1.txt;1;0;0;1;161;0.01;0.0;0.0
7428_1.txt;8;0;1;9;561;0.01;0.0;0.0
12223_1.txt;9;1;0;10;439;0.02;0.0;0.0
7190_4.txt;9;0;0;9;500;0.02;0.0;0.0
10888_1.txt;1;0;0;1;126;0.01;0.0;0.0
25_1.txt;0;1;0;1;291;0.0;0.0;0.0
8466_1.txt;2;0;0;2;114;0.02;0.0;0.0
2693_2.txt;2;0;0;2;262;0.01;0.0;0.0
4098_2.txt;6;0;4;10;264;0.02;0.0;0.02
7771_2.txt;0;0;0;0;151;0.0;0.0;0.0
7572_1.txt;1;0;0;1;141;0.01;0.0;0.0
10623_3.txt;2;1;0;3;156;0.01;0.01;0.0
8662_1.txt;2;0;0;2;139;0.01;0.0;0.0
10214_4.txt;11;0;0;11;204;0.05;0.0;0.0
3893_2.txt;3;0;0;3;430;0.01;0.0;0.0
1183_2.txt;1;0;0;1;213;0.0;0.0;0.0
507_4.txt;7;1;1;9;380;0.02;0.0;0.0
4339_2.txt;0;0;0;0;158;0.0;0.0;0.0
7920_1.txt;0;0;0;0;54;0.0;0.0;0.0
7204_2.txt;3;0;2;5;206;0.01;0.0;0.01
10965_1.txt;0;0;0;0;181;0.0;0.0;0.0
11938_3.txt;12;0;0;12;279;0.04;0.0;0.0
12429_1.txt;0;3;0;3;140;0.0;0.02;0.0
1161_1.txt;1;3;3;7;156;0.01;0.02;0.02
6220_1.txt;2;0;0;2;167;0.01;0.0;0.0
12450_1.txt;0;0;0;0;98;0.0;0.0;0.0
5411_1.txt;0;0;0;0;445;0.0;0.0;0.0
4678_2.txt;1;0;3;4;69;0.01;0.0;0.04
9775_4.txt;3;1;0;4;96;0.03;0.01;0.0
6826_2.txt;5;0;0;5;217;0.02;0.0;0.0
11262_3.txt;4;0;0;4;190;0.02;0.0;0.0
11434_2.txt;46;3;2;51;819;0.06;0.0;0.0
5556_4.txt;31;0;0;31;796;0.04;0.0;0.0
8355_2.txt;4;2;0;6;185;0.02;0.01;0.0
8559_3.txt;30;2;0;32;976;0.03;0.0;0.0
1925_1.txt;26;1;0;27;361;0.07;0.0;0.0
6274_2.txt;0;0;0;0;80;0.0;0.0;0.0
11410_3.txt;24;2;0;26;90;0.27;0.02;0.0
10670_3.txt;0;0;0;0;143;0.0;0.0;0.0
1796_2.txt;22;0;0;22;564;0.04;0.0;0.0
4148_1.txt;0;0;0;0;166;0.0;0.0;0.0
4764_1.txt;1;0;0;1;255;0.0;0.0;0.0
4344_1.txt;6;0;1;7;156;0.04;0.0;0.01
6703_1.txt;0;0;0;0;185;0.0;0.0;0.0
6058_1.txt;0;0;0;0;144;0.0;0.0;0.0
3582_3.txt;2;0;0;2;261;0.01;0.0;0.0
8665_3.txt;16;0;0;16;177;0.09;0.0;0.0
312_2.txt;3;0;0;3;141;0.02;0.0;0.0
6357_2.txt;8;0;0;8;220;0.04;0.0;0.0
10586_1.txt;6;1;0;7;138;0.04;0.01;0.0
5838_4.txt;10;1;0;11;141;0.07;0.01;0.0
6417_1.txt;0;1;0;1;289;0.0;0.0;0.0
2575_3.txt;3;0;1;4;181;0.02;0.0;0.01
266_3.txt;2;0;0;2;14;0.14;0.0;0.0
12158_3.txt;0;4;0;4;205;0.0;0.02;0.0
12156_3.txt;3;4;0;7;197;0.02;0.02;0.0
4185_3.txt;6;0;0;6;161;0.04;0.0;0.0
5150_4.txt;0;0;0;0;182;0.0;0.0;0.0
7999_1.txt;0;0;0;0;161;0.0;0.0;0.0
8783_1.txt;0;0;0;0;168;0.0;0.0;0.0
12207_1.txt;2;0;1;3;130;0.02;0.0;0.01
3550_1.txt;0;1;4;5;297;0.0;0.0;0.01
2227_1.txt;14;8;1;23;667;0.02;0.01;0.0
10772_1.txt;0;0;0;0;141;0.0;0.0;0.0
2024_1.txt;9;0;0;9;402;0.02;0.0;0.0
2058_1.txt;2;0;0;2;153;0.01;0.0;0.0
2816_1.txt;5;0;0;5;189;0.03;0.0;0.0
1477_4.txt;13;0;0;13;456;0.03;0.0;0.0
11656_2.txt;8;0;3;11;178;0.04;0.0;0.02
1747_2.txt;17;0;0;17;158;0.11;0.0;0.0
10099_1.txt;4;0;2;6;171;0.02;0.0;0.01
8418_1.txt;10;1;0;11;280;0.04;0.0;0.0
9497_3.txt;4;0;0;4;191;0.02;0.0;0.0
9618_4.txt;0;1;0;1;165;0.0;0.01;0.0
6435_3.txt;5;1;0;6;246;0.02;0.0;0.0
239_2.txt;8;0;0;8;204;0.04;0.0;0.0
773_2.txt;6;0;1;7;273;0.02;0.0;0.0
6922_3.txt;4;1;0;5;115;0.03;0.01;0.0
2322_2.txt;2;0;0;2;260;0.01;0.0;0.0
10895_1.txt;0;0;0;0;98;0.0;0.0;0.0
7288_2.txt;8;2;0;10;495;0.02;0.0;0.0
1876_4.txt;13;0;0;13;427;0.03;0.0;0.0
8943_4.txt;23;3;0;26;222;0.1;0.01;0.0
5614_4.txt;52;2;7;61;894;0.06;0.0;0.01
140_2.txt;6;0;0;6;106;0.06;0.0;0.0
11411_4.txt;2;0;0;2;135;0.01;0.0;0.0
9990_1.txt;0;0;0;0;250;0.0;0.0;0.0
5741_1.txt;1;4;0;5;206;0.0;0.02;0.0
3115_2.txt;1;0;0;1;217;0.0;0.0;0.0
1815_2.txt;16;0;0;16;568;0.03;0.0;0.0
4519_3.txt;5;1;1;7;315;0.02;0.0;0.0
10973_4.txt;0;0;0;0;142;0.0;0.0;0.0
4880_4.txt;22;0;10;32;181;0.12;0.0;0.06
4830_2.txt;3;3;2;8;286;0.01;0.01;0.01
6482_2.txt;1;0;2;3;147;0.01;0.0;0.01
15_1.txt;0;0;0;0;577;0.0;0.0;0.0
992_1.txt;3;0;0;3;210;0.01;0.0;0.0
6989_1.txt;1;0;0;1;86;0.01;0.0;0.0
4964_2.txt;2;0;0;2;140;0.01;0.0;0.0
5835_2.txt;14;2;1;17;289;0.05;0.01;0.0
10892_1.txt;0;0;0;0;86;0.0;0.0;0.0
11297_3.txt;10;0;0;10;263;0.04;0.0;0.0
3218_4.txt;0;0;0;0;149;0.0;0.0;0.0
5042_3.txt;4;1;0;5;174;0.02;0.01;0.0
2318_3.txt;0;1;0;1;161;0.0;0.01;0.0
4347_1.txt;5;0;0;5;160;0.03;0.0;0.0
10236_1.txt;5;0;3;8;356;0.01;0.0;0.01
3050_1.txt;6;5;3;14;306;0.02;0.02;0.01
2376_4.txt;3;0;0;3;130;0.02;0.0;0.0
3899_1.txt;8;4;0;12;237;0.03;0.02;0.0
61_3.txt;19;0;0;19;311;0.06;0.0;0.0
10893_3.txt;2;0;0;2;207;0.01;0.0;0.0
9298_2.txt;3;0;0;3;53;0.06;0.0;0.0
11850_3.txt;19;0;0;19;195;0.1;0.0;0.0
6133_1.txt;6;0;0;6;149;0.04;0.0;0.0
12045_2.txt;4;3;2;9;387;0.01;0.01;0.01
3831_4.txt;10;2;0;12;240;0.04;0.01;0.0
7858_1.txt;0;0;0;0;214;0.0;0.0;0.0
418_4.txt;2;0;0;2;383;0.01;0.0;0.0
4846_3.txt;0;2;2;4;475;0.0;0.0;0.0
3006_3.txt;8;0;4;12;518;0.02;0.0;0.01
1073_2.txt;4;0;0;4;134;0.03;0.0;0.0
5448_4.txt;10;3;0;13;190;0.05;0.02;0.0
2761_1.txt;6;4;6;16;649;0.01;0.01;0.01
9405_1.txt;0;1;0;1;102;0.0;0.01;0.0
5846_3.txt;0;0;0;0;294;0.0;0.0;0.0
9051_3.txt;3;0;0;3;276;0.01;0.0;0.0
8209_4.txt;4;0;0;4;255;0.02;0.0;0.0
2991_4.txt;14;0;0;14;466;0.03;0.0;0.0
6336_4.txt;13;3;3;19;244;0.05;0.01;0.01
6321_3.txt;2;0;0;2;268;0.01;0.0;0.0
8537_4.txt;0;0;0;0;62;0.0;0.0;0.0
438_4.txt;32;0;2;34;636;0.05;0.0;0.0
7549_1.txt;8;3;0;11;534;0.01;0.01;0.0
1028_3.txt;46;2;2;50;711;0.06;0.0;0.0
1603_2.txt;8;0;2;10;156;0.05;0.0;0.01
787_4.txt;0;0;1;1;137;0.0;0.0;0.01
10813_4.txt;3;0;0;3;143;0.02;0.0;0.0
10747_4.txt;0;0;0;0;303;0.0;0.0;0.0
9963_2.txt;9;1;0;10;252;0.04;0.0;0.0
1407_2.txt;3;0;2;5;134;0.02;0.0;0.01
90_4.txt;9;1;0;10;322;0.03;0.0;0.0
6477_1.txt;22;0;2;24;566;0.04;0.0;0.0
95_3.txt;8;0;0;8;170;0.05;0.0;0.0
3869_3.txt;5;5;0;10;392;0.01;0.01;0.0
2862_1.txt;4;0;0;4;216;0.02;0.0;0.0
2574_3.txt;2;0;0;2;167;0.01;0.0;0.0
1340_2.txt;12;1;5;18;470;0.03;0.0;0.01
2115_4.txt;25;2;0;27;467;0.05;0.0;0.0
12003_4.txt;2;0;0;2;141;0.01;0.0;0.0
1691_4.txt;0;0;0;0;162;0.0;0.0;0.0
3978_4.txt;11;5;3;19;350;0.03;0.01;0.01
11586_2.txt;14;0;0;14;384;0.04;0.0;0.0
932_3.txt;11;0;0;11;241;0.05;0.0;0.0
12190_4.txt;4;0;3;7;135;0.03;0.0;0.02
256_1.txt;12;2;1;15;190;0.06;0.01;0.01
3059_1.txt;2;5;2;9;143;0.01;0.03;0.01
1778_3.txt;11;0;0;11;210;0.05;0.0;0.0
11883_1.txt;10;0;1;11;369;0.03;0.0;0.0
5338_2.txt;19;0;0;19;227;0.08;0.0;0.0
9532_3.txt;9;0;0;9;221;0.04;0.0;0.0
5239_3.txt;15;0;0;15;366;0.04;0.0;0.0
3938_1.txt;11;0;0;11;226;0.05;0.0;0.0
4950_3.txt;9;0;0;9;561;0.02;0.0;0.0
5381_4.txt;4;0;0;4;317;0.01;0.0;0.0
11754_4.txt;4;0;4;8;366;0.01;0.0;0.01
4749_3.txt;5;0;0;5;301;0.02;0.0;0.0
10627_1.txt;0;0;0;0;275;0.0;0.0;0.0
3103_2.txt;11;0;1;12;231;0.05;0.0;0.0
6080_4.txt;10;0;0;10;282;0.04;0.0;0.0
1410_4.txt;17;1;0;18;294;0.06;0.0;0.0
1492_2.txt;5;0;0;5;452;0.01;0.0;0.0
10679_3.txt;0;2;0;2;239;0.0;0.01;0.0
10261_1.txt;0;1;0;1;316;0.0;0.0;0.0
7466_1.txt;2;0;0;2;119;0.02;0.0;0.0
6049_4.txt;15;1;0;16;292;0.05;0.0;0.0
7716_4.txt;1;0;0;1;225;0.0;0.0;0.0
4219_4.txt;1;2;0;3;183;0.01;0.01;0.0
10249_1.txt;0;0;0;0;221;0.0;0.0;0.0
6688_3.txt;0;7;4;11;188;0.0;0.04;0.02
8112_1.txt;7;0;0;7;258;0.03;0.0;0.0
9351_1.txt;0;0;0;0;162;0.0;0.0;0.0
97_1.txt;0;0;0;0;183;0.0;0.0;0.0
8393_2.txt;14;1;0;15;204;0.07;0.0;0.0
6064_3.txt;3;0;0;3;248;0.01;0.0;0.0
7030_4.txt;0;1;3;4;174;0.0;0.01;0.02
6529_3.txt;1;0;0;1;127;0.01;0.0;0.0
1024_1.txt;2;1;0;3;255;0.01;0.0;0.0
9324_4.txt;0;0;0;0;139;0.0;0.0;0.0
5466_1.txt;0;0;0;0;62;0.0;0.0;0.0
292_1.txt;1;0;0;1;125;0.01;0.0;0.0
460_2.txt;0;2;0;2;157;0.0;0.01;0.0
789_2.txt;0;0;0;0;158;0.0;0.0;0.0
2261_3.txt;7;0;0;7;87;0.08;0.0;0.0
4494_1.txt;7;2;4;13;1249;0.01;0.0;0.0
2515_1.txt;3;1;0;4;148;0.02;0.01;0.0
6711_2.txt;4;3;0;7;156;0.03;0.02;0.0
