name;number of persons;number of locations;number of organisations;number of named entities;number of words;relative number of Persons;relative number of locations;relative number of organisations
7812_8.txt;10;10;6;26;389;0.03;0.03;0.02
4604_10.txt;14;0;0;14;368;0.04;0.0;0.0
11880_10.txt;34;0;0;34;594;0.06;0.0;0.0
10021_8.txt;7;0;1;8;167;0.04;0.0;0.01
7646_8.txt;4;0;0;4;75;0.05;0.0;0.0
6192_9.txt;13;1;2;16;564;0.02;0.0;0.0
5534_7.txt;11;2;2;15;783;0.01;0.0;0.0
8428_7.txt;2;0;0;2;349;0.01;0.0;0.0
267_7.txt;8;5;0;13;192;0.04;0.03;0.0
686_9.txt;2;0;2;4;108;0.02;0.0;0.02
5665_9.txt;9;2;0;11;346;0.03;0.01;0.0
3058_9.txt;4;0;0;4;124;0.03;0.0;0.0
468_7.txt;12;1;7;20;362;0.03;0.0;0.02
4484_8.txt;34;4;3;41;464;0.07;0.01;0.01
7796_10.txt;7;0;0;7;165;0.04;0.0;0.0
556_9.txt;18;4;0;22;185;0.1;0.02;0.0
9243_8.txt;0;0;2;2;216;0.0;0.0;0.01
9263_8.txt;0;4;0;4;200;0.0;0.02;0.0
5839_7.txt;10;0;1;11;182;0.05;0.0;0.01
3281_10.txt;8;0;0;8;169;0.05;0.0;0.0
2912_9.txt;17;0;0;17;401;0.04;0.0;0.0
6680_7.txt;8;0;0;8;246;0.03;0.0;0.0
6345_7.txt;6;0;0;6;110;0.05;0.0;0.0
2482_10.txt;6;1;0;7;125;0.05;0.01;0.0
11104_10.txt;8;0;1;9;262;0.03;0.0;0.0
2501_8.txt;2;1;1;4;359;0.01;0.0;0.0
5875_8.txt;7;0;1;8;162;0.04;0.0;0.01
7891_8.txt;35;4;0;39;428;0.08;0.01;0.0
3825_8.txt;0;0;0;0;305;0.0;0.0;0.0
10847_10.txt;2;0;0;2;163;0.01;0.0;0.0
12000_8.txt;4;0;0;4;187;0.02;0.0;0.0
11448_10.txt;7;0;0;7;311;0.02;0.0;0.0
1531_8.txt;44;1;3;48;527;0.08;0.0;0.01
40_8.txt;9;0;1;10;312;0.03;0.0;0.0
7262_10.txt;5;2;0;7;230;0.02;0.01;0.0
6770_10.txt;2;0;1;3;204;0.01;0.0;0.0
9865_8.txt;0;0;0;0;101;0.0;0.0;0.0
8052_9.txt;28;5;0;33;675;0.04;0.01;0.0
171_8.txt;23;0;3;26;309;0.07;0.0;0.01
11807_7.txt;19;0;0;19;187;0.1;0.0;0.0
8565_7.txt;0;0;0;0;84;0.0;0.0;0.0
4854_7.txt;4;0;0;4;139;0.03;0.0;0.0
10275_10.txt;7;0;0;7;279;0.03;0.0;0.0
8366_10.txt;0;0;1;1;101;0.0;0.0;0.01
3488_7.txt;60;5;13;78;987;0.06;0.01;0.01
3091_10.txt;1;0;5;6;299;0.0;0.0;0.02
2566_8.txt;6;0;0;6;204;0.03;0.0;0.0
8232_10.txt;24;3;0;27;249;0.1;0.01;0.0
5952_9.txt;23;1;0;24;237;0.1;0.0;0.0
8705_8.txt;4;1;0;5;271;0.01;0.0;0.0
4349_10.txt;30;0;0;30;252;0.12;0.0;0.0
1449_9.txt;14;0;0;14;315;0.04;0.0;0.0
12412_9.txt;19;3;0;22;589;0.03;0.01;0.0
3583_10.txt;0;0;0;0;72;0.0;0.0;0.0
9357_7.txt;30;3;0;33;245;0.12;0.01;0.0
4043_7.txt;1;1;0;2;231;0.0;0.0;0.0
12100_8.txt;4;0;0;4;410;0.01;0.0;0.0
365_10.txt;2;0;0;2;65;0.03;0.0;0.0
2644_8.txt;4;0;0;4;175;0.02;0.0;0.0
5391_9.txt;31;0;1;32;486;0.06;0.0;0.0
4640_10.txt;0;6;0;6;186;0.0;0.03;0.0
5533_7.txt;8;3;3;14;519;0.02;0.01;0.01
7279_9.txt;0;0;0;0;142;0.0;0.0;0.0
8293_8.txt;10;3;0;13;311;0.03;0.01;0.0
1919_8.txt;12;0;0;12;325;0.04;0.0;0.0
11672_10.txt;22;0;0;22;202;0.11;0.0;0.0
6493_10.txt;3;4;0;7;182;0.02;0.02;0.0
9786_8.txt;2;0;0;2;122;0.02;0.0;0.0
7407_10.txt;0;0;0;0;184;0.0;0.0;0.0
151_10.txt;4;0;0;4;127;0.03;0.0;0.0
2367_8.txt;6;2;0;8;158;0.04;0.01;0.0
1990_10.txt;34;5;6;45;575;0.06;0.01;0.01
4130_9.txt;5;0;0;5;24;0.21;0.0;0.0
4940_7.txt;8;0;0;8;137;0.06;0.0;0.0
2649_7.txt;2;0;0;2;90;0.02;0.0;0.0
254_8.txt;14;2;2;18;447;0.03;0.0;0.0
9563_9.txt;7;0;1;8;136;0.05;0.0;0.01
1648_10.txt;0;3;0;3;184;0.0;0.02;0.0
937_10.txt;5;0;3;8;287;0.02;0.0;0.01
5796_8.txt;46;0;0;46;879;0.05;0.0;0.0
8806_9.txt;8;1;0;9;426;0.02;0.0;0.0
5611_10.txt;7;1;0;8;338;0.02;0.0;0.0
4170_8.txt;6;0;1;7;222;0.03;0.0;0.0
747_10.txt;7;0;0;7;294;0.02;0.0;0.0
7480_10.txt;4;0;0;4;195;0.02;0.0;0.0
1422_10.txt;5;4;3;12;494;0.01;0.01;0.01
11298_8.txt;37;3;0;40;527;0.07;0.01;0.0
956_9.txt;1;5;0;6;192;0.01;0.03;0.0
10504_9.txt;3;0;0;3;149;0.02;0.0;0.0
1263_8.txt;13;0;0;13;253;0.05;0.0;0.0
1883_7.txt;19;0;0;19;169;0.11;0.0;0.0
8140_10.txt;0;0;3;3;243;0.0;0.0;0.01
554_7.txt;17;0;0;17;240;0.07;0.0;0.0
977_8.txt;12;1;0;13;885;0.01;0.0;0.0
8730_8.txt;8;0;0;8;187;0.04;0.0;0.0
11289_10.txt;5;0;0;5;93;0.05;0.0;0.0
8738_8.txt;0;0;1;1;74;0.0;0.0;0.01
4862_7.txt;6;1;0;7;169;0.04;0.01;0.0
2535_7.txt;16;0;0;16;207;0.08;0.0;0.0
7848_10.txt;13;0;0;13;246;0.05;0.0;0.0
6819_8.txt;0;4;1;5;255;0.0;0.02;0.0
9723_9.txt;3;2;0;5;457;0.01;0.0;0.0
1974_8.txt;8;1;1;10;362;0.02;0.0;0.0
6366_8.txt;0;0;0;0;63;0.0;0.0;0.0
8223_9.txt;2;1;0;3;114;0.02;0.01;0.0
11275_10.txt;6;3;0;9;541;0.01;0.01;0.0
5911_9.txt;46;4;9;59;737;0.06;0.01;0.01
4728_8.txt;2;1;0;3;132;0.02;0.01;0.0
10274_8.txt;0;0;0;0;133;0.0;0.0;0.0
12101_7.txt;3;3;0;6;180;0.02;0.02;0.0
7777_10.txt;13;1;0;14;217;0.06;0.0;0.0
7840_8.txt;8;0;0;8;236;0.03;0.0;0.0
5732_7.txt;5;3;3;11;273;0.02;0.01;0.01
6973_10.txt;0;4;1;5;157;0.0;0.03;0.01
9846_7.txt;1;0;0;1;234;0.0;0.0;0.0
7507_8.txt;32;3;1;36;355;0.09;0.01;0.0
6424_10.txt;8;0;0;8;182;0.04;0.0;0.0
1708_10.txt;5;2;1;8;191;0.03;0.01;0.01
10364_10.txt;19;1;3;23;397;0.05;0.0;0.01
12218_7.txt;8;2;2;12;426;0.02;0.0;0.0
11866_8.txt;1;0;0;1;103;0.01;0.0;0.0
5725_9.txt;4;0;4;8;339;0.01;0.0;0.01
1490_8.txt;10;2;1;13;408;0.02;0.0;0.0
984_7.txt;6;0;0;6;237;0.03;0.0;0.0
7161_9.txt;6;0;0;6;162;0.04;0.0;0.0
10468_9.txt;8;1;0;9;124;0.06;0.01;0.0
3207_7.txt;4;0;2;6;238;0.02;0.0;0.01
5329_9.txt;2;0;2;4;134;0.01;0.0;0.01
8057_10.txt;13;2;2;17;562;0.02;0.0;0.0
11616_8.txt;2;4;0;6;489;0.0;0.01;0.0
108_10.txt;3;2;0;5;98;0.03;0.02;0.0
11856_10.txt;0;0;0;0;61;0.0;0.0;0.0
8647_7.txt;4;2;0;6;87;0.05;0.02;0.0
1686_10.txt;4;0;0;4;135;0.03;0.0;0.0
11925_7.txt;4;0;0;4;160;0.03;0.0;0.0
10405_8.txt;4;1;0;5;330;0.01;0.0;0.0
11045_9.txt;11;0;2;13;491;0.02;0.0;0.0
1776_10.txt;13;1;4;18;278;0.05;0.0;0.01
11166_7.txt;22;5;0;27;301;0.07;0.02;0.0
11862_10.txt;0;0;0;0;85;0.0;0.0;0.0
12261_10.txt;12;1;7;20;402;0.03;0.0;0.02
6876_8.txt;8;5;10;23;553;0.01;0.01;0.02
8075_8.txt;8;0;0;8;291;0.03;0.0;0.0
4266_7.txt;14;9;4;27;548;0.03;0.02;0.01
5582_9.txt;44;5;2;51;615;0.07;0.01;0.0
834_8.txt;15;0;0;15;252;0.06;0.0;0.0
7784_7.txt;1;0;0;1;136;0.01;0.0;0.0
3415_9.txt;9;0;0;9;148;0.06;0.0;0.0
2125_10.txt;18;7;3;28;306;0.06;0.02;0.01
9442_10.txt;25;1;2;28;577;0.04;0.0;0.0
4181_9.txt;0;2;0;2;219;0.0;0.01;0.0
1256_8.txt;9;0;0;9;91;0.1;0.0;0.0
547_10.txt;3;6;0;9;180;0.02;0.03;0.0
8149_10.txt;15;0;9;24;370;0.04;0.0;0.02
1096_9.txt;6;1;0;7;149;0.04;0.01;0.0
7230_8.txt;12;0;0;12;261;0.05;0.0;0.0
3860_10.txt;20;3;0;23;378;0.05;0.01;0.0
7297_10.txt;4;0;3;7;138;0.03;0.0;0.02
6121_10.txt;1;0;0;1;78;0.01;0.0;0.0
9389_7.txt;9;3;0;12;227;0.04;0.01;0.0
10929_10.txt;9;6;5;20;422;0.02;0.01;0.01
8495_8.txt;83;9;10;102;908;0.09;0.01;0.01
2042_7.txt;3;3;3;9;305;0.01;0.01;0.01
8235_7.txt;14;0;2;16;422;0.03;0.0;0.0
579_10.txt;8;6;0;14;362;0.02;0.02;0.0
4505_8.txt;4;1;5;10;360;0.01;0.0;0.01
4623_7.txt;4;0;0;4;153;0.03;0.0;0.0
4939_7.txt;4;0;0;4;177;0.02;0.0;0.0
8285_8.txt;22;0;0;22;614;0.04;0.0;0.0
1882_10.txt;15;0;0;15;225;0.07;0.0;0.0
3271_9.txt;16;0;0;16;213;0.08;0.0;0.0
5726_7.txt;3;0;0;3;170;0.02;0.0;0.0
6194_8.txt;15;0;0;15;348;0.04;0.0;0.0
2330_8.txt;4;0;1;5;157;0.03;0.0;0.01
8161_10.txt;3;0;0;3;170;0.02;0.0;0.0
2052_10.txt;5;0;0;5;213;0.02;0.0;0.0
2533_7.txt;27;1;0;28;546;0.05;0.0;0.0
5763_8.txt;2;0;2;4;256;0.01;0.0;0.01
2034_9.txt;2;1;1;4;294;0.01;0.0;0.0
3276_8.txt;15;1;0;16;358;0.04;0.0;0.0
7073_10.txt;10;0;0;10;203;0.05;0.0;0.0
5994_8.txt;3;1;0;4;253;0.01;0.0;0.0
7788_10.txt;4;1;1;6;119;0.03;0.01;0.01
5359_10.txt;27;1;2;30;581;0.05;0.0;0.0
4443_8.txt;21;0;6;27;1147;0.02;0.0;0.01
7863_10.txt;0;0;0;0;104;0.0;0.0;0.0
8146_10.txt;12;3;2;17;563;0.02;0.01;0.0
5690_7.txt;10;2;0;12;205;0.05;0.01;0.0
6254_10.txt;1;1;0;2;202;0.0;0.0;0.0
11959_8.txt;24;4;2;30;476;0.05;0.01;0.0
840_9.txt;1;0;0;1;202;0.0;0.0;0.0
12452_8.txt;28;5;1;34;535;0.05;0.01;0.0
9223_9.txt;37;4;2;43;359;0.1;0.01;0.01
4797_10.txt;14;0;0;14;341;0.04;0.0;0.0
823_9.txt;6;2;0;8;178;0.03;0.01;0.0
9259_10.txt;0;0;0;0;147;0.0;0.0;0.0
9824_10.txt;2;0;0;2;123;0.02;0.0;0.0
4384_10.txt;27;4;0;31;864;0.03;0.0;0.0
6157_10.txt;4;2;2;8;227;0.02;0.01;0.01
4937_7.txt;7;3;0;10;118;0.06;0.03;0.0
862_7.txt;6;0;0;6;196;0.03;0.0;0.0
3656_8.txt;2;2;2;6;284;0.01;0.01;0.01
6809_7.txt;2;1;2;5;151;0.01;0.01;0.01
770_10.txt;8;0;2;10;169;0.05;0.0;0.01
9333_8.txt;6;1;0;7;327;0.02;0.0;0.0
7509_8.txt;15;0;5;20;570;0.03;0.0;0.01
11547_9.txt;3;0;0;3;116;0.03;0.0;0.0
3105_8.txt;11;0;0;11;441;0.02;0.0;0.0
10105_8.txt;17;0;3;20;440;0.04;0.0;0.01
10411_9.txt;16;1;4;21;452;0.04;0.0;0.01
5436_7.txt;36;8;8;52;618;0.06;0.01;0.01
8892_10.txt;2;0;0;2;120;0.02;0.0;0.0
3543_10.txt;34;9;2;45;1160;0.03;0.01;0.0
1817_8.txt;1;0;0;1;138;0.01;0.0;0.0
4111_10.txt;2;0;0;2;148;0.01;0.0;0.0
4339_10.txt;0;0;0;0;259;0.0;0.0;0.0
1238_7.txt;4;0;0;4;66;0.06;0.0;0.0
5931_7.txt;2;0;1;3;136;0.01;0.0;0.01
11400_10.txt;29;3;3;35;739;0.04;0.0;0.0
11477_8.txt;5;1;0;6;302;0.02;0.0;0.0
12407_7.txt;12;1;0;13;664;0.02;0.0;0.0
7607_8.txt;5;0;0;5;207;0.02;0.0;0.0
6759_7.txt;14;0;0;14;272;0.05;0.0;0.0
11429_7.txt;1;4;0;5;714;0.0;0.01;0.0
4724_7.txt;0;0;0;0;288;0.0;0.0;0.0
7585_8.txt;1;0;0;1;112;0.01;0.0;0.0
11789_10.txt;2;0;0;2;261;0.01;0.0;0.0
6241_10.txt;0;1;0;1;303;0.0;0.0;0.0
9379_7.txt;5;0;0;5;198;0.03;0.0;0.0
6070_8.txt;9;0;0;9;164;0.05;0.0;0.0
10788_10.txt;2;0;0;2;175;0.01;0.0;0.0
8337_10.txt;4;0;0;4;248;0.02;0.0;0.0
3661_10.txt;10;0;2;12;184;0.05;0.0;0.01
3205_8.txt;0;0;0;0;83;0.0;0.0;0.0
3823_9.txt;2;3;0;5;150;0.01;0.02;0.0
5975_8.txt;5;2;1;8;153;0.03;0.01;0.01
5274_7.txt;0;0;0;0;253;0.0;0.0;0.0
9040_9.txt;6;2;0;8;194;0.03;0.01;0.0
11704_10.txt;3;1;1;5;593;0.01;0.0;0.0
9713_10.txt;2;4;1;7;339;0.01;0.01;0.0
696_10.txt;3;0;0;3;147;0.02;0.0;0.0
10413_10.txt;7;0;0;7;99;0.07;0.0;0.0
8338_8.txt;4;0;0;4;102;0.04;0.0;0.0
8291_8.txt;13;0;0;13;306;0.04;0.0;0.0
10830_10.txt;0;0;0;0;102;0.0;0.0;0.0
12413_9.txt;4;0;0;4;68;0.06;0.0;0.0
10553_8.txt;8;1;0;9;138;0.06;0.01;0.0
582_9.txt;0;0;0;0;335;0.0;0.0;0.0
1084_9.txt;17;1;0;18;225;0.08;0.0;0.0
6_10.txt;1;0;2;3;88;0.01;0.0;0.02
3178_8.txt;5;0;0;5;132;0.04;0.0;0.0
8732_9.txt;10;0;0;10;585;0.02;0.0;0.0
9353_8.txt;28;0;0;28;188;0.15;0.0;0.0
4437_7.txt;12;2;0;14;382;0.03;0.01;0.0
7453_10.txt;46;1;0;47;509;0.09;0.0;0.0
6271_9.txt;0;0;0;0;170;0.0;0.0;0.0
1370_8.txt;5;0;0;5;123;0.04;0.0;0.0
230_9.txt;24;1;0;25;216;0.11;0.0;0.0
837_7.txt;19;1;0;20;486;0.04;0.0;0.0
3350_7.txt;3;0;0;3;235;0.01;0.0;0.0
884_8.txt;7;1;0;8;286;0.02;0.0;0.0
6032_10.txt;5;5;1;11;226;0.02;0.02;0.0
2152_8.txt;4;1;0;5;169;0.02;0.01;0.0
1251_9.txt;9;9;1;19;247;0.04;0.04;0.0
7326_10.txt;35;2;0;37;697;0.05;0.0;0.0
9021_10.txt;0;0;3;3;124;0.0;0.0;0.02
6079_9.txt;5;0;0;5;145;0.03;0.0;0.0
6936_7.txt;11;4;2;17;161;0.07;0.02;0.01
2914_8.txt;8;2;10;20;270;0.03;0.01;0.04
712_9.txt;0;0;1;1;56;0.0;0.0;0.02
7626_9.txt;7;0;0;7;170;0.04;0.0;0.0
4102_10.txt;3;0;0;3;64;0.05;0.0;0.0
3439_9.txt;15;0;1;16;706;0.02;0.0;0.0
10363_9.txt;8;0;0;8;410;0.02;0.0;0.0
3711_7.txt;36;6;0;42;794;0.05;0.01;0.0
4649_10.txt;16;0;3;19;836;0.02;0.0;0.0
11311_10.txt;0;0;0;0;54;0.0;0.0;0.0
6107_7.txt;0;0;0;0;93;0.0;0.0;0.0
6684_10.txt;19;0;0;19;191;0.1;0.0;0.0
5029_8.txt;2;0;0;2;327;0.01;0.0;0.0
1748_8.txt;4;0;0;4;350;0.01;0.0;0.0
4471_8.txt;29;1;1;31;185;0.16;0.01;0.01
2209_8.txt;6;0;0;6;136;0.04;0.0;0.0
2384_10.txt;21;0;7;28;417;0.05;0.0;0.02
5550_7.txt;12;1;0;13;216;0.06;0.0;0.0
1760_10.txt;33;2;3;38;243;0.14;0.01;0.01
1924_10.txt;1;0;0;1;228;0.0;0.0;0.0
3651_10.txt;18;2;2;22;343;0.05;0.01;0.01
4357_10.txt;8;0;0;8;203;0.04;0.0;0.0
8777_10.txt;4;0;0;4;52;0.08;0.0;0.0
9045_9.txt;11;5;4;20;241;0.05;0.02;0.02
4591_9.txt;23;0;0;23;499;0.05;0.0;0.0
1066_10.txt;0;0;0;0;73;0.0;0.0;0.0
2684_10.txt;1;0;0;1;55;0.02;0.0;0.0
168_9.txt;10;1;1;12;230;0.04;0.0;0.0
11149_10.txt;22;7;0;29;439;0.05;0.02;0.0
2683_10.txt;6;0;0;6;153;0.04;0.0;0.0
5536_9.txt;0;0;0;0;142;0.0;0.0;0.0
7398_10.txt;3;1;0;4;288;0.01;0.0;0.0
2370_10.txt;0;2;0;2;150;0.0;0.01;0.0
12020_7.txt;36;1;0;37;338;0.11;0.0;0.0
1528_8.txt;9;0;0;9;150;0.06;0.0;0.0
12006_10.txt;4;2;0;6;138;0.03;0.01;0.0
10042_10.txt;35;2;5;42;615;0.06;0.0;0.01
8850_8.txt;19;0;0;19;242;0.08;0.0;0.0
6657_9.txt;66;10;1;77;1082;0.06;0.01;0.0
4365_9.txt;25;2;0;27;486;0.05;0.0;0.0
846_7.txt;18;3;1;22;292;0.06;0.01;0.0
11151_8.txt;16;4;1;21;737;0.02;0.01;0.0
10215_10.txt;13;0;0;13;490;0.03;0.0;0.0
11683_8.txt;3;1;0;4;373;0.01;0.0;0.0
3527_7.txt;27;4;0;31;408;0.07;0.01;0.0
7106_8.txt;42;4;0;46;479;0.09;0.01;0.0
11598_8.txt;4;0;0;4;63;0.06;0.0;0.0
2517_9.txt;4;0;1;5;294;0.01;0.0;0.0
10500_10.txt;1;0;2;3;150;0.01;0.0;0.01
960_7.txt;2;0;0;2;170;0.01;0.0;0.0
12317_10.txt;0;0;0;0;239;0.0;0.0;0.0
12415_8.txt;8;1;0;9;116;0.07;0.01;0.0
4091_7.txt;0;4;0;4;606;0.0;0.01;0.0
5942_7.txt;17;3;3;23;376;0.05;0.01;0.01
11344_7.txt;19;5;3;27;316;0.06;0.02;0.01
9071_8.txt;8;0;0;8;138;0.06;0.0;0.0
9653_9.txt;17;2;0;19;661;0.03;0.0;0.0
6794_10.txt;2;0;0;2;299;0.01;0.0;0.0
8805_9.txt;8;2;0;10;198;0.04;0.01;0.0
3868_10.txt;2;1;0;3;127;0.02;0.01;0.0
6223_7.txt;4;4;0;8;375;0.01;0.01;0.0
6228_7.txt;4;0;0;4;131;0.03;0.0;0.0
8771_7.txt;21;0;2;23;307;0.07;0.0;0.01
4992_7.txt;15;0;0;15;221;0.07;0.0;0.0
11621_9.txt;9;0;1;10;186;0.05;0.0;0.01
6880_7.txt;7;1;4;12;516;0.01;0.0;0.01
11142_8.txt;11;9;4;24;289;0.04;0.03;0.01
8756_9.txt;9;0;0;9;230;0.04;0.0;0.0
2634_7.txt;8;3;5;16;454;0.02;0.01;0.01
9050_8.txt;2;0;0;2;174;0.01;0.0;0.0
10694_7.txt;4;6;2;12;402;0.01;0.01;0.0
6085_8.txt;6;1;0;7;149;0.04;0.01;0.0
3677_8.txt;28;6;0;34;307;0.09;0.02;0.0
4535_7.txt;20;0;0;20;176;0.11;0.0;0.0
6132_10.txt;0;0;0;0;149;0.0;0.0;0.0
4932_8.txt;26;12;7;45;493;0.05;0.02;0.01
3919_7.txt;21;1;1;23;182;0.12;0.01;0.01
6830_10.txt;6;2;0;8;276;0.02;0.01;0.0
8026_9.txt;14;4;0;18;333;0.04;0.01;0.0
4119_8.txt;2;1;0;3;134;0.01;0.01;0.0
6776_7.txt;2;0;0;2;45;0.04;0.0;0.0
7081_8.txt;11;0;2;13;497;0.02;0.0;0.0
5630_8.txt;37;0;0;37;271;0.14;0.0;0.0
10121_8.txt;2;0;0;2;184;0.01;0.0;0.0
12274_10.txt;0;0;0;0;68;0.0;0.0;0.0
5109_10.txt;7;4;2;13;189;0.04;0.02;0.01
4169_7.txt;0;0;0;0;72;0.0;0.0;0.0
7913_10.txt;0;0;0;0;74;0.0;0.0;0.0
12158_7.txt;26;1;2;29;504;0.05;0.0;0.0
6004_10.txt;6;1;3;10;235;0.03;0.0;0.01
10401_10.txt;17;4;0;21;287;0.06;0.01;0.0
4117_9.txt;3;2;0;5;187;0.02;0.01;0.0
4679_10.txt;4;6;0;10;125;0.03;0.05;0.0
3436_8.txt;8;2;0;10;161;0.05;0.01;0.0
11849_8.txt;0;0;0;0;90;0.0;0.0;0.0
5070_9.txt;24;4;2;30;370;0.06;0.01;0.01
2831_7.txt;2;0;5;7;281;0.01;0.0;0.02
132_9.txt;44;8;4;56;885;0.05;0.01;0.0
8938_9.txt;14;1;3;18;168;0.08;0.01;0.02
12088_9.txt;5;0;0;5;111;0.05;0.0;0.0
9781_8.txt;3;0;1;4;708;0.0;0.0;0.0
3870_9.txt;8;1;0;9;342;0.02;0.0;0.0
2214_10.txt;3;4;0;7;224;0.01;0.02;0.0
1823_7.txt;5;1;4;10;393;0.01;0.0;0.01
3483_9.txt;0;0;0;0;62;0.0;0.0;0.0
4976_10.txt;23;1;8;32;335;0.07;0.0;0.02
4075_10.txt;6;3;0;9;185;0.03;0.02;0.0
844_8.txt;7;0;0;7;123;0.06;0.0;0.0
5363_9.txt;6;0;1;7;342;0.02;0.0;0.0
11890_7.txt;9;1;0;10;260;0.03;0.0;0.0
2161_10.txt;4;0;0;4;216;0.02;0.0;0.0
654_10.txt;27;1;0;28;1041;0.03;0.0;0.0
7523_7.txt;11;0;3;14;293;0.04;0.0;0.01
6381_8.txt;7;0;2;9;430;0.02;0.0;0.0
3275_10.txt;11;0;0;11;714;0.02;0.0;0.0
11184_7.txt;39;2;4;45;659;0.06;0.0;0.01
1715_8.txt;17;2;0;19;555;0.03;0.0;0.0
9614_10.txt;0;0;0;0;61;0.0;0.0;0.0
11804_10.txt;3;0;0;3;179;0.02;0.0;0.0
7985_10.txt;42;5;3;50;1079;0.04;0.0;0.0
4528_8.txt;4;1;0;5;228;0.02;0.0;0.0
1414_10.txt;5;2;3;10;585;0.01;0.0;0.01
2090_10.txt;6;1;0;7;318;0.02;0.0;0.0
2543_10.txt;68;5;1;74;921;0.07;0.01;0.0
4648_9.txt;6;2;0;8;391;0.02;0.01;0.0
4957_8.txt;19;2;0;21;340;0.06;0.01;0.0
8657_9.txt;2;0;0;2;187;0.01;0.0;0.0
9175_10.txt;38;16;1;55;1103;0.03;0.01;0.0
2689_9.txt;3;0;0;3;165;0.02;0.0;0.0
11971_10.txt;3;0;0;3;264;0.01;0.0;0.0
5752_8.txt;0;0;0;0;54;0.0;0.0;0.0
12112_10.txt;0;0;0;0;144;0.0;0.0;0.0
3899_9.txt;2;0;0;2;64;0.03;0.0;0.0
8775_9.txt;17;0;4;21;260;0.07;0.0;0.02
6446_10.txt;7;4;0;11;205;0.03;0.02;0.0
3898_10.txt;2;1;0;3;221;0.01;0.0;0.0
8602_10.txt;6;0;0;6;245;0.02;0.0;0.0
4123_7.txt;30;5;25;60;1145;0.03;0.0;0.02
292_10.txt;0;0;0;0;139;0.0;0.0;0.0
8814_10.txt;29;14;2;45;544;0.05;0.03;0.0
6365_7.txt;4;0;0;4;72;0.06;0.0;0.0
12460_7.txt;8;1;2;11;268;0.03;0.0;0.01
10981_8.txt;11;2;4;17;455;0.02;0.0;0.01
3667_8.txt;3;7;0;10;167;0.02;0.04;0.0
7859_7.txt;7;1;1;9;518;0.01;0.0;0.0
10460_10.txt;0;0;0;0;127;0.0;0.0;0.0
9688_9.txt;47;5;2;54;1009;0.05;0.0;0.0
9525_8.txt;26;1;1;28;390;0.07;0.0;0.0
9265_9.txt;8;2;0;10;395;0.02;0.01;0.0
6186_10.txt;61;4;8;73;833;0.07;0.0;0.01
2562_10.txt;8;2;0;10;354;0.02;0.01;0.0
2234_9.txt;0;1;0;1;268;0.0;0.0;0.0
6716_8.txt;26;0;0;26;322;0.08;0.0;0.0
12374_7.txt;24;0;0;24;458;0.05;0.0;0.0
5397_9.txt;14;1;4;19;114;0.12;0.01;0.04
5310_10.txt;11;3;2;16;269;0.04;0.01;0.01
6869_8.txt;4;0;0;4;68;0.06;0.0;0.0
9498_8.txt;24;2;0;26;234;0.1;0.01;0.0
2279_10.txt;2;0;0;2;131;0.02;0.0;0.0
4143_9.txt;4;2;1;7;549;0.01;0.0;0.0
4600_10.txt;4;2;0;6;142;0.03;0.01;0.0
8027_10.txt;6;0;0;6;126;0.05;0.0;0.0
2974_8.txt;0;0;0;0;126;0.0;0.0;0.0
11799_8.txt;3;0;0;3;141;0.02;0.0;0.0
10344_7.txt;14;1;0;15;281;0.05;0.0;0.0
7676_9.txt;8;0;0;8;151;0.05;0.0;0.0
3374_7.txt;8;2;0;10;270;0.03;0.01;0.0
5276_10.txt;0;1;1;2;180;0.0;0.01;0.01
7952_8.txt;0;0;0;0;173;0.0;0.0;0.0
2326_8.txt;10;0;0;10;119;0.08;0.0;0.0
2732_8.txt;19;4;2;25;356;0.05;0.01;0.01
12080_8.txt;7;1;2;10;217;0.03;0.0;0.01
3977_10.txt;0;0;0;0;159;0.0;0.0;0.0
11913_10.txt;0;0;0;0;204;0.0;0.0;0.0
7617_9.txt;3;0;0;3;137;0.02;0.0;0.0
9987_9.txt;6;0;0;6;169;0.04;0.0;0.0
4167_10.txt;2;0;0;2;107;0.02;0.0;0.0
9888_10.txt;0;3;0;3;210;0.0;0.01;0.0
2150_10.txt;0;0;0;0;70;0.0;0.0;0.0
7377_9.txt;3;0;0;3;135;0.02;0.0;0.0
1261_8.txt;5;0;0;5;75;0.07;0.0;0.0
4383_9.txt;114;6;7;127;2137;0.05;0.0;0.0
7214_7.txt;15;0;0;15;292;0.05;0.0;0.0
506_7.txt;3;0;0;3;260;0.01;0.0;0.0
4135_10.txt;6;0;0;6;114;0.05;0.0;0.0
10486_7.txt;5;0;0;5;187;0.03;0.0;0.0
8542_9.txt;5;1;0;6;241;0.02;0.0;0.0
4731_8.txt;3;1;0;4;108;0.03;0.01;0.0
9211_9.txt;15;0;0;15;127;0.12;0.0;0.0
2188_10.txt;2;0;0;2;36;0.06;0.0;0.0
172_10.txt;2;4;0;6;92;0.02;0.04;0.0
11000_10.txt;1;0;0;1;257;0.0;0.0;0.0
1822_8.txt;9;0;4;13;243;0.04;0.0;0.02
9372_9.txt;6;3;0;9;98;0.06;0.03;0.0
10837_10.txt;11;3;0;14;136;0.08;0.02;0.0
9902_7.txt;36;7;4;47;958;0.04;0.01;0.0
5817_10.txt;4;0;2;6;169;0.02;0.0;0.01
4890_10.txt;3;0;0;3;75;0.04;0.0;0.0
572_9.txt;14;0;0;14;157;0.09;0.0;0.0
5514_9.txt;4;4;0;8;306;0.01;0.01;0.0
8008_7.txt;4;1;0;5;353;0.01;0.0;0.0
5910_8.txt;8;1;0;9;217;0.04;0.0;0.0
7336_10.txt;32;2;4;38;339;0.09;0.01;0.01
8535_7.txt;0;0;0;0;125;0.0;0.0;0.0
2514_8.txt;5;0;0;5;174;0.03;0.0;0.0
9707_10.txt;1;1;0;2;156;0.01;0.01;0.0
2294_8.txt;8;0;0;8;163;0.05;0.0;0.0
8032_10.txt;5;0;0;5;60;0.08;0.0;0.0
3251_7.txt;7;0;0;7;244;0.03;0.0;0.0
4586_7.txt;31;9;0;40;837;0.04;0.01;0.0
2365_10.txt;9;0;0;9;154;0.06;0.0;0.0
7881_9.txt;2;0;0;2;39;0.05;0.0;0.0
5334_7.txt;0;0;0;0;238;0.0;0.0;0.0
7454_10.txt;14;0;1;15;316;0.04;0.0;0.0
2678_8.txt;3;2;0;5;298;0.01;0.01;0.0
7737_10.txt;11;0;0;11;135;0.08;0.0;0.0
10424_9.txt;30;1;1;32;465;0.06;0.0;0.0
5005_8.txt;1;0;7;8;371;0.0;0.0;0.02
7016_7.txt;2;0;0;2;160;0.01;0.0;0.0
4572_10.txt;6;0;0;6;63;0.1;0.0;0.0
8718_9.txt;0;0;0;0;66;0.0;0.0;0.0
4192_10.txt;18;5;0;23;445;0.04;0.01;0.0
8845_8.txt;6;0;0;6;149;0.04;0.0;0.0
4355_10.txt;2;0;4;6;168;0.01;0.0;0.02
8090_9.txt;11;2;1;14;354;0.03;0.01;0.0
8991_10.txt;3;0;0;3;166;0.02;0.0;0.0
4917_8.txt;24;4;4;32;654;0.04;0.01;0.01
2142_8.txt;2;1;0;3;95;0.02;0.01;0.0
9387_9.txt;6;0;0;6;274;0.02;0.0;0.0
4220_7.txt;17;2;0;19;297;0.06;0.01;0.0
1271_7.txt;36;0;2;38;362;0.1;0.0;0.01
9293_7.txt;9;0;0;9;138;0.07;0.0;0.0
7776_7.txt;10;1;1;12;196;0.05;0.01;0.01
8546_10.txt;0;0;0;0;162;0.0;0.0;0.0
8945_10.txt;0;0;0;0;148;0.0;0.0;0.0
2641_10.txt;3;1;0;4;153;0.02;0.01;0.0
1120_7.txt;0;1;0;1;432;0.0;0.0;0.0
2190_10.txt;1;0;0;1;25;0.04;0.0;0.0
11843_10.txt;6;0;1;7;431;0.01;0.0;0.0
11012_9.txt;0;3;0;3;198;0.0;0.02;0.0
11124_10.txt;12;2;0;14;279;0.04;0.01;0.0
4626_8.txt;11;2;4;17;868;0.01;0.0;0.0
6533_7.txt;14;0;0;14;139;0.1;0.0;0.0
3694_8.txt;8;1;2;11;189;0.04;0.01;0.01
4177_9.txt;1;0;0;1;95;0.01;0.0;0.0
6148_10.txt;8;3;0;11;150;0.05;0.02;0.0
6096_10.txt;0;0;0;0;286;0.0;0.0;0.0
567_10.txt;12;1;0;13;200;0.06;0.01;0.0
6463_8.txt;6;3;0;9;276;0.02;0.01;0.0
6573_7.txt;6;0;0;6;147;0.04;0.0;0.0
7206_9.txt;2;0;0;2;100;0.02;0.0;0.0
420_7.txt;46;3;4;53;558;0.08;0.01;0.01
8545_9.txt;0;0;0;0;155;0.0;0.0;0.0
11552_9.txt;16;1;0;17;221;0.07;0.0;0.0
8222_9.txt;75;5;0;80;1196;0.06;0.0;0.0
4633_9.txt;5;2;0;7;252;0.02;0.01;0.0
1973_8.txt;5;0;0;5;276;0.02;0.0;0.0
11673_8.txt;7;3;0;10;161;0.04;0.02;0.0
9346_10.txt;11;0;0;11;179;0.06;0.0;0.0
10844_9.txt;3;0;0;3;87;0.03;0.0;0.0
10218_8.txt;0;6;4;10;414;0.0;0.01;0.01
1045_8.txt;41;19;2;62;505;0.08;0.04;0.0
1333_10.txt;2;0;0;2;199;0.01;0.0;0.0
10651_7.txt;6;0;0;6;158;0.04;0.0;0.0
8158_10.txt;2;0;0;2;91;0.02;0.0;0.0
11363_8.txt;3;0;0;3;172;0.02;0.0;0.0
11210_7.txt;10;0;0;10;367;0.03;0.0;0.0
6791_10.txt;0;0;0;0;136;0.0;0.0;0.0
3426_7.txt;0;4;2;6;224;0.0;0.02;0.01
2994_8.txt;30;3;3;36;917;0.03;0.0;0.0
1695_10.txt;0;2;0;2;98;0.0;0.02;0.0
1772_10.txt;0;0;0;0;142;0.0;0.0;0.0
9407_8.txt;35;3;2;40;597;0.06;0.01;0.0
6384_9.txt;0;0;1;1;195;0.0;0.0;0.01
6844_10.txt;47;1;5;53;686;0.07;0.0;0.01
1157_10.txt;5;0;0;5;85;0.06;0.0;0.0
4857_7.txt;26;2;2;30;477;0.05;0.0;0.0
743_7.txt;1;0;0;1;259;0.0;0.0;0.0
4449_8.txt;0;0;0;0;53;0.0;0.0;0.0
9209_7.txt;8;2;0;10;266;0.03;0.01;0.0
6262_9.txt;2;0;0;2;134;0.01;0.0;0.0
38_10.txt;5;0;0;5;101;0.05;0.0;0.0
298_8.txt;6;2;0;8;90;0.07;0.02;0.0
3849_8.txt;4;0;0;4;136;0.03;0.0;0.0
10188_8.txt;26;7;0;33;599;0.04;0.01;0.0
8968_8.txt;14;0;0;14;142;0.1;0.0;0.0
485_8.txt;4;1;4;9;182;0.02;0.01;0.02
1706_9.txt;0;0;0;0;53;0.0;0.0;0.0
2531_7.txt;18;1;0;19;132;0.14;0.01;0.0
6618_8.txt;24;2;2;28;650;0.04;0.0;0.0
10733_7.txt;0;0;0;0;129;0.0;0.0;0.0
531_10.txt;9;0;0;9;370;0.02;0.0;0.0
8499_9.txt;9;4;1;14;59;0.15;0.07;0.02
7959_10.txt;0;0;0;0;157;0.0;0.0;0.0
8609_10.txt;1;0;0;1;163;0.01;0.0;0.0
7308_8.txt;13;2;0;15;267;0.05;0.01;0.0
228_7.txt;17;0;0;17;342;0.05;0.0;0.0
1942_10.txt;0;0;0;0;164;0.0;0.0;0.0
3705_10.txt;8;1;0;9;108;0.07;0.01;0.0
11723_7.txt;33;5;0;38;945;0.03;0.01;0.0
11326_10.txt;0;1;0;1;140;0.0;0.01;0.0
376_10.txt;7;0;0;7;199;0.04;0.0;0.0
10035_9.txt;37;1;0;38;408;0.09;0.0;0.0
11175_8.txt;13;1;0;14;138;0.09;0.01;0.0
3221_10.txt;4;0;0;4;168;0.02;0.0;0.0
4179_10.txt;0;0;0;0;98;0.0;0.0;0.0
549_9.txt;36;2;0;38;205;0.18;0.01;0.0
5288_7.txt;8;2;0;10;229;0.03;0.01;0.0
3981_10.txt;13;1;3;17;161;0.08;0.01;0.02
6594_10.txt;5;13;2;20;351;0.01;0.04;0.01
11979_10.txt;12;0;0;12;221;0.05;0.0;0.0
2079_10.txt;8;2;0;10;194;0.04;0.01;0.0
9371_7.txt;15;0;0;15;158;0.09;0.0;0.0
1802_9.txt;6;0;2;8;442;0.01;0.0;0.0
4491_10.txt;5;1;4;10;188;0.03;0.01;0.02
6448_10.txt;2;0;0;2;221;0.01;0.0;0.0
12375_7.txt;22;0;0;22;604;0.04;0.0;0.0
3131_7.txt;0;0;0;0;98;0.0;0.0;0.0
5212_7.txt;9;2;0;11;289;0.03;0.01;0.0
2957_10.txt;4;0;0;4;51;0.08;0.0;0.0
2830_9.txt;8;0;0;8;70;0.11;0.0;0.0
1726_8.txt;9;0;0;9;272;0.03;0.0;0.0
4137_8.txt;37;10;0;47;623;0.06;0.02;0.0
7666_7.txt;7;1;0;8;88;0.08;0.01;0.0
8636_7.txt;14;0;0;14;130;0.11;0.0;0.0
3663_10.txt;14;1;0;15;358;0.04;0.0;0.0
2432_7.txt;3;0;0;3;279;0.01;0.0;0.0
9074_8.txt;16;0;0;16;184;0.09;0.0;0.0
12435_8.txt;1;0;0;1;162;0.01;0.0;0.0
6451_8.txt;3;0;0;3;499;0.01;0.0;0.0
859_9.txt;0;0;0;0;162;0.0;0.0;0.0
10190_7.txt;26;7;4;37;561;0.05;0.01;0.01
2402_7.txt;12;0;0;12;145;0.08;0.0;0.0
6599_8.txt;24;3;0;27;339;0.07;0.01;0.0
11841_9.txt;0;0;1;1;168;0.0;0.0;0.01
8981_7.txt;6;2;0;8;324;0.02;0.01;0.0
3244_10.txt;4;1;2;7;265;0.02;0.0;0.01
11313_10.txt;23;0;0;23;186;0.12;0.0;0.0
9593_10.txt;0;7;0;7;143;0.0;0.05;0.0
9272_7.txt;1;1;0;2;145;0.01;0.01;0.0
1039_9.txt;11;4;2;17;487;0.02;0.01;0.0
5317_7.txt;11;3;2;16;452;0.02;0.01;0.0
11515_10.txt;2;1;0;3;171;0.01;0.01;0.0
3709_7.txt;22;3;0;25;251;0.09;0.01;0.0
12179_8.txt;17;0;0;17;295;0.06;0.0;0.0
7566_10.txt;4;1;1;6;525;0.01;0.0;0.0
3945_10.txt;3;1;0;4;164;0.02;0.01;0.0
1502_10.txt;2;0;0;2;142;0.01;0.0;0.0
7805_10.txt;6;7;0;13;437;0.01;0.02;0.0
6535_10.txt;4;0;0;4;182;0.02;0.0;0.0
8331_8.txt;10;0;0;10;160;0.06;0.0;0.0
8492_9.txt;16;2;0;18;296;0.05;0.01;0.0
10176_7.txt;19;2;2;23;505;0.04;0.0;0.0
9292_10.txt;2;0;0;2;149;0.01;0.0;0.0
5521_8.txt;13;2;2;17;874;0.01;0.0;0.0
10825_9.txt;5;0;2;7;117;0.04;0.0;0.02
6922_8.txt;36;10;2;48;294;0.12;0.03;0.01
3407_8.txt;31;0;0;31;293;0.11;0.0;0.0
6047_10.txt;4;1;0;5;353;0.01;0.0;0.0
12174_7.txt;9;0;0;9;469;0.02;0.0;0.0
11731_10.txt;7;0;0;7;140;0.05;0.0;0.0
5983_8.txt;5;0;0;5;152;0.03;0.0;0.0
10349_10.txt;0;1;0;1;257;0.0;0.0;0.0
9596_10.txt;0;0;1;1;141;0.0;0.0;0.01
8722_9.txt;7;0;2;9;172;0.04;0.0;0.01
8295_7.txt;5;2;0;7;134;0.04;0.01;0.0
7810_7.txt;14;8;4;26;337;0.04;0.02;0.01
10040_10.txt;20;0;0;20;360;0.06;0.0;0.0
8821_9.txt;1;3;3;7;406;0.0;0.01;0.01
10831_7.txt;2;0;0;2;118;0.02;0.0;0.0
9879_8.txt;55;7;3;65;498;0.11;0.01;0.01
2302_9.txt;9;0;0;9;149;0.06;0.0;0.0
10603_10.txt;2;0;2;4;401;0.0;0.0;0.0
11770_10.txt;1;0;0;1;89;0.01;0.0;0.0
1514_7.txt;18;1;0;19;438;0.04;0.0;0.0
1162_9.txt;5;0;0;5;76;0.07;0.0;0.0
10729_8.txt;0;1;0;1;190;0.0;0.01;0.0
11749_10.txt;4;0;0;4;250;0.02;0.0;0.0
1448_8.txt;29;5;0;34;288;0.1;0.02;0.0
2019_10.txt;0;0;0;0;53;0.0;0.0;0.0
10746_10.txt;0;1;1;2;73;0.0;0.01;0.01
7345_7.txt;1;0;0;1;69;0.01;0.0;0.0
480_10.txt;4;0;0;4;349;0.01;0.0;0.0
3992_8.txt;33;0;2;35;563;0.06;0.0;0.0
3002_8.txt;8;0;0;8;110;0.07;0.0;0.0
9475_9.txt;18;0;0;18;334;0.05;0.0;0.0
9465_7.txt;4;0;0;4;176;0.02;0.0;0.0
2518_10.txt;7;2;0;9;270;0.03;0.01;0.0
824_8.txt;24;1;3;28;536;0.04;0.0;0.01
1425_7.txt;12;2;0;14;377;0.03;0.01;0.0
9938_9.txt;0;0;0;0;358;0.0;0.0;0.0
9907_7.txt;3;0;0;3;372;0.01;0.0;0.0
11419_10.txt;3;1;0;4;109;0.03;0.01;0.0
10385_10.txt;27;2;0;29;159;0.17;0.01;0.0
1194_7.txt;9;0;0;9;170;0.05;0.0;0.0
8706_8.txt;3;0;0;3;407;0.01;0.0;0.0
9832_10.txt;12;0;0;12;204;0.06;0.0;0.0
3865_8.txt;16;0;0;16;182;0.09;0.0;0.0
6854_10.txt;19;2;0;21;292;0.07;0.01;0.0
2323_8.txt;10;0;0;10;216;0.05;0.0;0.0
10794_10.txt;4;0;2;6;68;0.06;0.0;0.03
6645_8.txt;13;0;0;13;239;0.05;0.0;0.0
5330_7.txt;1;0;0;1;135;0.01;0.0;0.0
6832_10.txt;2;0;0;2;132;0.02;0.0;0.0
1595_7.txt;3;0;0;3;168;0.02;0.0;0.0
12030_9.txt;3;0;0;3;179;0.02;0.0;0.0
8963_8.txt;22;3;0;25;309;0.07;0.01;0.0
11872_10.txt;44;0;2;46;768;0.06;0.0;0.0
2104_7.txt;4;0;0;4;205;0.02;0.0;0.0
9600_8.txt;5;9;2;16;222;0.02;0.04;0.01
9091_10.txt;6;1;2;9;212;0.03;0.0;0.01
10682_10.txt;55;2;6;63;659;0.08;0.0;0.01
12479_10.txt;1;6;0;7;87;0.01;0.07;0.0
3609_8.txt;5;1;1;7;194;0.03;0.01;0.01
9395_9.txt;8;0;0;8;126;0.06;0.0;0.0
7927_10.txt;49;6;6;61;831;0.06;0.01;0.01
11501_8.txt;0;0;0;0;152;0.0;0.0;0.0
2733_10.txt;20;4;0;24;816;0.02;0.0;0.0
10863_8.txt;27;2;0;29;693;0.04;0.0;0.0
12199_9.txt;8;4;0;12;616;0.01;0.01;0.0
6287_10.txt;0;0;0;0;94;0.0;0.0;0.0
11341_10.txt;15;4;15;34;284;0.05;0.01;0.05
6558_8.txt;2;0;0;2;161;0.01;0.0;0.0
12297_7.txt;15;2;0;17;388;0.04;0.01;0.0
10693_8.txt;23;0;0;23;466;0.05;0.0;0.0
464_10.txt;6;0;0;6;116;0.05;0.0;0.0
11435_10.txt;0;0;0;0;63;0.0;0.0;0.0
6574_8.txt;3;1;0;4;135;0.02;0.01;0.0
5929_10.txt;2;0;0;2;148;0.01;0.0;0.0
5559_7.txt;3;0;0;3;57;0.05;0.0;0.0
1663_9.txt;0;0;0;0;163;0.0;0.0;0.0
4154_10.txt;2;0;0;2;180;0.01;0.0;0.0
5368_9.txt;32;0;0;32;359;0.09;0.0;0.0
8638_7.txt;20;1;3;24;392;0.05;0.0;0.01
3151_9.txt;15;1;2;18;256;0.06;0.0;0.01
1783_8.txt;67;2;1;70;487;0.14;0.0;0.0
1320_10.txt;15;2;1;18;344;0.04;0.01;0.0
665_9.txt;5;3;3;11;312;0.02;0.01;0.01
5016_10.txt;4;0;0;4;109;0.04;0.0;0.0
2317_10.txt;4;0;0;4;59;0.07;0.0;0.0
4041_7.txt;8;0;0;8;258;0.03;0.0;0.0
6639_10.txt;0;0;0;0;129;0.0;0.0;0.0
8966_10.txt;17;3;0;20;191;0.09;0.02;0.0
6526_7.txt;48;3;0;51;280;0.17;0.01;0.0
9939_10.txt;0;0;0;0;152;0.0;0.0;0.0
11633_8.txt;16;2;0;18;325;0.05;0.01;0.0
9326_10.txt;19;0;0;19;472;0.04;0.0;0.0
7894_10.txt;0;7;0;7;119;0.0;0.06;0.0
2388_10.txt;2;0;0;2;207;0.01;0.0;0.0
11224_8.txt;0;0;0;0;61;0.0;0.0;0.0
5221_7.txt;7;0;0;7;218;0.03;0.0;0.0
10977_8.txt;4;0;0;4;205;0.02;0.0;0.0
7171_10.txt;9;14;3;26;680;0.01;0.02;0.0
9491_10.txt;5;1;2;8;162;0.03;0.01;0.01
6174_10.txt;3;5;2;10;206;0.01;0.02;0.01
4110_10.txt;4;0;0;4;261;0.02;0.0;0.0
1142_10.txt;11;0;1;12;204;0.05;0.0;0.0
6757_8.txt;41;3;2;46;413;0.1;0.01;0.0
3769_7.txt;0;0;0;0;166;0.0;0.0;0.0
3494_9.txt;0;0;0;0;167;0.0;0.0;0.0
8018_10.txt;12;5;4;21;297;0.04;0.02;0.01
3387_10.txt;9;0;0;9;176;0.05;0.0;0.0
8214_7.txt;6;2;2;10;277;0.02;0.01;0.01
6958_7.txt;8;0;0;8;480;0.02;0.0;0.0
10348_8.txt;2;0;0;2;35;0.06;0.0;0.0
2248_7.txt;4;1;0;5;143;0.03;0.01;0.0
8796_8.txt;7;21;3;31;718;0.01;0.03;0.0
1680_8.txt;5;0;0;5;198;0.03;0.0;0.0
8857_10.txt;8;0;0;8;231;0.03;0.0;0.0
3311_10.txt;0;7;0;7;168;0.0;0.04;0.0
1185_8.txt;6;0;0;6;95;0.06;0.0;0.0
4321_8.txt;0;0;0;0;209;0.0;0.0;0.0
2356_10.txt;2;0;0;2;198;0.01;0.0;0.0
8267_7.txt;5;0;1;6;120;0.04;0.0;0.01
5482_10.txt;1;1;0;2;159;0.01;0.01;0.0
11600_7.txt;10;1;1;12;166;0.06;0.01;0.01
7224_8.txt;27;2;3;32;371;0.07;0.01;0.01
11475_8.txt;22;12;1;35;1047;0.02;0.01;0.0
5878_10.txt;17;0;0;17;174;0.1;0.0;0.0
4180_10.txt;0;0;0;0;27;0.0;0.0;0.0
11116_10.txt;2;0;0;2;171;0.01;0.0;0.0
615_10.txt;3;0;0;3;134;0.02;0.0;0.0
12194_10.txt;1;0;0;1;137;0.01;0.0;0.0
2871_10.txt;0;0;2;2;207;0.0;0.0;0.01
1169_8.txt;9;0;0;9;226;0.04;0.0;0.0
10256_8.txt;4;2;1;7;231;0.02;0.01;0.0
3520_9.txt;6;2;0;8;257;0.02;0.01;0.0
10959_10.txt;6;2;0;8;150;0.04;0.01;0.0
4938_7.txt;27;5;1;33;1101;0.02;0.0;0.0
10085_10.txt;2;1;0;3;192;0.01;0.01;0.0
7918_10.txt;8;2;0;10;228;0.04;0.01;0.0
2169_7.txt;0;0;0;0;127;0.0;0.0;0.0
10851_9.txt;8;3;0;11;276;0.03;0.01;0.0
5677_10.txt;7;0;0;7;125;0.06;0.0;0.0
3215_10.txt;2;2;0;4;149;0.01;0.01;0.0
3256_9.txt;5;0;0;5;63;0.08;0.0;0.0
691_9.txt;3;0;0;3;210;0.01;0.0;0.0
1326_10.txt;2;3;0;5;253;0.01;0.01;0.0
6882_9.txt;0;0;0;0;136;0.0;0.0;0.0
1589_10.txt;17;7;0;24;160;0.11;0.04;0.0
11716_7.txt;10;5;1;16;384;0.03;0.01;0.0
1614_10.txt;3;2;0;5;198;0.02;0.01;0.0
12132_10.txt;9;0;0;9;87;0.1;0.0;0.0
991_7.txt;6;0;0;6;374;0.02;0.0;0.0
5850_9.txt;0;0;0;0;130;0.0;0.0;0.0
2237_7.txt;10;5;0;15;492;0.02;0.01;0.0
9837_7.txt;16;1;3;20;576;0.03;0.0;0.01
1115_9.txt;4;0;0;4;167;0.02;0.0;0.0
3126_10.txt;4;0;2;6;227;0.02;0.0;0.01
5100_10.txt;2;0;0;2;52;0.04;0.0;0.0
5691_8.txt;9;1;1;11;420;0.02;0.0;0.0
418_9.txt;15;1;0;16;166;0.09;0.01;0.0
2148_10.txt;5;2;0;7;174;0.03;0.01;0.0
5049_9.txt;8;0;0;8;162;0.05;0.0;0.0
3045_10.txt;10;0;3;13;226;0.04;0.0;0.01
8432_10.txt;3;0;0;3;229;0.01;0.0;0.0
10513_7.txt;5;2;0;7;132;0.04;0.02;0.0
7457_9.txt;1;0;0;1;138;0.01;0.0;0.0
3489_10.txt;3;0;0;3;152;0.02;0.0;0.0
11079_8.txt;0;0;0;0;171;0.0;0.0;0.0
8461_7.txt;36;4;5;45;828;0.04;0.0;0.01
10728_10.txt;6;0;2;8;155;0.04;0.0;0.01
11857_10.txt;2;0;0;2;65;0.03;0.0;0.0
4440_7.txt;7;1;0;8;462;0.02;0.0;0.0
8367_10.txt;0;0;0;0;63;0.0;0.0;0.0
9590_10.txt;0;1;0;1;432;0.0;0.0;0.0
2902_9.txt;25;2;3;30;724;0.03;0.0;0.0
2927_10.txt;2;2;0;4;130;0.02;0.02;0.0
6679_8.txt;2;2;2;6;383;0.01;0.01;0.01
1825_10.txt;0;0;0;0;285;0.0;0.0;0.0
7026_7.txt;9;0;0;9;262;0.03;0.0;0.0
6349_10.txt;0;0;0;0;56;0.0;0.0;0.0
10768_7.txt;8;1;0;9;259;0.03;0.0;0.0
9336_9.txt;0;1;6;7;202;0.0;0.0;0.03
7619_10.txt;0;0;0;0;256;0.0;0.0;0.0
6295_7.txt;0;0;0;0;66;0.0;0.0;0.0
3481_10.txt;41;5;0;46;993;0.04;0.01;0.0
5138_10.txt;2;2;2;6;241;0.01;0.01;0.01
4882_9.txt;8;6;1;15;764;0.01;0.01;0.0
4136_10.txt;2;0;0;2;115;0.02;0.0;0.0
6178_7.txt;9;4;0;13;190;0.05;0.02;0.0
8127_8.txt;0;0;0;0;144;0.0;0.0;0.0
9060_8.txt;2;0;0;2;145;0.01;0.0;0.0
2473_10.txt;31;0;0;31;480;0.06;0.0;0.0
1568_9.txt;10;2;1;13;323;0.03;0.01;0.0
10146_7.txt;0;0;0;0;153;0.0;0.0;0.0
1323_10.txt;3;1;0;4;229;0.01;0.0;0.0
10557_9.txt;6;2;0;8;140;0.04;0.01;0.0
1738_7.txt;12;0;3;15;104;0.12;0.0;0.03
2949_10.txt;16;2;2;20;535;0.03;0.0;0.0
675_9.txt;21;2;0;23;377;0.06;0.01;0.0
8740_8.txt;2;0;3;5;101;0.02;0.0;0.03
2256_8.txt;4;1;0;5;173;0.02;0.01;0.0
10098_10.txt;2;0;3;5;162;0.01;0.0;0.02
9018_8.txt;13;1;3;17;397;0.03;0.0;0.01
4533_8.txt;7;1;0;8;232;0.03;0.0;0.0
10881_7.txt;6;0;0;6;270;0.02;0.0;0.0
4232_7.txt;17;0;0;17;461;0.04;0.0;0.0
199_10.txt;6;3;1;10;142;0.04;0.02;0.01
4395_10.txt;20;1;0;21;195;0.1;0.01;0.0
1642_10.txt;2;2;0;4;151;0.01;0.01;0.0
11819_8.txt;6;0;0;6;184;0.03;0.0;0.0
525_10.txt;0;2;4;6;156;0.0;0.01;0.03
7956_10.txt;0;0;0;0;131;0.0;0.0;0.0
11179_9.txt;8;0;1;9;513;0.02;0.0;0.0
1473_9.txt;17;0;0;17;727;0.02;0.0;0.0
3577_7.txt;3;2;0;5;159;0.02;0.01;0.0
4613_10.txt;12;0;0;12;127;0.09;0.0;0.0
2510_10.txt;2;1;0;3;281;0.01;0.0;0.0
8247_9.txt;3;0;0;3;460;0.01;0.0;0.0
651_10.txt;8;1;0;9;374;0.02;0.0;0.0
9019_8.txt;2;0;0;2;114;0.02;0.0;0.0
11824_10.txt;13;0;0;13;143;0.09;0.0;0.0
9808_9.txt;59;5;2;66;791;0.07;0.01;0.0
6787_9.txt;6;0;1;7;121;0.05;0.0;0.01
10402_10.txt;3;0;0;3;154;0.02;0.0;0.0
11194_10.txt;3;1;0;4;93;0.03;0.01;0.0
1735_10.txt;11;5;0;16;212;0.05;0.02;0.0
8962_9.txt;41;1;2;44;533;0.08;0.0;0.0
10238_10.txt;4;0;0;4;161;0.02;0.0;0.0
2395_7.txt;1;1;2;4;114;0.01;0.01;0.02
9579_8.txt;9;4;1;14;524;0.02;0.01;0.0
2426_9.txt;3;0;0;3;214;0.01;0.0;0.0
2505_9.txt;18;2;0;20;344;0.05;0.01;0.0
3889_10.txt;6;0;0;6;204;0.03;0.0;0.0
5189_10.txt;3;1;0;4;118;0.03;0.01;0.0
8055_8.txt;14;5;0;19;677;0.02;0.01;0.0
6760_9.txt;29;0;0;29;462;0.06;0.0;0.0
3042_8.txt;9;2;4;15;329;0.03;0.01;0.01
8977_7.txt;9;0;0;9;167;0.05;0.0;0.0
7459_10.txt;23;0;0;23;492;0.05;0.0;0.0
6741_7.txt;54;0;0;54;426;0.13;0.0;0.0
11837_7.txt;0;0;6;6;189;0.0;0.0;0.03
10785_10.txt;23;6;4;33;143;0.16;0.04;0.03
9305_10.txt;5;0;0;5;112;0.04;0.0;0.0
10334_8.txt;13;2;2;17;273;0.05;0.01;0.01
7397_8.txt;20;1;0;21;412;0.05;0.0;0.0
1544_10.txt;3;0;0;3;187;0.02;0.0;0.0
2420_10.txt;8;0;0;8;211;0.04;0.0;0.0
3798_9.txt;29;3;0;32;614;0.05;0.0;0.0
3902_10.txt;7;1;1;9;203;0.03;0.0;0.0
3755_10.txt;0;0;0;0;133;0.0;0.0;0.0
7947_10.txt;0;0;0;0;147;0.0;0.0;0.0
7704_10.txt;6;0;0;6;144;0.04;0.0;0.0
8508_7.txt;17;0;0;17;173;0.1;0.0;0.0
8207_10.txt;11;0;0;11;233;0.05;0.0;0.0
7248_9.txt;10;4;0;14;142;0.07;0.03;0.0
8791_10.txt;0;0;0;0;68;0.0;0.0;0.0
10479_10.txt;1;2;0;3;140;0.01;0.01;0.0
5121_10.txt;5;0;0;5;209;0.02;0.0;0.0
8130_10.txt;2;0;0;2;60;0.03;0.0;0.0
6534_10.txt;11;0;0;11;145;0.08;0.0;0.0
9425_10.txt;0;1;0;1;139;0.0;0.01;0.0
919_8.txt;10;0;1;11;233;0.04;0.0;0.0
2753_10.txt;1;0;0;1;75;0.01;0.0;0.0
11246_8.txt;2;1;0;3;169;0.01;0.01;0.0
3030_9.txt;6;1;0;7;151;0.04;0.01;0.0
9106_9.txt;14;3;0;17;193;0.07;0.02;0.0
536_10.txt;6;0;0;6;131;0.05;0.0;0.0
1090_8.txt;32;2;3;37;377;0.08;0.01;0.01
3310_8.txt;0;0;0;0;222;0.0;0.0;0.0
9661_8.txt;9;4;1;14;292;0.03;0.01;0.0
1732_10.txt;15;1;0;16;321;0.05;0.0;0.0
854_9.txt;12;1;1;14;589;0.02;0.0;0.0
4430_8.txt;20;3;0;23;590;0.03;0.01;0.0
5431_10.txt;7;5;0;12;226;0.03;0.02;0.0
2760_8.txt;22;0;0;22;390;0.06;0.0;0.0
3730_10.txt;5;1;0;6;402;0.01;0.0;0.0
10968_7.txt;3;4;4;11;141;0.02;0.03;0.03
7834_8.txt;16;2;5;23;557;0.03;0.0;0.01
9294_7.txt;13;0;2;15;347;0.04;0.0;0.01
7527_10.txt;14;1;2;17;395;0.04;0.0;0.01
9393_10.txt;4;3;0;7;178;0.02;0.02;0.0
3550_10.txt;6;0;0;6;124;0.05;0.0;0.0
3674_8.txt;39;11;7;57;1025;0.04;0.01;0.01
7406_9.txt;0;0;0;0;142;0.0;0.0;0.0
9640_9.txt;0;1;0;1;82;0.0;0.01;0.0
6045_9.txt;0;0;0;0;168;0.0;0.0;0.0
3943_10.txt;15;7;9;31;416;0.04;0.02;0.02
1248_8.txt;5;0;0;5;128;0.04;0.0;0.0
7560_9.txt;2;1;0;3;88;0.02;0.01;0.0
6729_10.txt;3;5;5;13;216;0.01;0.02;0.02
9022_10.txt;1;0;0;1;109;0.01;0.0;0.0
10662_7.txt;14;0;2;16;406;0.03;0.0;0.0
11967_8.txt;1;0;0;1;170;0.01;0.0;0.0
2263_10.txt;4;0;0;4;49;0.08;0.0;0.0
62_10.txt;1;0;0;1;132;0.01;0.0;0.0
4128_10.txt;2;0;0;2;122;0.02;0.0;0.0
10627_10.txt;7;0;0;7;530;0.01;0.0;0.0
5707_10.txt;0;0;2;2;118;0.0;0.0;0.02
3767_9.txt;8;0;0;8;423;0.02;0.0;0.0
2135_8.txt;1;1;0;2;155;0.01;0.01;0.0
4546_10.txt;10;1;0;11;166;0.06;0.01;0.0
340_10.txt;0;0;0;0;66;0.0;0.0;0.0
281_10.txt;0;0;0;0;77;0.0;0.0;0.0
10665_8.txt;3;0;0;3;261;0.01;0.0;0.0
8810_9.txt;21;1;1;23;261;0.08;0.0;0.0
6182_7.txt;26;1;2;29;354;0.07;0.0;0.01
8196_8.txt;5;0;0;5;99;0.05;0.0;0.0
1700_8.txt;1;0;0;1;95;0.01;0.0;0.0
10716_7.txt;5;4;2;11;349;0.01;0.01;0.01
3370_9.txt;6;0;1;7;415;0.01;0.0;0.0
4038_10.txt;8;0;0;8;322;0.02;0.0;0.0
12258_10.txt;14;2;0;16;186;0.08;0.01;0.0
3814_7.txt;29;7;9;45;863;0.03;0.01;0.01
11303_9.txt;6;0;0;6;78;0.08;0.0;0.0
10023_9.txt;2;0;0;2;123;0.02;0.0;0.0
3424_10.txt;2;0;0;2;230;0.01;0.0;0.0
2243_7.txt;0;2;1;3;261;0.0;0.01;0.0
12365_7.txt;2;3;1;6;289;0.01;0.01;0.0
1850_10.txt;4;0;0;4;208;0.02;0.0;0.0
10946_7.txt;7;0;2;9;196;0.04;0.0;0.01
4866_7.txt;33;0;3;36;362;0.09;0.0;0.01
7775_8.txt;10;0;0;10;195;0.05;0.0;0.0
3748_10.txt;4;0;0;4;170;0.02;0.0;0.0
5598_8.txt;16;1;3;20;827;0.02;0.0;0.0
12372_7.txt;43;0;0;43;403;0.11;0.0;0.0
1603_9.txt;0;0;0;0;91;0.0;0.0;0.0
12068_9.txt;0;0;0;0;93;0.0;0.0;0.0
10099_10.txt;14;5;4;23;574;0.02;0.01;0.01
1742_7.txt;4;2;2;8;133;0.03;0.02;0.02
3502_9.txt;13;0;0;13;152;0.09;0.0;0.0
2837_8.txt;38;2;0;40;386;0.1;0.01;0.0
7825_9.txt;10;2;2;14;652;0.02;0.0;0.0
11318_9.txt;12;0;0;12;197;0.06;0.0;0.0
4486_7.txt;25;0;0;25;355;0.07;0.0;0.0
1048_8.txt;0;4;0;4;220;0.0;0.02;0.0
9081_8.txt;0;0;0;0;107;0.0;0.0;0.0
11647_8.txt;12;4;0;16;433;0.03;0.01;0.0
1038_7.txt;8;0;0;8;208;0.04;0.0;0.0
236_9.txt;8;0;1;9;235;0.03;0.0;0.0
9304_9.txt;5;0;0;5;163;0.03;0.0;0.0
569_10.txt;13;4;0;17;285;0.05;0.01;0.0
1451_8.txt;6;4;0;10;217;0.03;0.02;0.0
9360_10.txt;4;0;0;4;744;0.01;0.0;0.0
11282_7.txt;24;1;0;25;641;0.04;0.0;0.0
11908_8.txt;7;0;0;7;201;0.03;0.0;0.0
11148_9.txt;19;4;0;23;235;0.08;0.02;0.0
9084_7.txt;0;0;0;0;243;0.0;0.0;0.0
11111_9.txt;0;4;0;4;222;0.0;0.02;0.0
11140_9.txt;40;10;0;50;724;0.06;0.01;0.0
119_10.txt;0;1;1;2;209;0.0;0.0;0.0
11634_9.txt;2;0;0;2;142;0.01;0.0;0.0
2116_10.txt;6;0;2;8;175;0.03;0.0;0.01
10687_10.txt;0;0;0;0;145;0.0;0.0;0.0
8757_8.txt;12;1;0;13;210;0.06;0.0;0.0
5255_10.txt;17;0;0;17;361;0.05;0.0;0.0
11171_7.txt;0;0;1;1;140;0.0;0.0;0.01
12306_9.txt;20;2;0;22;318;0.06;0.01;0.0
324_8.txt;0;1;1;2;262;0.0;0.0;0.0
6268_9.txt;2;0;0;2;98;0.02;0.0;0.0
7610_9.txt;1;0;0;1;159;0.01;0.0;0.0
11060_10.txt;2;0;0;2;54;0.04;0.0;0.0
2905_7.txt;4;0;0;4;165;0.02;0.0;0.0
9540_8.txt;0;0;4;4;312;0.0;0.0;0.01
11048_7.txt;0;0;0;0;124;0.0;0.0;0.0
2908_8.txt;0;3;0;3;140;0.0;0.02;0.0
9042_10.txt;4;1;1;6;187;0.02;0.01;0.01
8112_9.txt;10;2;0;12;192;0.05;0.01;0.0
9798_7.txt;46;1;0;47;578;0.08;0.0;0.0
904_10.txt;5;2;6;13;162;0.03;0.01;0.04
7259_7.txt;7;0;0;7;99;0.07;0.0;0.0
7563_10.txt;6;0;8;14;921;0.01;0.0;0.01
5835_10.txt;16;0;4;20;222;0.07;0.0;0.02
7220_7.txt;20;0;0;20;286;0.07;0.0;0.0
10908_10.txt;1;0;0;1;147;0.01;0.0;0.0
7482_10.txt;1;0;0;1;157;0.01;0.0;0.0
4392_9.txt;3;0;0;3;134;0.02;0.0;0.0
9129_8.txt;5;0;5;10;210;0.02;0.0;0.02
9428_10.txt;6;2;1;9;209;0.03;0.01;0.0
1640_10.txt;0;1;2;3;151;0.0;0.01;0.01
2606_8.txt;0;0;0;0;197;0.0;0.0;0.0
10820_10.txt;0;0;0;0;547;0.0;0.0;0.0
2126_10.txt;24;1;5;30;441;0.05;0.0;0.01
871_9.txt;28;0;0;28;419;0.07;0.0;0.0
3162_8.txt;13;1;2;16;531;0.02;0.0;0.0
8395_8.txt;63;5;3;71;852;0.07;0.01;0.0
4329_7.txt;38;6;0;44;475;0.08;0.01;0.0
5747_8.txt;10;0;0;10;248;0.04;0.0;0.0
3277_9.txt;0;0;0;0;146;0.0;0.0;0.0
6172_7.txt;26;2;0;28;508;0.05;0.0;0.0
3900_10.txt;1;0;0;1;93;0.01;0.0;0.0
6207_9.txt;26;0;0;26;378;0.07;0.0;0.0
899_7.txt;12;0;5;17;513;0.02;0.0;0.01
7043_7.txt;26;14;2;42;557;0.05;0.03;0.0
4447_7.txt;6;1;0;7;114;0.05;0.01;0.0
81_10.txt;25;0;0;25;218;0.11;0.0;0.0
11296_8.txt;5;7;3;15;365;0.01;0.02;0.01
3158_8.txt;41;1;1;43;337;0.12;0.0;0.0
8829_9.txt;4;1;0;5;234;0.02;0.0;0.0
964_8.txt;4;2;1;7;392;0.01;0.01;0.0
471_7.txt;6;0;0;6;192;0.03;0.0;0.0
9967_10.txt;4;1;0;5;248;0.02;0.0;0.0
4912_8.txt;18;4;0;22;545;0.03;0.01;0.0
9365_9.txt;6;0;0;6;203;0.03;0.0;0.0
12150_7.txt;7;1;0;8;272;0.03;0.0;0.0
7999_10.txt;0;0;0;0;158;0.0;0.0;0.0
5792_10.txt;9;0;0;9;106;0.08;0.0;0.0
10033_10.txt;2;1;0;3;346;0.01;0.0;0.0
1057_9.txt;0;0;0;0;67;0.0;0.0;0.0
3857_9.txt;25;2;0;27;525;0.05;0.0;0.0
10350_10.txt;0;0;0;0;150;0.0;0.0;0.0
2284_10.txt;3;2;2;7;181;0.02;0.01;0.01
7252_8.txt;0;5;4;9;235;0.0;0.02;0.02
3615_9.txt;10;1;0;11;288;0.03;0.0;0.0
3460_8.txt;11;0;0;11;173;0.06;0.0;0.0
4309_8.txt;7;0;0;7;446;0.02;0.0;0.0
11644_10.txt;0;0;2;2;192;0.0;0.0;0.01
1312_9.txt;13;1;3;17;270;0.05;0.0;0.01
1870_10.txt;5;0;3;8;200;0.03;0.0;0.01
6704_9.txt;16;0;0;16;360;0.04;0.0;0.0
7021_10.txt;1;1;6;8;233;0.0;0.0;0.03
1692_8.txt;8;0;0;8;261;0.03;0.0;0.0
1223_7.txt;0;0;0;0;199;0.0;0.0;0.0
2626_8.txt;8;3;2;13;431;0.02;0.01;0.0
12156_8.txt;23;2;2;27;495;0.05;0.0;0.0
7833_8.txt;25;2;0;27;563;0.04;0.0;0.0
11245_10.txt;0;0;0;0;77;0.0;0.0;0.0
9848_7.txt;0;0;0;0;102;0.0;0.0;0.0
10438_9.txt;16;3;0;19;617;0.03;0.0;0.0
3630_7.txt;2;0;1;3;53;0.04;0.0;0.02
11067_7.txt;3;0;1;4;248;0.01;0.0;0.0
4715_9.txt;5;1;0;6;58;0.09;0.02;0.0
487_8.txt;12;0;3;15;410;0.03;0.0;0.01
9851_7.txt;0;0;2;2;113;0.0;0.0;0.02
5765_9.txt;0;7;1;8;602;0.0;0.01;0.0
12208_8.txt;20;5;1;26;798;0.03;0.01;0.0
12380_7.txt;41;0;2;43;431;0.1;0.0;0.0
3179_8.txt;0;0;0;0;260;0.0;0.0;0.0
6276_7.txt;1;0;2;3;65;0.02;0.0;0.03
6269_10.txt;1;0;0;1;109;0.01;0.0;0.0
9180_9.txt;72;18;1;91;1204;0.06;0.01;0.0
8215_7.txt;18;0;0;18;615;0.03;0.0;0.0
8024_10.txt;2;0;1;3;329;0.01;0.0;0.0
2262_10.txt;1;0;0;1;34;0.03;0.0;0.0
9780_10.txt;2;0;0;2;130;0.02;0.0;0.0
8034_10.txt;1;0;0;1;79;0.01;0.0;0.0
586_10.txt;5;4;0;9;474;0.01;0.01;0.0
12045_10.txt;0;3;0;3;215;0.0;0.01;0.0
12171_7.txt;12;1;0;13;530;0.02;0.0;0.0
4803_8.txt;15;3;0;18;548;0.03;0.01;0.0
10576_7.txt;23;0;4;27;622;0.04;0.0;0.01
517_10.txt;14;0;1;15;151;0.09;0.0;0.01
6698_10.txt;14;0;1;15;269;0.05;0.0;0.0
10455_10.txt;2;2;0;4;280;0.01;0.01;0.0
7513_9.txt;40;1;2;43;912;0.04;0.0;0.0
7412_9.txt;0;0;0;0;61;0.0;0.0;0.0
8464_10.txt;6;3;21;30;263;0.02;0.01;0.08
1156_9.txt;0;0;0;0;159;0.0;0.0;0.0
9073_10.txt;3;0;0;3;254;0.01;0.0;0.0
203_7.txt;18;0;0;18;318;0.06;0.0;0.0
9809_7.txt;18;1;0;19;477;0.04;0.0;0.0
404_9.txt;0;0;1;1;96;0.0;0.0;0.01
5380_7.txt;12;0;0;12;398;0.03;0.0;0.0
11242_9.txt;0;1;0;1;136;0.0;0.01;0.0
6991_9.txt;2;0;0;2;132;0.02;0.0;0.0
5668_10.txt;15;0;2;17;154;0.1;0.0;0.01
4634_10.txt;15;29;6;50;662;0.02;0.04;0.01
11875_7.txt;13;6;1;20;391;0.03;0.02;0.0
10784_10.txt;2;0;1;3;77;0.03;0.0;0.01
2077_10.txt;1;0;0;1;325;0.0;0.0;0.0
688_9.txt;2;0;0;2;141;0.01;0.0;0.0
1754_10.txt;0;0;0;0;153;0.0;0.0;0.0
10058_7.txt;6;1;0;7;361;0.02;0.0;0.0
8006_10.txt;7;0;2;9;266;0.03;0.0;0.01
11720_8.txt;3;0;0;3;288;0.01;0.0;0.0
11368_10.txt;4;2;1;7;143;0.03;0.01;0.01
1383_7.txt;24;1;0;25;526;0.05;0.0;0.0
7249_8.txt;3;2;0;5;385;0.01;0.01;0.0
2603_8.txt;10;3;0;13;323;0.03;0.01;0.0
9966_10.txt;3;3;1;7;213;0.01;0.01;0.0
8980_10.txt;27;1;6;34;736;0.04;0.0;0.01
8429_7.txt;0;0;0;0;178;0.0;0.0;0.0
194_8.txt;2;1;1;4;55;0.04;0.02;0.02
2728_10.txt;21;0;0;21;161;0.13;0.0;0.0
5194_10.txt;8;5;2;15;191;0.04;0.03;0.01
5607_7.txt;10;0;0;10;389;0.03;0.0;0.0
4636_8.txt;20;13;0;33;948;0.02;0.01;0.0
5481_10.txt;0;0;0;0;146;0.0;0.0;0.0
5336_8.txt;2;5;0;7;169;0.01;0.03;0.0
2572_10.txt;12;0;0;12;156;0.08;0.0;0.0
9051_10.txt;1;1;1;3;207;0.0;0.0;0.0
10205_10.txt;0;0;0;0;109;0.0;0.0;0.0
5648_10.txt;15;0;0;15;207;0.07;0.0;0.0
12038_9.txt;3;0;5;8;125;0.02;0.0;0.04
6275_7.txt;0;0;0;0;68;0.0;0.0;0.0
11449_10.txt;5;0;0;5;182;0.03;0.0;0.0
10448_10.txt;0;0;0;0;83;0.0;0.0;0.0
6979_10.txt;2;0;1;3;208;0.01;0.0;0.0
8884_9.txt;0;1;1;2;170;0.0;0.01;0.01
756_10.txt;5;0;0;5;144;0.03;0.0;0.0
6027_9.txt;27;1;0;28;547;0.05;0.0;0.0
4850_10.txt;9;1;2;12;309;0.03;0.0;0.01
2055_10.txt;0;0;0;0;73;0.0;0.0;0.0
7311_9.txt;4;0;0;4;146;0.03;0.0;0.0
1759_8.txt;8;1;0;9;366;0.02;0.0;0.0
7363_9.txt;1;0;0;1;166;0.01;0.0;0.0
1141_10.txt;22;0;0;22;274;0.08;0.0;0.0
3060_10.txt;13;0;1;14;474;0.03;0.0;0.0
10339_7.txt;34;8;0;42;1029;0.03;0.01;0.0
7986_10.txt;5;5;0;10;165;0.03;0.03;0.0
55_9.txt;10;0;1;11;224;0.04;0.0;0.0
2048_7.txt;11;1;0;12;126;0.09;0.01;0.0
10882_8.txt;2;0;0;2;113;0.02;0.0;0.0
1835_10.txt;2;0;0;2;195;0.01;0.0;0.0
10102_7.txt;14;0;0;14;180;0.08;0.0;0.0
7816_9.txt;23;9;0;32;496;0.05;0.02;0.0
10681_10.txt;4;0;4;8;270;0.01;0.0;0.01
1512_10.txt;12;2;1;15;905;0.01;0.0;0.0
12140_8.txt;56;4;0;60;737;0.08;0.01;0.0
7070_9.txt;11;0;0;11;325;0.03;0.0;0.0
3557_9.txt;0;0;0;0;60;0.0;0.0;0.0
2032_10.txt;0;0;0;0;51;0.0;0.0;0.0
9521_10.txt;10;0;0;10;215;0.05;0.0;0.0
177_9.txt;0;0;3;3;319;0.0;0.0;0.01
9504_10.txt;10;8;2;20;219;0.05;0.04;0.01
5467_9.txt;10;0;0;10;316;0.03;0.0;0.0
3388_7.txt;5;2;4;11;398;0.01;0.01;0.01
12383_7.txt;45;2;5;52;322;0.14;0.01;0.02
5425_10.txt;12;3;2;17;211;0.06;0.01;0.01
6090_7.txt;2;0;0;2;186;0.01;0.0;0.0
7323_9.txt;21;2;0;23;359;0.06;0.01;0.0
9484_10.txt;0;0;0;0;66;0.0;0.0;0.0
5040_9.txt;7;0;2;9;164;0.04;0.0;0.01
9796_9.txt;28;1;6;35;431;0.06;0.0;0.01
8152_10.txt;0;0;1;1;178;0.0;0.0;0.01
11040_7.txt;0;0;0;0;179;0.0;0.0;0.0
8727_7.txt;0;0;1;1;171;0.0;0.0;0.01
10744_8.txt;0;0;0;0;124;0.0;0.0;0.0
11062_10.txt;5;0;0;5;51;0.1;0.0;0.0
5048_9.txt;11;2;1;14;300;0.04;0.01;0.0
6925_9.txt;38;0;2;40;231;0.16;0.0;0.01
10170_8.txt;0;0;0;0;165;0.0;0.0;0.0
9061_7.txt;1;0;0;1;227;0.0;0.0;0.0
2204_10.txt;0;0;0;0;79;0.0;0.0;0.0
9520_10.txt;15;0;0;15;236;0.06;0.0;0.0
11677_8.txt;3;1;1;5;135;0.02;0.01;0.01
10549_9.txt;2;0;0;2;132;0.02;0.0;0.0
5351_7.txt;1;0;0;1;139;0.01;0.0;0.0
9644_10.txt;0;1;0;1;188;0.0;0.01;0.0
8858_10.txt;35;0;0;35;694;0.05;0.0;0.0
6547_9.txt;15;4;2;21;349;0.04;0.01;0.01
10089_7.txt;5;0;0;5;167;0.03;0.0;0.0
4372_10.txt;15;0;0;15;111;0.14;0.0;0.0
6567_10.txt;10;0;0;10;373;0.03;0.0;0.0
9694_9.txt;4;2;0;6;98;0.04;0.02;0.0
9334_9.txt;4;0;0;4;194;0.02;0.0;0.0
3216_8.txt;45;0;0;45;338;0.13;0.0;0.0
8417_8.txt;5;3;0;8;228;0.02;0.01;0.0
8690_8.txt;7;0;0;7;338;0.02;0.0;0.0
1781_10.txt;0;1;0;1;126;0.0;0.01;0.0
610_9.txt;3;0;2;5;267;0.01;0.0;0.01
11785_10.txt;1;0;0;1;91;0.01;0.0;0.0
70_9.txt;4;0;0;4;47;0.09;0.0;0.0
5989_7.txt;15;0;10;25;416;0.04;0.0;0.02
8594_7.txt;6;0;0;6;149;0.04;0.0;0.0
4531_8.txt;5;1;0;6;160;0.03;0.01;0.0
10074_9.txt;2;3;2;7;137;0.01;0.02;0.01
7339_10.txt;4;0;0;4;116;0.03;0.0;0.0
3360_7.txt;35;2;3;40;360;0.1;0.01;0.01
6351_8.txt;3;1;0;4;91;0.03;0.01;0.0
11929_9.txt;6;4;12;22;193;0.03;0.02;0.06
645_10.txt;0;0;0;0;91;0.0;0.0;0.0
10096_7.txt;18;1;0;19;312;0.06;0.0;0.0
6417_7.txt;11;3;5;19;300;0.04;0.01;0.02
6202_7.txt;14;0;0;14;211;0.07;0.0;0.0
7374_10.txt;0;1;0;1;90;0.0;0.01;0.0
7082_8.txt;2;0;0;2;257;0.01;0.0;0.0
9338_8.txt;25;2;9;36;227;0.11;0.01;0.04
10189_7.txt;17;2;1;20;476;0.04;0.0;0.0
5936_10.txt;2;0;0;2;109;0.02;0.0;0.0
910_10.txt;2;1;0;3;210;0.01;0.0;0.0
8842_9.txt;65;0;1;66;789;0.08;0.0;0.0
10591_10.txt;8;6;0;14;258;0.03;0.02;0.0
7328_8.txt;0;0;0;0;126;0.0;0.0;0.0
4767_9.txt;2;2;0;4;165;0.01;0.01;0.0
9569_9.txt;0;7;0;7;440;0.0;0.02;0.0
2529_7.txt;44;3;0;47;463;0.1;0.01;0.0
354_9.txt;14;2;0;16;844;0.02;0.0;0.0
4439_8.txt;31;0;0;31;245;0.13;0.0;0.0
1621_10.txt;1;2;0;3;210;0.0;0.01;0.0
10249_7.txt;0;2;0;2;329;0.0;0.01;0.0
10798_8.txt;22;0;0;22;208;0.11;0.0;0.0
7701_10.txt;9;4;0;13;347;0.03;0.01;0.0
3784_9.txt;17;0;0;17;169;0.1;0.0;0.0
6856_10.txt;30;0;0;30;415;0.07;0.0;0.0
11871_7.txt;24;1;0;25;201;0.12;0.0;0.0
10471_10.txt;1;0;0;1;228;0.0;0.0;0.0
3881_9.txt;1;0;0;1;216;0.0;0.0;0.0
6668_8.txt;72;0;2;74;1009;0.07;0.0;0.0
2951_8.txt;2;0;0;2;117;0.02;0.0;0.0
5247_10.txt;0;0;0;0;41;0.0;0.0;0.0
6945_10.txt;87;4;4;95;662;0.13;0.01;0.01
8781_9.txt;16;1;0;17;349;0.05;0.0;0.0
3172_9.txt;0;0;2;2;127;0.0;0.0;0.02
43_10.txt;4;0;0;4;73;0.05;0.0;0.0
626_9.txt;21;6;4;31;611;0.03;0.01;0.01
9541_8.txt;3;0;1;4;269;0.01;0.0;0.0
10057_9.txt;1;0;0;1;244;0.0;0.0;0.0
3782_8.txt;1;0;0;1;127;0.01;0.0;0.0
10593_8.txt;4;2;2;8;131;0.03;0.02;0.02
1240_7.txt;17;0;0;17;372;0.05;0.0;0.0
10541_10.txt;0;0;0;0;134;0.0;0.0;0.0
124_10.txt;17;4;0;21;531;0.03;0.01;0.0
3356_10.txt;12;1;0;13;208;0.06;0.0;0.0
4920_7.txt;9;0;0;9;123;0.07;0.0;0.0
10853_10.txt;38;0;2;40;369;0.1;0.0;0.01
3438_10.txt;24;0;0;24;331;0.07;0.0;0.0
287_9.txt;1;0;0;1;175;0.01;0.0;0.0
1584_9.txt;57;5;8;70;800;0.07;0.01;0.01
516_10.txt;0;0;0;0;96;0.0;0.0;0.0
10224_10.txt;6;0;0;6;286;0.02;0.0;0.0
2115_10.txt;0;0;0;0;139;0.0;0.0;0.0
11671_8.txt;13;0;0;13;153;0.08;0.0;0.0
9434_10.txt;8;0;0;8;191;0.04;0.0;0.0
10358_9.txt;10;0;0;10;228;0.04;0.0;0.0
820_10.txt;42;1;6;49;1069;0.04;0.0;0.01
8011_10.txt;0;0;5;5;197;0.0;0.0;0.03
11818_10.txt;31;3;7;41;732;0.04;0.0;0.01
12229_9.txt;2;0;0;2;149;0.01;0.0;0.0
5341_10.txt;8;0;0;8;391;0.02;0.0;0.0
5011_10.txt;0;0;2;2;49;0.0;0.0;0.04
4226_10.txt;0;0;0;0;193;0.0;0.0;0.0
5557_9.txt;10;0;0;10;280;0.04;0.0;0.0
5054_7.txt;8;1;0;9;164;0.05;0.01;0.0
10136_7.txt;4;0;0;4;222;0.02;0.0;0.0
4291_10.txt;2;0;0;2;210;0.01;0.0;0.0
3531_7.txt;21;0;0;21;342;0.06;0.0;0.0
8421_10.txt;10;6;2;18;145;0.07;0.04;0.01
2975_7.txt;4;0;0;4;156;0.03;0.0;0.0
11869_10.txt;2;0;0;2;51;0.04;0.0;0.0
8493_10.txt;3;0;0;3;160;0.02;0.0;0.0
5134_10.txt;5;0;1;6;130;0.04;0.0;0.01
5478_9.txt;3;0;0;3;272;0.01;0.0;0.0
8557_7.txt;12;0;0;12;396;0.03;0.0;0.0
4897_8.txt;14;1;0;15;329;0.04;0.0;0.0
9497_8.txt;10;0;2;12;225;0.04;0.0;0.01
7491_7.txt;10;1;3;14;376;0.03;0.0;0.01
7356_10.txt;4;3;0;7;147;0.03;0.02;0.0
8818_10.txt;33;10;1;44;649;0.05;0.02;0.0
8906_8.txt;2;0;0;2;196;0.01;0.0;0.0
7910_10.txt;0;0;0;0;101;0.0;0.0;0.0
109_10.txt;3;1;0;4;71;0.04;0.01;0.0
11428_7.txt;11;5;0;16;306;0.04;0.02;0.0
12144_8.txt;8;5;0;13;437;0.02;0.01;0.0
3007_7.txt;48;0;0;48;543;0.09;0.0;0.0
4373_10.txt;8;0;0;8;279;0.03;0.0;0.0
3970_7.txt;21;5;3;29;276;0.08;0.02;0.01
7072_9.txt;12;0;0;12;105;0.11;0.0;0.0
11057_10.txt;2;0;0;2;154;0.01;0.0;0.0
6881_9.txt;8;1;0;9;202;0.04;0.0;0.0
345_7.txt;1;0;2;3;123;0.01;0.0;0.02
4517_9.txt;10;0;0;10;145;0.07;0.0;0.0
8355_7.txt;3;0;0;3;199;0.02;0.0;0.0
3703_9.txt;0;0;0;0;83;0.0;0.0;0.0
11226_7.txt;0;0;10;10;376;0.0;0.0;0.03
8153_9.txt;0;0;0;0;145;0.0;0.0;0.0
7012_10.txt;6;0;0;6;131;0.05;0.0;0.0
252_9.txt;3;0;0;3;179;0.02;0.0;0.0
1098_9.txt;23;1;0;24;356;0.06;0.0;0.0
6486_10.txt;0;14;3;17;201;0.0;0.07;0.01
9922_10.txt;0;1;2;3;162;0.0;0.01;0.01
6578_7.txt;31;4;2;37;792;0.04;0.01;0.0
9785_7.txt;0;0;0;0;259;0.0;0.0;0.0
10419_10.txt;10;1;0;11;149;0.07;0.01;0.0
1281_10.txt;6;2;0;8;184;0.03;0.01;0.0
3001_10.txt;6;0;0;6;63;0.1;0.0;0.0
1728_7.txt;4;4;0;8;139;0.03;0.03;0.0
3855_8.txt;32;3;1;36;399;0.08;0.01;0.0
3642_9.txt;6;4;1;11;345;0.02;0.01;0.0
2984_8.txt;13;2;0;15;322;0.04;0.01;0.0
6046_7.txt;1;2;0;3;170;0.01;0.01;0.0
2416_10.txt;18;0;2;20;126;0.14;0.0;0.02
9268_9.txt;0;9;0;9;433;0.0;0.02;0.0
9717_8.txt;18;2;4;24;286;0.06;0.01;0.01
1341_10.txt;4;0;0;4;59;0.07;0.0;0.0
1746_7.txt;6;2;3;11;219;0.03;0.01;0.01
10623_8.txt;23;2;0;25;245;0.09;0.01;0.0
2120_8.txt;4;1;0;5;132;0.03;0.01;0.0
2539_10.txt;14;2;0;16;369;0.04;0.01;0.0
9632_8.txt;6;0;6;12;183;0.03;0.0;0.03
6971_10.txt;3;1;0;4;179;0.02;0.01;0.0
5201_10.txt;9;1;0;10;243;0.04;0.0;0.0
7841_10.txt;13;0;0;13;299;0.04;0.0;0.0
804_10.txt;9;1;1;11;365;0.02;0.0;0.0
490_9.txt;60;1;16;77;1131;0.05;0.0;0.01
5035_7.txt;4;0;0;4;184;0.02;0.0;0.0
6240_10.txt;0;0;0;0;118;0.0;0.0;0.0
7196_8.txt;66;10;3;79;544;0.12;0.02;0.01
6718_10.txt;16;3;8;27;724;0.02;0.0;0.01
7688_10.txt;12;0;2;14;138;0.09;0.0;0.01
6843_9.txt;11;4;4;19;228;0.05;0.02;0.02
9115_10.txt;0;0;0;0;159;0.0;0.0;0.0
1012_10.txt;8;3;0;11;348;0.02;0.01;0.0
2697_9.txt;8;1;0;9;299;0.03;0.0;0.0
7911_10.txt;0;1;0;1;162;0.0;0.01;0.0
10546_9.txt;4;1;0;5;208;0.02;0.0;0.0
5731_7.txt;11;5;0;16;733;0.02;0.01;0.0
3780_8.txt;9;0;0;9;235;0.04;0.0;0.0
1172_8.txt;5;15;5;25;389;0.01;0.04;0.01
9847_7.txt;0;0;2;2;97;0.0;0.0;0.02
1787_10.txt;2;0;0;2;150;0.01;0.0;0.0
3706_7.txt;4;0;0;4;69;0.06;0.0;0.0
4934_8.txt;6;0;0;6;277;0.02;0.0;0.0
11187_9.txt;23;1;0;24;291;0.08;0.0;0.0
11353_9.txt;2;1;0;3;157;0.01;0.01;0.0
879_8.txt;31;0;0;31;930;0.03;0.0;0.0
10026_7.txt;5;0;0;5;155;0.03;0.0;0.0
5325_7.txt;10;1;1;12;292;0.03;0.0;0.0
2907_7.txt;0;4;2;6;78;0.0;0.05;0.03
6589_10.txt;0;0;0;0;132;0.0;0.0;0.0
5646_10.txt;3;0;1;4;209;0.01;0.0;0.0
11039_8.txt;2;0;0;2;185;0.01;0.0;0.0
2865_10.txt;1;8;5;14;380;0.0;0.02;0.01
6801_9.txt;11;3;0;14;171;0.06;0.02;0.0
10800_8.txt;4;0;0;4;119;0.03;0.0;0.0
11666_10.txt;6;2;3;11;237;0.03;0.01;0.01
2772_7.txt;49;8;0;57;552;0.09;0.01;0.0
9936_10.txt;0;0;0;0;138;0.0;0.0;0.0
10913_7.txt;29;0;0;29;397;0.07;0.0;0.0
10879_10.txt;0;0;0;0;151;0.0;0.0;0.0
1914_7.txt;20;0;0;20;335;0.06;0.0;0.0
9830_7.txt;9;1;0;10;358;0.03;0.0;0.0
7075_10.txt;11;0;0;11;452;0.02;0.0;0.0
10151_8.txt;4;2;0;6;165;0.02;0.01;0.0
4844_8.txt;2;0;3;5;136;0.01;0.0;0.02
1259_9.txt;2;0;0;2;45;0.04;0.0;0.0
1586_7.txt;4;1;0;5;229;0.02;0.0;0.0
5642_7.txt;16;3;0;19;439;0.04;0.01;0.0
9094_10.txt;4;3;0;7;143;0.03;0.02;0.0
6433_7.txt;14;3;7;24;264;0.05;0.01;0.03
134_10.txt;7;2;0;9;295;0.02;0.01;0.0
10290_8.txt;15;2;1;18;386;0.04;0.01;0.0
6135_8.txt;3;0;4;7;190;0.02;0.0;0.02
12031_7.txt;4;0;0;4;390;0.01;0.0;0.0
1553_10.txt;1;0;0;1;48;0.02;0.0;0.0
8934_10.txt;7;0;0;7;321;0.02;0.0;0.0
12467_7.txt;52;0;10;62;733;0.07;0.0;0.01
4217_9.txt;7;0;0;7;229;0.03;0.0;0.0
3911_10.txt;4;0;0;4;54;0.07;0.0;0.0
12043_10.txt;2;1;3;6;231;0.01;0.0;0.01
653_10.txt;63;0;2;65;1111;0.06;0.0;0.0
10375_10.txt;6;0;1;7;175;0.03;0.0;0.01
4702_8.txt;17;1;3;21;403;0.04;0.0;0.01
10225_9.txt;2;0;0;2;86;0.02;0.0;0.0
12408_7.txt;13;0;0;13;187;0.07;0.0;0.0
4173_10.txt;0;0;0;0;124;0.0;0.0;0.0
4358_10.txt;12;0;0;12;154;0.08;0.0;0.0
10380_10.txt;0;0;0;0;164;0.0;0.0;0.0
4193_8.txt;12;1;0;13;215;0.06;0.0;0.0
5236_10.txt;4;0;0;4;201;0.02;0.0;0.0
2563_10.txt;7;4;0;11;301;0.02;0.01;0.0
496_10.txt;2;0;0;2;52;0.04;0.0;0.0
6364_8.txt;11;0;0;11;273;0.04;0.0;0.0
4245_7.txt;33;4;0;37;384;0.09;0.01;0.0
12482_8.txt;0;0;0;0;176;0.0;0.0;0.0
12364_7.txt;6;2;0;8;244;0.02;0.01;0.0
1609_9.txt;5;0;0;5;171;0.03;0.0;0.0
12014_10.txt;6;3;7;16;254;0.02;0.01;0.03
12369_7.txt;55;7;3;65;894;0.06;0.01;0.0
11337_10.txt;2;0;0;2;98;0.02;0.0;0.0
221_9.txt;11;0;4;15;174;0.06;0.0;0.02
7905_10.txt;7;2;0;9;187;0.04;0.01;0.0
5094_8.txt;9;0;0;9;144;0.06;0.0;0.0
6764_9.txt;35;5;0;40;643;0.05;0.01;0.0
4678_10.txt;4;6;0;10;149;0.03;0.04;0.0
509_10.txt;14;0;0;14;160;0.09;0.0;0.0
4244_10.txt;4;4;2;10;202;0.02;0.02;0.01
4433_7.txt;8;0;1;9;261;0.03;0.0;0.0
2155_10.txt;16;1;2;19;272;0.06;0.0;0.01
3466_7.txt;0;0;0;0;169;0.0;0.0;0.0
346_10.txt;0;0;0;0;205;0.0;0.0;0.0
1598_8.txt;5;2;0;7;288;0.02;0.01;0.0
3601_7.txt;2;1;0;3;209;0.01;0.0;0.0
9080_7.txt;0;0;0;0;158;0.0;0.0;0.0
4965_9.txt;5;2;3;10;187;0.03;0.01;0.02
3427_8.txt;1;2;0;3;218;0.0;0.01;0.0
11156_8.txt;6;0;0;6;267;0.02;0.0;0.0
7177_8.txt;2;0;2;4;187;0.01;0.0;0.01
9349_8.txt;16;0;0;16;669;0.02;0.0;0.0
7835_9.txt;5;1;0;6;251;0.02;0.0;0.0
8362_7.txt;3;1;0;4;134;0.02;0.01;0.0
3325_7.txt;5;0;0;5;182;0.03;0.0;0.0
4607_10.txt;11;2;0;13;206;0.05;0.01;0.0
1004_7.txt;16;1;0;17;809;0.02;0.0;0.0
9925_7.txt;8;0;0;8;162;0.05;0.0;0.0
6654_7.txt;6;0;0;6;163;0.04;0.0;0.0
4350_10.txt;4;0;0;4;153;0.03;0.0;0.0
8220_8.txt;8;0;0;8;199;0.04;0.0;0.0
4513_8.txt;3;0;0;3;200;0.01;0.0;0.0
2101_7.txt;12;2;0;14;343;0.03;0.01;0.0
8681_8.txt;6;0;2;8;308;0.02;0.0;0.01
7583_7.txt;12;2;0;14;256;0.05;0.01;0.0
2986_8.txt;7;0;0;7;179;0.04;0.0;0.0
580_9.txt;10;0;0;10;213;0.05;0.0;0.0
5698_8.txt;9;0;0;9;149;0.06;0.0;0.0
8760_7.txt;0;2;0;2;189;0.0;0.01;0.0
2797_10.txt;5;1;4;10;265;0.02;0.0;0.02
2403_10.txt;22;1;0;23;536;0.04;0.0;0.0
4578_9.txt;3;0;0;3;61;0.05;0.0;0.0
1055_10.txt;1;1;0;2;69;0.01;0.01;0.0
3066_10.txt;0;0;0;0;77;0.0;0.0;0.0
1947_8.txt;4;0;0;4;151;0.03;0.0;0.0
6458_8.txt;0;0;0;0;145;0.0;0.0;0.0
1752_8.txt;26;1;0;27;595;0.04;0.0;0.0
227_10.txt;9;1;0;10;114;0.08;0.01;0.0
11127_9.txt;53;13;0;66;973;0.05;0.01;0.0
5901_7.txt;10;0;0;10;236;0.04;0.0;0.0
8397_10.txt;0;0;0;0;125;0.0;0.0;0.0
5332_7.txt;1;0;0;1;529;0.0;0.0;0.0
4752_7.txt;10;4;2;16;402;0.02;0.01;0.0
1965_7.txt;3;0;0;3;140;0.02;0.0;0.0
9814_10.txt;12;6;1;19;187;0.06;0.03;0.01
6700_8.txt;21;8;2;31;244;0.09;0.03;0.01
2835_7.txt;11;6;0;17;280;0.04;0.02;0.0
12206_9.txt;10;3;0;13;287;0.03;0.01;0.0
2232_7.txt;0;0;3;3;188;0.0;0.0;0.02
10648_8.txt;2;0;0;2;157;0.01;0.0;0.0
2827_10.txt;4;0;0;4;191;0.02;0.0;0.0
1928_10.txt;3;0;0;3;238;0.01;0.0;0.0
3075_9.txt;6;0;0;6;156;0.04;0.0;0.0
1234_10.txt;0;2;0;2;130;0.0;0.02;0.0
5708_10.txt;0;0;2;2;176;0.0;0.0;0.01
11946_9.txt;24;1;0;25;155;0.15;0.01;0.0
12025_7.txt;10;0;4;14;550;0.02;0.0;0.01
9871_7.txt;6;0;0;6;152;0.04;0.0;0.0
3933_7.txt;26;0;0;26;373;0.07;0.0;0.0
9128_9.txt;5;0;0;5;244;0.02;0.0;0.0
1961_9.txt;2;0;0;2;141;0.01;0.0;0.0
4826_7.txt;2;9;0;11;231;0.01;0.04;0.0
12353_9.txt;3;3;0;6;163;0.02;0.02;0.0
1022_10.txt;2;2;0;4;169;0.01;0.01;0.0
3337_9.txt;15;2;7;24;590;0.03;0.0;0.01
1588_8.txt;37;1;0;38;229;0.16;0.0;0.0
7294_9.txt;2;0;0;2;297;0.01;0.0;0.0
2215_8.txt;0;2;0;2;242;0.0;0.01;0.0
5759_10.txt;2;0;4;6;645;0.0;0.0;0.01
5639_7.txt;5;0;0;5;286;0.02;0.0;0.0
6007_8.txt;0;0;4;4;134;0.0;0.0;0.03
7333_10.txt;3;0;0;3;164;0.02;0.0;0.0
685_8.txt;10;0;2;12;161;0.06;0.0;0.01
10772_10.txt;2;0;0;2;56;0.04;0.0;0.0
8269_7.txt;3;1;1;5;256;0.01;0.0;0.0
2205_8.txt;12;0;3;15;203;0.06;0.0;0.01
7531_8.txt;11;0;0;11;550;0.02;0.0;0.0
3830_10.txt;18;3;0;21;660;0.03;0.0;0.0
3301_10.txt;3;1;0;4;131;0.02;0.01;0.0
5499_10.txt;4;1;0;5;98;0.04;0.01;0.0
3409_10.txt;36;6;6;48;394;0.09;0.02;0.02
9817_8.txt;3;5;2;10;157;0.02;0.03;0.01
761_10.txt;1;0;1;2;121;0.01;0.0;0.01
160_9.txt;0;0;0;0;46;0.0;0.0;0.0
7919_10.txt;27;1;0;28;287;0.09;0.0;0.0
432_8.txt;2;0;0;2;73;0.03;0.0;0.0
7904_8.txt;3;1;0;4;134;0.02;0.01;0.0
5963_10.txt;3;0;0;3;191;0.02;0.0;0.0
12337_7.txt;20;0;0;20;245;0.08;0.0;0.0
9539_7.txt;1;0;1;2;137;0.01;0.0;0.01
3797_9.txt;15;0;0;15;651;0.02;0.0;0.0
4150_10.txt;1;1;0;2;142;0.01;0.01;0.0
5870_8.txt;31;2;3;36;346;0.09;0.01;0.01
244_10.txt;7;3;0;10;121;0.06;0.02;0.0
3574_10.txt;24;2;2;28;737;0.03;0.0;0.0
4913_9.txt;18;0;0;18;290;0.06;0.0;0.0
1543_8.txt;0;0;0;0;142;0.0;0.0;0.0
5084_7.txt;8;0;0;8;176;0.05;0.0;0.0
936_8.txt;12;2;1;15;657;0.02;0.0;0.0
9421_10.txt;12;0;0;12;534;0.02;0.0;0.0
1079_7.txt;2;0;0;2;112;0.02;0.0;0.0
1352_10.txt;6;3;0;9;219;0.03;0.01;0.0
8827_8.txt;6;0;0;6;133;0.05;0.0;0.0
2361_10.txt;2;0;1;3;153;0.01;0.0;0.01
12172_7.txt;10;1;2;13;389;0.03;0.0;0.01
3795_9.txt;4;0;0;4;285;0.01;0.0;0.0
6894_7.txt;5;1;0;6;226;0.02;0.0;0.0
216_8.txt;9;0;0;9;125;0.07;0.0;0.0
8677_9.txt;2;0;2;4;87;0.02;0.0;0.02
9771_10.txt;19;1;0;20;200;0.1;0.01;0.0
3875_9.txt;6;1;0;7;187;0.03;0.01;0.0
12024_7.txt;2;0;0;2;127;0.02;0.0;0.0
10061_8.txt;2;0;0;2;123;0.02;0.0;0.0
6406_9.txt;2;0;0;2;72;0.03;0.0;0.0
9012_7.txt;39;2;1;42;545;0.07;0.0;0.0
10314_8.txt;1;0;0;1;143;0.01;0.0;0.0
9082_10.txt;0;2;0;2;499;0.0;0.0;0.0
8491_7.txt;2;7;0;9;293;0.01;0.02;0.0
10200_10.txt;0;0;0;0;147;0.0;0.0;0.0
571_10.txt;2;3;0;5;199;0.01;0.02;0.0
11519_9.txt;2;0;0;2;162;0.01;0.0;0.0
9568_7.txt;25;4;0;29;392;0.06;0.01;0.0
10489_10.txt;0;0;0;0;118;0.0;0.0;0.0
1729_8.txt;8;0;7;15;242;0.03;0.0;0.03
3416_10.txt;12;5;0;17;759;0.02;0.01;0.0
5292_7.txt;5;5;0;10;529;0.01;0.01;0.0
3290_8.txt;17;0;0;17;230;0.07;0.0;0.0
4810_9.txt;19;4;0;23;536;0.04;0.01;0.0
2720_7.txt;20;5;2;27;545;0.04;0.01;0.0
293_7.txt;0;0;0;0;112;0.0;0.0;0.0
2249_7.txt;3;1;8;12;259;0.01;0.0;0.03
1358_10.txt;1;0;0;1;195;0.01;0.0;0.0
9087_7.txt;26;4;0;30;302;0.09;0.01;0.0
4114_9.txt;0;1;0;1;231;0.0;0.0;0.0
12268_7.txt;0;1;0;1;131;0.0;0.01;0.0
2526_9.txt;5;3;1;9;210;0.02;0.01;0.0
7554_10.txt;0;0;0;0;301;0.0;0.0;0.0
466_8.txt;8;0;0;8;111;0.07;0.0;0.0
1766_10.txt;4;0;1;5;221;0.02;0.0;0.0
10422_7.txt;46;7;6;59;653;0.07;0.01;0.01
3362_8.txt;28;2;3;33;453;0.06;0.0;0.01
9979_7.txt;5;2;0;7;171;0.03;0.01;0.0
12354_10.txt;6;0;0;6;138;0.04;0.0;0.0
10359_7.txt;6;1;0;7;187;0.03;0.01;0.0
1636_10.txt;5;0;4;9;172;0.03;0.0;0.02
10767_10.txt;6;4;0;10;152;0.04;0.03;0.0
1661_8.txt;0;0;0;0;99;0.0;0.0;0.0
9185_9.txt;3;0;0;3;194;0.02;0.0;0.0
5543_7.txt;3;1;0;4;54;0.06;0.02;0.0
8530_9.txt;3;2;0;5;134;0.02;0.01;0.0
931_10.txt;13;2;0;15;244;0.05;0.01;0.0
982_8.txt;7;1;0;8;139;0.05;0.01;0.0
2711_7.txt;11;2;0;13;412;0.03;0.0;0.0
864_9.txt;2;1;0;3;77;0.03;0.01;0.0
8852_9.txt;36;1;0;37;658;0.05;0.0;0.0
7018_10.txt;23;0;2;25;1106;0.02;0.0;0.0
11376_10.txt;13;0;1;14;302;0.04;0.0;0.0
5860_8.txt;0;0;1;1;71;0.0;0.0;0.01
8883_8.txt;10;1;0;11;379;0.03;0.0;0.0
456_10.txt;10;0;0;10;87;0.11;0.0;0.0
9149_9.txt;6;0;0;6;120;0.05;0.0;0.0
5647_10.txt;4;0;0;4;215;0.02;0.0;0.0
429_10.txt;0;1;0;1;110;0.0;0.01;0.0
4926_8.txt;25;7;0;32;460;0.05;0.02;0.0
155_10.txt;43;5;2;50;560;0.08;0.01;0.0
7250_8.txt;2;0;0;2;300;0.01;0.0;0.0
9828_10.txt;0;0;6;6;118;0.0;0.0;0.05
4693_7.txt;18;0;0;18;191;0.09;0.0;0.0
6210_10.txt;39;2;1;42;433;0.09;0.0;0.0
3624_10.txt;2;0;0;2;73;0.03;0.0;0.0
1639_10.txt;3;0;0;3;150;0.02;0.0;0.0
2988_7.txt;24;0;1;25;182;0.13;0.0;0.01
10454_9.txt;14;3;0;17;692;0.02;0.0;0.0
4478_8.txt;13;1;1;15;300;0.04;0.0;0.0
8751_7.txt;11;8;0;19;522;0.02;0.02;0.0
2128_8.txt;2;0;0;2;192;0.01;0.0;0.0
2652_10.txt;11;0;0;11;297;0.04;0.0;0.0
5226_10.txt;2;2;0;4;184;0.01;0.01;0.0
3470_8.txt;23;0;0;23;426;0.05;0.0;0.0
12270_10.txt;2;1;1;4;225;0.01;0.0;0.0
12185_9.txt;3;3;0;6;136;0.02;0.02;0.0
3314_10.txt;0;0;0;0;42;0.0;0.0;0.0
4014_10.txt;2;0;0;2;235;0.01;0.0;0.0
5078_9.txt;0;3;2;5;242;0.0;0.01;0.01
6519_8.txt;10;2;0;12;150;0.07;0.01;0.0
10034_8.txt;14;0;0;14;255;0.05;0.0;0.0
1691_8.txt;3;3;0;6;173;0.02;0.02;0.0
8442_9.txt;5;0;1;6;150;0.03;0.0;0.01
4521_10.txt;4;0;0;4;71;0.06;0.0;0.0
5669_10.txt;8;0;0;8;111;0.07;0.0;0.0
4690_9.txt;0;0;0;0;147;0.0;0.0;0.0
2062_10.txt;4;0;0;4;144;0.03;0.0;0.0
69_10.txt;1;1;0;2;350;0.0;0.0;0.0
8877_9.txt;7;0;0;7;201;0.03;0.0;0.0
3194_9.txt;5;1;0;6;232;0.02;0.0;0.0
11709_10.txt;1;0;0;1;236;0.0;0.0;0.0
8284_8.txt;0;0;0;0;348;0.0;0.0;0.0
12307_10.txt;0;0;0;0;43;0.0;0.0;0.0
1456_9.txt;0;1;0;1;154;0.0;0.01;0.0
8899_8.txt;1;8;3;12;627;0.0;0.01;0.0
5207_7.txt;32;13;0;45;1004;0.03;0.01;0.0
12086_10.txt;7;0;0;7;276;0.03;0.0;0.0
1282_9.txt;2;0;3;5;117;0.02;0.0;0.03
2181_10.txt;3;2;0;5;102;0.03;0.02;0.0
2660_10.txt;7;0;0;7;145;0.05;0.0;0.0
5129_9.txt;2;0;0;2;194;0.01;0.0;0.0
206_10.txt;20;0;0;20;165;0.12;0.0;0.0
8578_8.txt;4;0;0;4;97;0.04;0.0;0.0
5073_7.txt;11;6;0;17;289;0.04;0.02;0.0
12376_7.txt;20;4;7;31;346;0.06;0.01;0.02
5387_8.txt;15;0;1;16;393;0.04;0.0;0.0
2534_8.txt;7;1;3;11;278;0.03;0.0;0.01
10004_8.txt;12;0;0;12;202;0.06;0.0;0.0
10222_9.txt;22;2;8;32;395;0.06;0.01;0.02
678_8.txt;7;0;0;7;149;0.05;0.0;0.0
1840_10.txt;4;1;0;5;176;0.02;0.01;0.0
11256_10.txt;25;0;6;31;219;0.11;0.0;0.03
9410_7.txt;0;0;0;0;187;0.0;0.0;0.0
10832_10.txt;6;0;0;6;87;0.07;0.0;0.0
3565_10.txt;36;6;0;42;333;0.11;0.02;0.0
5_10.txt;11;3;0;14;255;0.04;0.01;0.0
11886_10.txt;1;0;0;1;148;0.01;0.0;0.0
1232_10.txt;5;0;0;5;152;0.03;0.0;0.0
10155_9.txt;2;1;0;3;166;0.01;0.01;0.0
9437_9.txt;31;0;0;31;761;0.04;0.0;0.0
2245_7.txt;24;1;0;25;351;0.07;0.0;0.0
5917_7.txt;20;4;2;26;314;0.06;0.01;0.01
6705_10.txt;11;0;0;11;198;0.06;0.0;0.0
12209_7.txt;0;0;0;0;145;0.0;0.0;0.0
10094_7.txt;14;3;2;19;660;0.02;0.0;0.0
9490_10.txt;9;2;0;11;237;0.04;0.01;0.0
2191_10.txt;7;5;0;12;245;0.03;0.02;0.0
2227_7.txt;3;2;2;7;308;0.01;0.01;0.01
4101_8.txt;3;0;0;3;661;0.0;0.0;0.0
12276_7.txt;0;0;0;0;108;0.0;0.0;0.0
11198_8.txt;4;0;0;4;213;0.02;0.0;0.0
3732_10.txt;14;0;0;14;208;0.07;0.0;0.0
9328_7.txt;2;0;0;2;219;0.01;0.0;0.0
2925_10.txt;2;0;0;2;134;0.01;0.0;0.0
1976_10.txt;6;2;0;8;127;0.05;0.02;0.0
12360_10.txt;0;1;0;1;140;0.0;0.01;0.0
2041_7.txt;12;3;0;15;480;0.03;0.01;0.0
9833_8.txt;2;0;0;2;355;0.01;0.0;0.0
6141_9.txt;5;1;0;6;205;0.02;0.0;0.0
4459_7.txt;23;1;2;26;564;0.04;0.0;0.0
8412_7.txt;0;0;0;0;180;0.0;0.0;0.0
5263_8.txt;8;0;1;9;144;0.06;0.0;0.01
10619_8.txt;23;3;4;30;273;0.08;0.01;0.01
3786_9.txt;24;5;2;31;720;0.03;0.01;0.0
11021_8.txt;17;1;0;18;367;0.05;0.0;0.0
3954_9.txt;0;1;0;1;118;0.0;0.01;0.0
7516_7.txt;29;2;0;31;286;0.1;0.01;0.0
1915_10.txt;9;0;0;9;156;0.06;0.0;0.0
8273_10.txt;3;0;0;3;186;0.02;0.0;0.0
10686_8.txt;2;1;0;3;128;0.02;0.01;0.0
8720_9.txt;6;1;3;10;530;0.01;0.0;0.01
2520_10.txt;3;1;0;4;170;0.02;0.01;0.0
11742_9.txt;16;4;0;20;501;0.03;0.01;0.0
10956_9.txt;1;0;3;4;173;0.01;0.0;0.02
4646_7.txt;1;0;0;1;144;0.01;0.0;0.0
7729_7.txt;2;0;0;2;111;0.02;0.0;0.0
3504_7.txt;0;0;0;0;126;0.0;0.0;0.0
10514_8.txt;12;2;0;14;202;0.06;0.01;0.0
2519_10.txt;13;1;0;14;431;0.03;0.0;0.0
7078_9.txt;45;0;0;45;1058;0.04;0.0;0.0
9217_7.txt;8;3;0;11;297;0.03;0.01;0.0
3578_7.txt;3;0;0;3;81;0.04;0.0;0.0
2318_10.txt;21;1;2;24;248;0.08;0.0;0.01
5086_7.txt;9;0;4;13;166;0.05;0.0;0.02
10605_7.txt;4;0;0;4;44;0.09;0.0;0.0
2508_10.txt;5;0;0;5;200;0.03;0.0;0.0
8393_8.txt;55;3;0;58;1035;0.05;0.0;0.0
11771_10.txt;3;0;3;6;65;0.05;0.0;0.05
3500_10.txt;14;7;7;28;435;0.03;0.02;0.02
8452_7.txt;12;1;2;15;463;0.03;0.0;0.0
10131_10.txt;1;0;0;1;147;0.01;0.0;0.0
5563_8.txt;0;0;2;2;84;0.0;0.0;0.02
1872_7.txt;26;1;2;29;526;0.05;0.0;0.0
2123_10.txt;3;0;0;3;134;0.02;0.0;0.0
11064_7.txt;2;0;0;2;79;0.03;0.0;0.0
8219_7.txt;9;0;0;9;160;0.06;0.0;0.0
6483_10.txt;7;7;0;14;350;0.02;0.02;0.0
7102_7.txt;5;0;0;5;120;0.04;0.0;0.0
4121_10.txt;1;1;0;2;146;0.01;0.01;0.0
6888_9.txt;2;0;0;2;360;0.01;0.0;0.0
3886_10.txt;4;0;0;4;63;0.06;0.0;0.0
2083_7.txt;3;5;0;8;239;0.01;0.02;0.0
4602_8.txt;11;4;0;15;157;0.07;0.03;0.0
6980_9.txt;13;1;4;18;247;0.05;0.0;0.02
6993_7.txt;10;0;0;10;259;0.04;0.0;0.0
6516_10.txt;3;0;0;3;180;0.02;0.0;0.0
2184_7.txt;16;0;0;16;196;0.08;0.0;0.0
9255_10.txt;10;0;1;11;175;0.06;0.0;0.01
3127_9.txt;12;0;0;12;156;0.08;0.0;0.0
11312_9.txt;1;1;3;5;118;0.01;0.01;0.03
4149_10.txt;8;0;0;8;312;0.03;0.0;0.0
7490_8.txt;12;0;3;15;309;0.04;0.0;0.01
45_10.txt;1;0;0;1;163;0.01;0.0;0.0
12335_9.txt;8;0;0;8;134;0.06;0.0;0.0
1649_8.txt;31;8;1;40;945;0.03;0.01;0.0
10048_10.txt;15;3;0;18;611;0.02;0.0;0.0
2708_7.txt;23;0;0;23;328;0.07;0.0;0.0
1369_8.txt;7;0;0;7;170;0.04;0.0;0.0
7267_7.txt;18;2;0;20;322;0.06;0.01;0.0
6726_9.txt;2;0;0;2;133;0.02;0.0;0.0
5793_10.txt;10;0;0;10;331;0.03;0.0;0.0
2230_10.txt;0;2;0;2;184;0.0;0.01;0.0
6663_10.txt;24;2;2;28;262;0.09;0.01;0.01
12403_8.txt;4;4;0;8;212;0.02;0.02;0.0
12397_8.txt;0;0;0;0;51;0.0;0.0;0.0
11204_9.txt;1;0;0;1;135;0.01;0.0;0.0
2807_7.txt;0;0;0;0;86;0.0;0.0;0.0
1758_10.txt;2;2;2;6;247;0.01;0.01;0.01
1005_10.txt;2;0;0;2;122;0.02;0.0;0.0
6013_7.txt;1;0;0;1;200;0.01;0.0;0.0
11401_9.txt;28;7;9;44;609;0.05;0.01;0.01
6799_9.txt;11;3;3;17;340;0.03;0.01;0.01
10430_9.txt;12;2;1;15;701;0.02;0.0;0.0
1953_10.txt;4;0;0;4;228;0.02;0.0;0.0
1913_10.txt;11;2;0;13;263;0.04;0.01;0.0
6860_8.txt;24;0;4;28;276;0.09;0.0;0.01
3372_9.txt;11;6;3;20;371;0.03;0.02;0.01
11285_7.txt;9;0;0;9;410;0.02;0.0;0.0
5783_7.txt;15;1;0;16;221;0.07;0.0;0.0
8772_8.txt;21;0;0;21;374;0.06;0.0;0.0
11977_8.txt;5;0;2;7;153;0.03;0.0;0.01
10621_10.txt;0;1;0;1;73;0.0;0.01;0.0
1572_10.txt;0;0;0;0;152;0.0;0.0;0.0
11746_9.txt;0;0;0;0;126;0.0;0.0;0.0
7300_8.txt;5;0;1;6;219;0.02;0.0;0.0
5826_10.txt;0;0;0;0;219;0.0;0.0;0.0
371_9.txt;6;0;0;6;216;0.03;0.0;0.0
8028_10.txt;4;0;0;4;66;0.06;0.0;0.0
10100_10.txt;0;0;2;2;214;0.0;0.0;0.01
7290_10.txt;4;1;0;5;183;0.02;0.01;0.0
10307_8.txt;16;0;0;16;469;0.03;0.0;0.0
8538_10.txt;0;0;0;0;44;0.0;0.0;0.0
11618_8.txt;18;2;6;26;253;0.07;0.01;0.02
6111_10.txt;20;5;2;27;506;0.04;0.01;0.0
11686_10.txt;0;0;0;0;53;0.0;0.0;0.0
9645_8.txt;0;0;0;0;159;0.0;0.0;0.0
5177_8.txt;1;0;0;1;88;0.01;0.0;0.0
9001_8.txt;0;0;0;0;58;0.0;0.0;0.0
2528_10.txt;2;0;0;2;39;0.05;0.0;0.0
10443_9.txt;6;1;0;7;97;0.06;0.01;0.0
670_7.txt;4;0;0;4;195;0.02;0.0;0.0
3707_7.txt;17;2;0;19;455;0.04;0.0;0.0
7958_10.txt;0;0;0;0;116;0.0;0.0;0.0
3681_8.txt;20;2;0;22;143;0.14;0.01;0.0
493_10.txt;8;0;3;11;148;0.05;0.0;0.02
657_10.txt;5;1;0;6;137;0.04;0.01;0.0
6512_7.txt;10;0;0;10;181;0.06;0.0;0.0
127_7.txt;0;1;0;1;140;0.0;0.01;0.0
1619_10.txt;45;4;3;52;581;0.08;0.01;0.01
7443_7.txt;10;1;0;11;276;0.04;0.0;0.0
4485_10.txt;7;0;0;7;183;0.04;0.0;0.0
8007_7.txt;0;0;0;0;366;0.0;0.0;0.0
5664_8.txt;12;0;2;14;731;0.02;0.0;0.0
7063_8.txt;43;4;1;48;520;0.08;0.01;0.0
2264_9.txt;6;0;0;6;119;0.05;0.0;0.0
2848_7.txt;34;7;2;43;391;0.09;0.02;0.01
10896_8.txt;10;0;0;10;228;0.04;0.0;0.0
3866_7.txt;22;9;5;36;440;0.05;0.02;0.01
786_7.txt;0;0;5;5;342;0.0;0.0;0.01
4536_7.txt;9;0;4;13;139;0.06;0.0;0.03
9361_9.txt;5;0;0;5;152;0.03;0.0;0.0
6541_8.txt;15;0;0;15;362;0.04;0.0;0.0
2022_9.txt;4;0;0;4;135;0.03;0.0;0.0
2035_7.txt;0;0;0;0;162;0.0;0.0;0.0
642_10.txt;0;3;0;3;169;0.0;0.02;0.0
11544_10.txt;32;2;2;36;778;0.04;0.0;0.0
2571_7.txt;4;0;0;4;86;0.05;0.0;0.0
4699_8.txt;0;0;0;0;75;0.0;0.0;0.0
4945_7.txt;17;1;3;21;706;0.02;0.0;0.0
7577_8.txt;4;0;1;5;162;0.02;0.0;0.01
6127_8.txt;6;0;0;6;132;0.05;0.0;0.0
11904_10.txt;8;0;3;11;437;0.02;0.0;0.01
7165_10.txt;0;0;1;1;160;0.0;0.0;0.01
8122_10.txt;0;0;0;0;93;0.0;0.0;0.0
11695_9.txt;1;0;0;1;272;0.0;0.0;0.0
11759_10.txt;12;0;3;15;144;0.08;0.0;0.02
10969_10.txt;1;4;2;7;274;0.0;0.01;0.01
1032_7.txt;2;3;0;5;190;0.01;0.02;0.0
9506_8.txt;9;2;2;13;238;0.04;0.01;0.01
10002_7.txt;4;0;0;4;144;0.03;0.0;0.0
2472_10.txt;6;0;0;6;53;0.11;0.0;0.0
869_7.txt;14;0;0;14;154;0.09;0.0;0.0
1010_10.txt;7;0;0;7;242;0.03;0.0;0.0
10231_10.txt;16;1;1;18;811;0.02;0.0;0.0
8539_8.txt;0;0;0;0;93;0.0;0.0;0.0
3128_9.txt;13;0;0;13;235;0.06;0.0;0.0
6011_8.txt;0;0;0;0;68;0.0;0.0;0.0
4376_9.txt;17;1;0;18;240;0.07;0.0;0.0
7020_10.txt;18;0;0;18;784;0.02;0.0;0.0
673_8.txt;9;0;0;9;233;0.04;0.0;0.0
3984_7.txt;30;2;0;32;217;0.14;0.01;0.0
2051_8.txt;21;6;3;30;593;0.04;0.01;0.01
1068_10.txt;5;0;0;5;208;0.02;0.0;0.0
5519_9.txt;21;10;1;32;885;0.02;0.01;0.0
5238_7.txt;10;0;0;10;160;0.06;0.0;0.0
4106_7.txt;7;0;0;7;152;0.05;0.0;0.0
9229_7.txt;11;1;1;13;553;0.02;0.0;0.0
5882_9.txt;8;2;0;10;131;0.06;0.02;0.0
11648_9.txt;0;3;0;3;281;0.0;0.01;0.0
7382_8.txt;1;0;0;1;64;0.02;0.0;0.0
8699_10.txt;2;0;4;6;60;0.03;0.0;0.07
10437_7.txt;4;0;0;4;296;0.01;0.0;0.0
8289_8.txt;1;0;0;1;56;0.02;0.0;0.0
8559_8.txt;0;0;0;0;181;0.0;0.0;0.0
2739_9.txt;42;4;1;47;458;0.09;0.01;0.0
8283_7.txt;2;0;0;2;111;0.02;0.0;0.0
10445_10.txt;3;0;0;3;298;0.01;0.0;0.0
8956_8.txt;9;0;0;9;131;0.07;0.0;0.0
3193_9.txt;21;0;1;22;248;0.08;0.0;0.0
6309_8.txt;14;2;2;18;318;0.04;0.01;0.01
437_9.txt;0;1;1;2;142;0.0;0.01;0.01
10503_10.txt;12;0;2;14;404;0.03;0.0;0.0
6916_8.txt;27;0;3;30;194;0.14;0.0;0.02
7265_8.txt;2;0;0;2;116;0.02;0.0;0.0
2134_10.txt;17;2;0;19;217;0.08;0.01;0.0
4237_10.txt;22;0;0;22;219;0.1;0.0;0.0
7195_10.txt;6;0;4;10;157;0.04;0.0;0.03
8526_10.txt;4;0;0;4;121;0.03;0.0;0.0
7464_10.txt;0;1;0;1;76;0.0;0.01;0.0
3957_10.txt;26;0;0;26;194;0.13;0.0;0.0
3519_7.txt;39;0;2;41;657;0.06;0.0;0.0
2147_10.txt;3;1;0;4;143;0.02;0.01;0.0
2457_8.txt;1;2;0;3;323;0.0;0.01;0.0
4381_10.txt;15;5;0;20;241;0.06;0.02;0.0
1833_10.txt;27;2;2;31;355;0.08;0.01;0.01
3344_9.txt;2;0;0;2;128;0.02;0.0;0.0
7909_10.txt;0;0;0;0;201;0.0;0.0;0.0
11592_10.txt;2;4;0;6;194;0.01;0.02;0.0
5934_10.txt;4;1;1;6;147;0.03;0.01;0.01
2007_7.txt;4;3;0;7;180;0.02;0.02;0.0
4094_9.txt;3;2;2;7;202;0.01;0.01;0.01
414_10.txt;15;1;0;16;143;0.1;0.01;0.0
4852_8.txt;10;1;6;17;200;0.05;0.01;0.03
10066_10.txt;10;2;2;14;354;0.03;0.01;0.01
6128_7.txt;8;0;1;9;237;0.03;0.0;0.0
4090_8.txt;0;0;0;0;147;0.0;0.0;0.0
4975_8.txt;4;0;0;4;132;0.03;0.0;0.0
8180_8.txt;11;0;0;11;163;0.07;0.0;0.0
8999_8.txt;4;1;0;5;246;0.02;0.0;0.0
866_8.txt;18;0;0;18;560;0.03;0.0;0.0
11631_7.txt;45;8;1;54;886;0.05;0.01;0.0
4367_9.txt;20;1;0;21;281;0.07;0.0;0.0
7275_8.txt;4;0;0;4;199;0.02;0.0;0.0
6024_10.txt;9;2;3;14;620;0.01;0.0;0.0
9500_7.txt;4;1;0;5;128;0.03;0.01;0.0
5105_8.txt;10;1;0;11;465;0.02;0.0;0.0
10704_10.txt;4;1;0;5;383;0.01;0.0;0.0
5898_8.txt;17;8;5;30;326;0.05;0.02;0.02
3804_10.txt;7;1;7;15;837;0.01;0.0;0.01
7434_7.txt;42;0;0;42;989;0.04;0.0;0.0
3961_8.txt;5;3;2;10;386;0.01;0.01;0.01
12458_7.txt;18;0;0;18;468;0.04;0.0;0.0
1830_8.txt;41;10;1;52;737;0.06;0.01;0.0
10958_10.txt;2;0;1;3;295;0.01;0.0;0.0
5494_10.txt;5;3;0;8;177;0.03;0.02;0.0
5604_8.txt;5;0;0;5;327;0.02;0.0;0.0
3636_8.txt;8;0;0;8;200;0.04;0.0;0.0
10735_10.txt;0;0;1;1;74;0.0;0.0;0.01
9430_9.txt;2;1;0;3;182;0.01;0.01;0.0
7997_10.txt;3;0;0;3;118;0.03;0.0;0.0
7400_9.txt;0;0;0;0;67;0.0;0.0;0.0
11665_8.txt;12;0;1;13;362;0.03;0.0;0.0
9207_10.txt;30;3;0;33;370;0.08;0.01;0.0
10087_10.txt;4;0;1;5;68;0.06;0.0;0.01
6746_8.txt;12;0;0;12;219;0.05;0.0;0.0
7590_10.txt;2;1;0;3;166;0.01;0.01;0.0
4334_10.txt;10;0;0;10;214;0.05;0.0;0.0
4735_9.txt;3;0;0;3;141;0.02;0.0;0.0
4278_10.txt;1;0;0;1;113;0.01;0.0;0.0
10512_10.txt;6;0;0;6;71;0.08;0.0;0.0
6470_10.txt;3;0;0;3;167;0.02;0.0;0.0
5335_10.txt;0;0;0;0;62;0.0;0.0;0.0
1356_8.txt;4;4;2;10;289;0.01;0.01;0.01
1118_10.txt;3;4;0;7;139;0.02;0.03;0.0
7650_9.txt;4;1;0;5;130;0.03;0.01;0.0
1207_10.txt;0;0;0;0;136;0.0;0.0;0.0
11406_9.txt;13;2;5;20;598;0.02;0.0;0.01
11669_9.txt;6;0;0;6;60;0.1;0.0;0.0
764_10.txt;0;0;1;1;164;0.0;0.0;0.01
2392_8.txt;7;0;0;7;123;0.06;0.0;0.0
11934_8.txt;8;0;1;9;110;0.07;0.0;0.01
4534_9.txt;12;0;0;12;229;0.05;0.0;0.0
8106_7.txt;0;0;0;0;315;0.0;0.0;0.0
2877_9.txt;1;0;2;3;148;0.01;0.0;0.01
11504_8.txt;35;3;3;41;711;0.05;0.0;0.0
1554_8.txt;0;0;0;0;148;0.0;0.0;0.0
2057_10.txt;0;0;0;0;152;0.0;0.0;0.0
3425_8.txt;6;4;6;16;748;0.01;0.01;0.01
4499_9.txt;4;1;3;8;250;0.02;0.0;0.01
2614_9.txt;0;1;1;2;237;0.0;0.0;0.0
4804_7.txt;2;1;0;3;121;0.02;0.01;0.0
10412_8.txt;3;3;2;8;305;0.01;0.01;0.01
9651_9.txt;4;0;0;4;217;0.02;0.0;0.0
1228_9.txt;16;2;6;24;227;0.07;0.01;0.03
1999_9.txt;13;4;0;17;273;0.05;0.01;0.0
9549_8.txt;1;1;0;2;178;0.01;0.01;0.0
4241_10.txt;4;0;0;4;156;0.03;0.0;0.0
10949_8.txt;5;0;0;5;150;0.03;0.0;0.0
8970_10.txt;13;4;1;18;271;0.05;0.01;0.0
11099_10.txt;4;0;0;4;161;0.02;0.0;0.0
8445_10.txt;0;4;1;5;144;0.0;0.03;0.01
1681_7.txt;8;1;0;9;160;0.05;0.01;0.0
5210_10.txt;1;0;0;1;206;0.0;0.0;0.0
8435_10.txt;13;0;1;14;237;0.05;0.0;0.0
2643_10.txt;0;0;0;0;180;0.0;0.0;0.0
5924_8.txt;22;0;0;22;271;0.08;0.0;0.0
9258_10.txt;0;6;0;6;474;0.0;0.01;0.0
11969_10.txt;29;1;0;30;352;0.08;0.0;0.0
10473_10.txt;3;0;0;3;93;0.03;0.0;0.0
6838_7.txt;24;3;0;27;761;0.03;0.0;0.0
10897_9.txt;19;0;0;19;386;0.05;0.0;0.0
705_10.txt;1;0;0;1;186;0.01;0.0;0.0
10911_7.txt;21;1;0;22;212;0.1;0.0;0.0
9548_10.txt;4;3;1;8;161;0.02;0.02;0.01
11295_9.txt;25;4;1;30;392;0.06;0.01;0.0
4650_7.txt;0;0;4;4;126;0.0;0.0;0.03
7715_8.txt;4;0;0;4;241;0.02;0.0;0.0
9882_8.txt;40;0;1;41;413;0.1;0.0;0.0
5616_8.txt;4;0;1;5;201;0.02;0.0;0.0
7771_9.txt;15;6;3;24;294;0.05;0.02;0.01
11774_10.txt;4;0;0;4;212;0.02;0.0;0.0
555_8.txt;6;5;0;11;175;0.03;0.03;0.0
6632_7.txt;1;0;0;1;62;0.02;0.0;0.0
1393_7.txt;14;2;0;16;362;0.04;0.01;0.0
10887_7.txt;2;0;0;2;205;0.01;0.0;0.0
1894_8.txt;76;0;12;88;436;0.17;0.0;0.03
2012_8.txt;10;0;0;10;189;0.05;0.0;0.0
1310_7.txt;44;2;0;46;587;0.07;0.0;0.0
1779_10.txt;3;1;0;4;164;0.02;0.01;0.0
3303_10.txt;0;0;0;0;47;0.0;0.0;0.0
8236_7.txt;44;1;2;47;334;0.13;0.0;0.01
18_7.txt;8;1;0;9;139;0.06;0.01;0.0
3293_10.txt;24;0;0;24;252;0.1;0.0;0.0
6899_9.txt;4;0;0;4;71;0.06;0.0;0.0
5136_10.txt;3;0;0;3;89;0.03;0.0;0.0
4697_7.txt;37;0;0;37;332;0.11;0.0;0.0
5434_9.txt;25;11;4;40;587;0.04;0.02;0.01
2749_10.txt;2;0;0;2;108;0.02;0.0;0.0
739_7.txt;7;0;1;8;213;0.03;0.0;0.0
3801_8.txt;12;1;3;16;373;0.03;0.0;0.01
9234_8.txt;5;1;0;6;166;0.03;0.01;0.0
2374_9.txt;24;5;0;29;1005;0.02;0.0;0.0
3622_8.txt;5;0;0;5;173;0.03;0.0;0.0
3778_10.txt;12;0;1;13;551;0.02;0.0;0.0
10457_8.txt;0;0;0;0;116;0.0;0.0;0.0
11813_8.txt;31;0;2;33;466;0.07;0.0;0.0
4516_10.txt;5;0;0;5;75;0.07;0.0;0.0
10129_7.txt;11;0;0;11;169;0.07;0.0;0.0
11561_10.txt;11;0;0;11;306;0.04;0.0;0.0
4585_10.txt;5;0;0;5;72;0.07;0.0;0.0
6114_7.txt;7;0;0;7;139;0.05;0.0;0.0
10684_9.txt;5;0;0;5;116;0.04;0.0;0.0
44_8.txt;0;0;0;0;167;0.0;0.0;0.0
3597_10.txt;0;0;0;0;154;0.0;0.0;0.0
6255_8.txt;0;1;0;1;190;0.0;0.01;0.0
1083_10.txt;5;0;1;6;103;0.05;0.0;0.01
2383_9.txt;34;2;10;46;795;0.04;0.0;0.01
7255_9.txt;0;0;0;0;130;0.0;0.0;0.0
11538_7.txt;19;1;0;20;408;0.05;0.0;0.0
8685_9.txt;13;0;0;13;484;0.03;0.0;0.0
7846_10.txt;1;0;0;1;246;0.0;0.0;0.0
7681_9.txt;2;1;0;3;234;0.01;0.0;0.0
12457_8.txt;13;0;0;13;519;0.03;0.0;0.0
3572_10.txt;15;0;1;16;449;0.03;0.0;0.0
12282_8.txt;8;1;0;9;239;0.03;0.0;0.0
6156_10.txt;0;0;1;1;205;0.0;0.0;0.0
3046_10.txt;5;1;0;6;348;0.01;0.0;0.0
9197_7.txt;3;0;0;3;205;0.01;0.0;0.0
9769_8.txt;3;0;0;3;125;0.02;0.0;0.0
1690_10.txt;0;0;0;0;106;0.0;0.0;0.0
1637_10.txt;8;1;0;9;206;0.04;0.0;0.0
11780_8.txt;2;2;0;4;197;0.01;0.01;0.0
8563_10.txt;3;0;0;3;132;0.02;0.0;0.0
5096_7.txt;16;3;0;19;156;0.1;0.02;0.0
4549_7.txt;10;0;0;10;261;0.04;0.0;0.0
4643_10.txt;15;7;0;22;674;0.02;0.01;0.0
3752_7.txt;0;0;0;0;149;0.0;0.0;0.0
8279_10.txt;0;0;0;0;60;0.0;0.0;0.0
3937_8.txt;9;1;4;14;135;0.07;0.01;0.03
7604_9.txt;3;1;0;4;399;0.01;0.0;0.0
2064_8.txt;0;0;0;0;159;0.0;0.0;0.0
4054_9.txt;5;1;0;6;181;0.03;0.01;0.0
10942_9.txt;4;0;0;4;142;0.03;0.0;0.0
2058_9.txt;5;0;0;5;153;0.03;0.0;0.0
11283_8.txt;14;0;6;20;505;0.03;0.0;0.01
5319_8.txt;9;1;0;10;222;0.04;0.0;0.0
2615_9.txt;0;0;0;0;444;0.0;0.0;0.0
3273_9.txt;2;0;1;3;169;0.01;0.0;0.01
8856_8.txt;19;0;0;19;344;0.06;0.0;0.0
3291_8.txt;3;0;2;5;234;0.01;0.0;0.01
10210_7.txt;2;1;0;3;226;0.01;0.0;0.0
4692_10.txt;16;0;0;16;179;0.09;0.0;0.0
6815_8.txt;6;1;0;7;146;0.04;0.01;0.0
11136_10.txt;6;3;0;9;297;0.02;0.01;0.0
1309_10.txt;4;0;0;4;66;0.06;0.0;0.0
167_7.txt;18;0;3;21;223;0.08;0.0;0.01
8253_10.txt;12;0;0;12;196;0.06;0.0;0.0
709_10.txt;0;0;0;0;120;0.0;0.0;0.0
4903_10.txt;23;5;9;37;381;0.06;0.01;0.02
12382_8.txt;2;0;0;2;256;0.01;0.0;0.0
11053_10.txt;42;1;0;43;615;0.07;0.0;0.0
1029_9.txt;0;0;0;0;171;0.0;0.0;0.0
8320_8.txt;9;0;0;9;197;0.05;0.0;0.0
146_10.txt;7;0;0;7;184;0.04;0.0;0.0
5239_7.txt;0;2;0;2;65;0.0;0.03;0.0
9160_8.txt;3;1;0;4;70;0.04;0.01;0.0
9311_10.txt;0;0;0;0;165;0.0;0.0;0.0
8078_10.txt;2;0;3;5;139;0.01;0.0;0.02
4700_9.txt;3;0;0;3;388;0.01;0.0;0.0
2460_10.txt;5;0;0;5;141;0.04;0.0;0.0
12041_9.txt;2;1;0;3;169;0.01;0.01;0.0
41_9.txt;19;0;2;21;314;0.06;0.0;0.01
6997_7.txt;2;0;0;2;191;0.01;0.0;0.0
3826_10.txt;4;0;1;5;466;0.01;0.0;0.0
9323_10.txt;0;0;0;0;179;0.0;0.0;0.0
7827_10.txt;9;0;0;9;123;0.07;0.0;0.0
12287_10.txt;0;0;0;0;108;0.0;0.0;0.0
1402_7.txt;6;0;0;6;198;0.03;0.0;0.0
12230_9.txt;9;1;0;10;471;0.02;0.0;0.0
10814_7.txt;5;0;0;5;260;0.02;0.0;0.0
8403_10.txt;3;0;0;3;165;0.02;0.0;0.0
3182_8.txt;28;2;0;30;296;0.09;0.01;0.0
5562_10.txt;1;0;3;4;135;0.01;0.0;0.02
9256_10.txt;0;0;2;2;66;0.0;0.0;0.03
830_10.txt;6;0;2;8;147;0.04;0.0;0.01
10376_7.txt;4;1;0;5;146;0.03;0.01;0.0
2179_8.txt;16;6;3;25;688;0.02;0.01;0.0
3068_9.txt;14;0;1;15;322;0.04;0.0;0.0
3000_8.txt;78;2;4;84;694;0.11;0.0;0.01
2743_9.txt;9;1;0;10;485;0.02;0.0;0.0
13_7.txt;12;4;1;17;241;0.05;0.02;0.0
5150_7.txt;13;1;2;16;176;0.07;0.01;0.01
1212_8.txt;5;0;0;5;167;0.03;0.0;0.0
5348_8.txt;1;0;1;2;79;0.01;0.0;0.01
2086_10.txt;11;1;0;12;389;0.03;0.0;0.0
6836_9.txt;35;6;3;44;1132;0.03;0.01;0.0
11516_8.txt;9;0;0;9;318;0.03;0.0;0.0
12190_7.txt;21;6;2;29;570;0.04;0.01;0.0
1567_7.txt;15;1;2;18;228;0.07;0.0;0.01
2773_7.txt;30;4;0;34;458;0.07;0.01;0.0
247_10.txt;6;0;0;6;158;0.04;0.0;0.0
883_9.txt;24;0;0;24;501;0.05;0.0;0.0
3155_10.txt;2;0;0;2;138;0.01;0.0;0.0
1480_8.txt;1;0;0;1;232;0.0;0.0;0.0
5833_10.txt;1;0;0;1;148;0.01;0.0;0.0
3048_10.txt;4;0;0;4;145;0.03;0.0;0.0
5110_10.txt;0;3;0;3;167;0.0;0.02;0.0
7186_7.txt;12;5;2;19;294;0.04;0.02;0.01
280_8.txt;4;2;0;6;374;0.01;0.01;0.0
10127_8.txt;4;0;0;4;227;0.02;0.0;0.0
131_10.txt;12;3;1;16;638;0.02;0.0;0.0
7639_8.txt;1;0;0;1;228;0.0;0.0;0.0
1676_9.txt;14;3;6;23;445;0.03;0.01;0.01
12399_9.txt;1;3;2;6;625;0.0;0.0;0.0
10070_9.txt;0;0;0;0;80;0.0;0.0;0.0
1266_8.txt;4;2;0;6;135;0.03;0.01;0.0
1135_9.txt;0;0;0;0;152;0.0;0.0;0.0
6411_10.txt;9;0;0;9;184;0.05;0.0;0.0
1274_7.txt;4;0;0;4;304;0.01;0.0;0.0
2795_7.txt;20;0;0;20;158;0.13;0.0;0.0
2441_10.txt;16;3;4;23;496;0.03;0.01;0.01
6822_7.txt;10;5;0;15;263;0.04;0.02;0.0
7855_8.txt;17;0;2;19;343;0.05;0.0;0.01
7578_8.txt;6;0;0;6;115;0.05;0.0;0.0
10435_7.txt;2;0;0;2;267;0.01;0.0;0.0
6447_8.txt;38;1;0;39;604;0.06;0.0;0.0
7819_9.txt;37;9;0;46;579;0.06;0.02;0.0
8733_10.txt;12;0;5;17;218;0.06;0.0;0.02
9028_10.txt;2;1;0;3;53;0.04;0.02;0.0
2605_7.txt;0;1;0;1;73;0.0;0.01;0.0
9994_10.txt;6;0;0;6;176;0.03;0.0;0.0
1211_7.txt;0;0;0;0;159;0.0;0.0;0.0
2893_10.txt;11;0;5;16;255;0.04;0.0;0.02
7955_10.txt;2;0;0;2;158;0.01;0.0;0.0
2541_7.txt;29;3;0;32;455;0.06;0.01;0.0
3890_10.txt;2;3;0;5;155;0.01;0.02;0.0
1977_10.txt;3;0;0;3;107;0.03;0.0;0.0
11619_9.txt;11;0;0;11;161;0.07;0.0;0.0
11487_10.txt;6;0;2;8;500;0.01;0.0;0.0
11083_10.txt;2;0;0;2;112;0.02;0.0;0.0
1327_9.txt;0;0;1;1;102;0.0;0.0;0.01
9973_8.txt;0;0;0;0;155;0.0;0.0;0.0
4236_8.txt;1;0;0;1;120;0.01;0.0;0.0
7663_7.txt;5;0;1;6;237;0.02;0.0;0.0
4281_10.txt;0;1;0;1;141;0.0;0.01;0.0
2031_8.txt;12;5;0;17;312;0.04;0.02;0.0
5199_7.txt;3;1;0;4;151;0.02;0.01;0.0
1469_7.txt;5;1;1;7;236;0.02;0.0;0.0
682_10.txt;5;0;0;5;234;0.02;0.0;0.0
784_10.txt;0;0;2;2;62;0.0;0.0;0.03
1886_10.txt;3;0;0;3;192;0.02;0.0;0.0
4051_8.txt;17;3;2;22;432;0.04;0.01;0.0
918_10.txt;25;1;3;29;283;0.09;0.0;0.01
4017_7.txt;8;1;1;10;397;0.02;0.0;0.0
5092_8.txt;15;0;0;15;179;0.08;0.0;0.0
4058_10.txt;49;5;8;62;1121;0.04;0.0;0.01
4905_10.txt;16;1;1;18;312;0.05;0.0;0.0
11_9.txt;0;0;4;4;47;0.0;0.0;0.09
10357_8.txt;14;2;4;20;778;0.02;0.0;0.01
11434_7.txt;0;0;0;0;50;0.0;0.0;0.0
5402_9.txt;40;3;0;43;734;0.05;0.0;0.0
4929_7.txt;5;2;0;7;239;0.02;0.01;0.0
7757_9.txt;50;3;2;55;664;0.08;0.0;0.0
8208_8.txt;6;0;0;6;290;0.02;0.0;0.0
667_8.txt;22;1;0;23;455;0.05;0.0;0.0
6089_10.txt;2;0;0;2;156;0.01;0.0;0.0
4010_10.txt;13;0;0;13;288;0.05;0.0;0.0
4551_10.txt;6;0;0;6;202;0.03;0.0;0.0
7656_10.txt;0;0;0;0;59;0.0;0.0;0.0
3968_10.txt;17;0;4;21;229;0.07;0.0;0.02
7916_8.txt;10;0;0;10;315;0.03;0.0;0.0
201_10.txt;22;3;3;28;138;0.16;0.02;0.02
7149_10.txt;2;0;0;2;74;0.03;0.0;0.0
602_10.txt;2;2;1;5;198;0.01;0.01;0.01
495_7.txt;6;0;4;10;410;0.01;0.0;0.01
12334_7.txt;7;3;0;10;130;0.05;0.02;0.0
5008_10.txt;8;1;1;10;808;0.01;0.0;0.0
3333_8.txt;0;2;6;8;158;0.0;0.01;0.04
11532_8.txt;0;0;0;0;141;0.0;0.0;0.0
8407_7.txt;6;0;1;7;185;0.03;0.0;0.01
1540_10.txt;4;3;0;7;361;0.01;0.01;0.0
258_7.txt;35;2;3;40;440;0.08;0.0;0.01
11133_10.txt;20;4;0;24;1154;0.02;0.0;0.0
6788_9.txt;0;0;0;0;137;0.0;0.0;0.0
2224_10.txt;3;0;0;3;129;0.02;0.0;0.0
8315_10.txt;6;0;0;6;142;0.04;0.0;0.0
4540_7.txt;29;6;0;35;328;0.09;0.02;0.0
10475_8.txt;2;0;0;2;175;0.01;0.0;0.0
4239_10.txt;8;2;1;11;160;0.05;0.01;0.01
12005_10.txt;2;0;0;2;153;0.01;0.0;0.0
11900_8.txt;1;0;0;1;122;0.01;0.0;0.0
2398_9.txt;2;1;0;3;114;0.02;0.01;0.0
8110_9.txt;0;0;0;0;115;0.0;0.0;0.0
611_10.txt;1;0;0;1;225;0.0;0.0;0.0
7053_7.txt;16;2;1;19;339;0.05;0.01;0.0
7769_7.txt;5;2;4;11;200;0.03;0.01;0.02
10482_10.txt;0;0;0;0;119;0.0;0.0;0.0
5161_8.txt;19;1;0;20;346;0.05;0.0;0.0
3647_10.txt;9;0;2;11;245;0.04;0.0;0.01
12157_9.txt;34;2;1;37;361;0.09;0.01;0.0
2989_10.txt;18;0;0;18;134;0.13;0.0;0.0
10456_10.txt;0;0;0;0;238;0.0;0.0;0.0
9332_10.txt;1;0;0;1;39;0.03;0.0;0.0
5205_7.txt;18;5;0;23;656;0.03;0.01;0.0
10496_10.txt;2;0;0;2;123;0.02;0.0;0.0
11493_7.txt;9;0;0;9;128;0.07;0.0;0.0
8520_8.txt;0;0;0;0;151;0.0;0.0;0.0
7754_9.txt;4;2;0;6;314;0.01;0.01;0.0
2632_7.txt;6;2;4;12;433;0.01;0.0;0.01
9773_7.txt;2;0;0;2;294;0.01;0.0;0.0
5429_10.txt;16;2;0;18;1078;0.01;0.0;0.0
2074_10.txt;4;2;0;6;133;0.03;0.02;0.0
5954_7.txt;0;4;1;5;250;0.0;0.02;0.0
12442_8.txt;6;0;2;8;167;0.04;0.0;0.01
1613_10.txt;23;0;1;24;705;0.03;0.0;0.0
6564_7.txt;19;0;0;19;161;0.12;0.0;0.0
8474_10.txt;0;0;0;0;116;0.0;0.0;0.0
2026_8.txt;26;1;1;28;559;0.05;0.0;0.0
6396_9.txt;7;2;0;9;141;0.05;0.01;0.0
951_10.txt;10;1;0;11;216;0.05;0.0;0.0
11348_10.txt;2;0;0;2;155;0.01;0.0;0.0
6057_9.txt;6;0;0;6;150;0.04;0.0;0.0
4682_9.txt;67;11;1;79;1168;0.06;0.01;0.0
9153_8.txt;0;0;0;0;201;0.0;0.0;0.0
10166_7.txt;0;0;0;0;179;0.0;0.0;0.0
7341_8.txt;15;0;0;15;302;0.05;0.0;0.0
6706_8.txt;6;0;0;6;108;0.06;0.0;0.0
4441_7.txt;10;2;1;13;496;0.02;0.0;0.0
7998_9.txt;4;2;2;8;325;0.01;0.01;0.01
5373_7.txt;1;0;1;2;308;0.0;0.0;0.0
10270_9.txt;0;0;0;0;44;0.0;0.0;0.0
10713_9.txt;1;3;0;4;207;0.0;0.01;0.0
11906_7.txt;12;0;0;12;240;0.05;0.0;0.0
9582_10.txt;0;6;3;9;195;0.0;0.03;0.02
5401_9.txt;26;4;2;32;540;0.05;0.01;0.0
4131_7.txt;3;0;0;3;51;0.06;0.0;0.0
9287_9.txt;3;2;0;5;258;0.01;0.01;0.0
10795_7.txt;9;0;2;11;148;0.06;0.0;0.01
1362_10.txt;8;0;0;8;205;0.04;0.0;0.0
7675_8.txt;8;1;0;9;206;0.04;0.0;0.0
5287_8.txt;9;4;0;13;200;0.04;0.02;0.0
8925_7.txt;1;0;0;1;333;0.0;0.0;0.0
4558_9.txt;5;0;0;5;150;0.03;0.0;0.0
4710_7.txt;6;0;0;6;202;0.03;0.0;0.0
601_7.txt;2;0;0;2;152;0.01;0.0;0.0
1285_9.txt;39;0;1;40;343;0.11;0.0;0.0
4618_10.txt;0;0;0;0;75;0.0;0.0;0.0
12201_8.txt;13;5;0;18;265;0.05;0.02;0.0
12089_10.txt;17;2;3;22;262;0.06;0.01;0.01
3395_9.txt;6;0;2;8;308;0.02;0.0;0.01
4832_8.txt;63;6;11;80;1040;0.06;0.01;0.01
8650_10.txt;1;0;0;1;84;0.01;0.0;0.0
9470_8.txt;4;0;0;4;159;0.03;0.0;0.0
4947_8.txt;10;0;0;10;147;0.07;0.0;0.0
10298_9.txt;6;0;0;6;186;0.03;0.0;0.0
1810_7.txt;21;0;5;26;320;0.07;0.0;0.02
10240_8.txt;20;4;0;24;250;0.08;0.02;0.0
3704_8.txt;0;1;0;1;117;0.0;0.01;0.0
8679_8.txt;5;0;0;5;214;0.02;0.0;0.0
4285_10.txt;8;1;0;9;346;0.02;0.0;0.0
638_10.txt;13;0;3;16;180;0.07;0.0;0.02
8835_9.txt;3;3;0;6;321;0.01;0.01;0.0
10147_10.txt;6;0;0;6;324;0.02;0.0;0.0
5500_10.txt;10;2;3;15;235;0.04;0.01;0.01
8574_9.txt;18;1;6;25;495;0.04;0.0;0.01
905_10.txt;41;3;1;45;1032;0.04;0.0;0.0
3090_10.txt;7;0;4;11;300;0.02;0.0;0.01
8612_7.txt;4;0;0;4;211;0.02;0.0;0.0
1564_10.txt;21;3;2;26;223;0.09;0.01;0.01
12357_7.txt;1;0;0;1;175;0.01;0.0;0.0
1620_10.txt;0;3;0;3;96;0.0;0.03;0.0
2545_8.txt;7;0;0;7;243;0.03;0.0;0.0
10895_7.txt;7;0;0;7;141;0.05;0.0;0.0
8319_10.txt;7;3;0;10;297;0.02;0.01;0.0
5072_8.txt;5;5;2;12;165;0.03;0.03;0.01
3144_10.txt;1;0;0;1;158;0.01;0.0;0.0
8400_7.txt;0;0;0;0;152;0.0;0.0;0.0
7722_10.txt;24;0;0;24;631;0.04;0.0;0.0
4276_10.txt;5;2;0;7;559;0.01;0.0;0.0
2980_7.txt;1;0;0;1;157;0.01;0.0;0.0
9495_8.txt;10;1;0;11;424;0.02;0.0;0.0
7698_10.txt;13;0;0;13;212;0.06;0.0;0.0
4515_10.txt;2;0;0;2;168;0.01;0.0;0.0
2437_10.txt;0;0;2;2;206;0.0;0.0;0.01
5235_8.txt;0;2;0;2;165;0.0;0.01;0.0
3533_10.txt;20;4;4;28;225;0.09;0.02;0.02
3175_8.txt;0;0;0;0;161;0.0;0.0;0.0
9036_10.txt;0;0;0;0;61;0.0;0.0;0.0
5416_9.txt;1;0;0;1;319;0.0;0.0;0.0
528_9.txt;13;9;5;27;554;0.02;0.02;0.01
6761_9.txt;5;1;0;6;126;0.04;0.01;0.0
3334_9.txt;5;0;0;5;153;0.03;0.0;0.0
9819_10.txt;2;1;0;3;155;0.01;0.01;0.0
2629_9.txt;0;0;0;0;143;0.0;0.0;0.0
2621_8.txt;3;3;1;7;129;0.02;0.02;0.01
10864_8.txt;2;5;0;7;454;0.0;0.01;0.0
9276_10.txt;0;4;3;7;187;0.0;0.02;0.02
1751_8.txt;10;0;0;10;325;0.03;0.0;0.0
3932_8.txt;12;4;3;19;308;0.04;0.01;0.01
7787_10.txt;9;2;0;11;168;0.05;0.01;0.0
8233_8.txt;1;0;0;1;163;0.01;0.0;0.0
11822_10.txt;11;0;3;14;255;0.04;0.0;0.01
8353_10.txt;0;0;1;1;216;0.0;0.0;0.0
1935_10.txt;2;0;0;2;156;0.01;0.0;0.0
304_10.txt;2;0;0;2;200;0.01;0.0;0.0
3506_10.txt;13;8;0;21;258;0.05;0.03;0.0
10104_10.txt;28;2;0;30;293;0.1;0.01;0.0
10175_10.txt;6;0;0;6;191;0.03;0.0;0.0
2290_10.txt;9;0;0;9;262;0.03;0.0;0.0
10266_9.txt;0;0;0;0;143;0.0;0.0;0.0
2607_9.txt;8;0;0;8;142;0.06;0.0;0.0
1042_10.txt;36;0;3;39;365;0.1;0.0;0.01
2658_10.txt;6;0;1;7;147;0.04;0.0;0.01
9164_10.txt;17;3;1;21;454;0.04;0.01;0.0
7287_7.txt;10;1;1;12;606;0.02;0.0;0.0
2973_9.txt;7;2;0;9;137;0.05;0.01;0.0
4320_8.txt;9;0;0;9;335;0.03;0.0;0.0
11829_10.txt;9;0;0;9;300;0.03;0.0;0.0
8038_7.txt;5;1;0;6;167;0.03;0.01;0.0
10062_10.txt;5;3;0;8;107;0.05;0.03;0.0
780_7.txt;2;0;2;4;49;0.04;0.0;0.04
6784_8.txt;35;6;1;42;474;0.07;0.01;0.0
10595_10.txt;12;20;10;42;1096;0.01;0.02;0.01
7209_8.txt;4;1;2;7;338;0.01;0.0;0.01
597_7.txt;48;38;2;88;1094;0.04;0.03;0.0
11957_8.txt;18;0;0;18;165;0.11;0.0;0.0
540_8.txt;3;0;0;3;182;0.02;0.0;0.0
1190_7.txt;33;0;9;42;737;0.04;0.0;0.01
6960_7.txt;0;0;0;0;170;0.0;0.0;0.0
9126_9.txt;5;0;0;5;87;0.06;0.0;0.0
10714_8.txt;5;8;2;15;615;0.01;0.01;0.0
7380_9.txt;3;0;0;3;76;0.04;0.0;0.0
7340_8.txt;2;0;1;3;263;0.01;0.0;0.0
11424_8.txt;10;7;0;17;498;0.02;0.01;0.0
11082_10.txt;0;1;1;2;101;0.0;0.01;0.01
3304_10.txt;15;0;0;15;262;0.06;0.0;0.0
4652_9.txt;0;1;0;1;137;0.0;0.01;0.0
305_8.txt;16;3;0;19;151;0.11;0.02;0.0
2108_10.txt;11;0;0;11;300;0.04;0.0;0.0
3226_10.txt;2;1;0;3;267;0.01;0.0;0.0
8955_8.txt;32;2;0;34;315;0.1;0.01;0.0
3206_8.txt;1;0;0;1;66;0.02;0.0;0.0
3115_8.txt;26;2;4;32;541;0.05;0.0;0.01
10582_10.txt;12;1;0;13;215;0.06;0.0;0.0
3465_9.txt;17;0;1;18;356;0.05;0.0;0.0
3522_8.txt;13;0;0;13;447;0.03;0.0;0.0
3781_7.txt;26;0;0;26;298;0.09;0.0;0.0
8864_10.txt;28;3;7;38;630;0.04;0.0;0.01
3164_10.txt;2;0;0;2;144;0.01;0.0;0.0
8231_10.txt;15;1;0;16;303;0.05;0.0;0.0
10415_7.txt;12;0;0;12;264;0.05;0.0;0.0
9649_9.txt;0;0;0;0;134;0.0;0.0;0.0
3991_7.txt;9;0;0;9;324;0.03;0.0;0.0
10516_7.txt;53;6;2;61;961;0.06;0.01;0.0
8365_8.txt;24;1;5;30;760;0.03;0.0;0.01
8506_8.txt;0;0;0;0;160;0.0;0.0;0.0
2725_8.txt;20;1;0;21;266;0.08;0.0;0.0
12449_8.txt;2;0;0;2;168;0.01;0.0;0.0
1119_10.txt;46;9;2;57;980;0.05;0.01;0.0
9279_7.txt;13;3;1;17;230;0.06;0.01;0.0
5655_7.txt;2;0;0;2;203;0.01;0.0;0.0
12459_10.txt;0;0;0;0;199;0.0;0.0;0.0
6281_8.txt;6;0;4;10;234;0.03;0.0;0.02
8568_7.txt;2;0;1;3;192;0.01;0.0;0.01
2983_7.txt;2;4;0;6;104;0.02;0.04;0.0
3811_9.txt;1;0;4;5;230;0.0;0.0;0.02
2594_9.txt;2;1;0;3;90;0.02;0.01;0.0
1774_10.txt;21;1;2;24;307;0.07;0.0;0.01
11893_10.txt;1;0;2;3;171;0.01;0.0;0.01
8298_7.txt;10;0;0;10;105;0.1;0.0;0.0
6330_10.txt;6;0;0;6;451;0.01;0.0;0.0
11907_7.txt;6;0;0;6;144;0.04;0.0;0.0
1960_7.txt;15;4;0;19;402;0.04;0.01;0.0
5228_8.txt;0;0;0;0;161;0.0;0.0;0.0
6826_9.txt;27;7;1;35;848;0.03;0.01;0.0
1966_10.txt;0;0;0;0;155;0.0;0.0;0.0
1051_9.txt;0;2;2;4;201;0.0;0.01;0.01
12470_10.txt;1;0;0;1;128;0.01;0.0;0.0
4841_7.txt;12;0;1;13;207;0.06;0.0;0.0
2970_10.txt;3;0;0;3;163;0.02;0.0;0.0
3800_7.txt;0;0;0;0;248;0.0;0.0;0.0
3478_8.txt;4;2;0;6;199;0.02;0.01;0.0
4016_10.txt;8;2;0;10;167;0.05;0.01;0.0
1479_8.txt;87;1;4;92;500;0.17;0.0;0.01
1940_10.txt;2;0;0;2;159;0.01;0.0;0.0
8908_10.txt;2;0;0;2;193;0.01;0.0;0.0
4508_7.txt;1;1;7;9;256;0.0;0.0;0.03
2030_9.txt;31;1;0;32;488;0.06;0.0;0.0
805_9.txt;7;0;4;11;282;0.02;0.0;0.01
7653_10.txt;3;0;0;3;59;0.05;0.0;0.0
11507_10.txt;11;4;0;15;220;0.05;0.02;0.0
2991_7.txt;0;2;0;2;59;0.0;0.03;0.0
5293_8.txt;4;5;0;9;152;0.03;0.03;0.0
2351_10.txt;1;0;0;1;209;0.0;0.0;0.0
278_9.txt;3;2;0;5;153;0.02;0.01;0.0
214_7.txt;21;0;0;21;280;0.07;0.0;0.0
5841_7.txt;3;0;0;3;147;0.02;0.0;0.0
11895_8.txt;7;0;0;7;140;0.05;0.0;0.0
4021_7.txt;2;2;0;4;168;0.01;0.01;0.0
6030_10.txt;25;4;6;35;1176;0.02;0.0;0.01
6473_8.txt;27;1;1;29;888;0.03;0.0;0.0
4931_8.txt;17;2;0;19;195;0.09;0.01;0.0
25_7.txt;4;0;1;5;198;0.02;0.0;0.01
7350_8.txt;0;0;0;0;316;0.0;0.0;0.0
10789_10.txt;0;0;0;0;146;0.0;0.0;0.0
4930_7.txt;8;0;0;8;256;0.03;0.0;0.0
9616_8.txt;20;0;0;20;335;0.06;0.0;0.0
10679_10.txt;19;0;0;19;288;0.07;0.0;0.0
8213_9.txt;3;0;0;3;215;0.01;0.0;0.0
7157_7.txt;0;0;0;0;154;0.0;0.0;0.0
4404_9.txt;10;6;2;18;598;0.02;0.01;0.0
10726_7.txt;9;1;1;11;193;0.05;0.01;0.01
10828_10.txt;0;0;0;0;37;0.0;0.0;0.0
10118_7.txt;1;5;0;6;158;0.01;0.03;0.0
1556_8.txt;0;0;0;0;150;0.0;0.0;0.0
5461_7.txt;21;2;2;25;391;0.05;0.01;0.01
10051_10.txt;0;0;0;0;181;0.0;0.0;0.0
4936_8.txt;23;4;4;31;723;0.03;0.01;0.01
9858_7.txt;0;0;1;1;232;0.0;0.0;0.0
2540_8.txt;15;3;2;20;338;0.04;0.01;0.01
1408_7.txt;15;0;1;16;284;0.05;0.0;0.0
310_7.txt;58;6;1;65;849;0.07;0.01;0.0
11777_9.txt;2;0;0;2;125;0.02;0.0;0.0
9562_8.txt;13;5;0;18;601;0.02;0.01;0.0
2701_9.txt;22;1;1;24;802;0.03;0.0;0.0
932_10.txt;5;0;0;5;304;0.02;0.0;0.0
1937_10.txt;0;2;5;7;447;0.0;0.0;0.01
4360_10.txt;4;1;0;5;153;0.03;0.01;0.0
11290_10.txt;41;9;8;58;944;0.04;0.01;0.01
74_8.txt;27;0;0;27;533;0.05;0.0;0.0
9140_10.txt;2;0;1;3;163;0.01;0.0;0.01
7134_10.txt;2;1;0;3;111;0.02;0.01;0.0
8145_10.txt;2;0;0;2;94;0.02;0.0;0.0
825_10.txt;7;0;3;10;482;0.01;0.0;0.01
10732_8.txt;0;0;1;1;157;0.0;0.0;0.01
9889_9.txt;11;7;1;19;349;0.03;0.02;0.0
565_10.txt;50;3;0;53;729;0.07;0.0;0.0
1040_10.txt;8;3;0;11;135;0.06;0.02;0.0
5880_10.txt;11;5;0;16;171;0.06;0.03;0.0
6134_7.txt;0;0;1;1;165;0.0;0.0;0.01
12402_7.txt;0;0;1;1;214;0.0;0.0;0.0
5517_9.txt;5;0;3;8;192;0.03;0.0;0.02
12023_9.txt;2;2;0;4;260;0.01;0.01;0.0
5442_8.txt;11;1;2;14;186;0.06;0.01;0.01
5821_7.txt;8;0;0;8;246;0.03;0.0;0.0
8800_10.txt;6;6;1;13;386;0.02;0.02;0.0
12249_8.txt;9;1;1;11;148;0.06;0.01;0.01
5156_9.txt;41;1;6;48;619;0.07;0.0;0.01
6941_9.txt;33;5;2;40;485;0.07;0.01;0.0
2885_9.txt;9;0;0;9;189;0.05;0.0;0.0
8453_10.txt;2;4;1;7;377;0.01;0.01;0.0
12017_7.txt;27;0;0;27;356;0.08;0.0;0.0
4541_10.txt;0;0;0;0;94;0.0;0.0;0.0
11602_8.txt;13;1;0;14;363;0.04;0.0;0.0
7914_10.txt;0;0;0;0;122;0.0;0.0;0.0
3418_10.txt;0;0;0;0;129;0.0;0.0;0.0
5206_7.txt;0;0;0;0;165;0.0;0.0;0.0
5501_10.txt;2;2;0;4;114;0.02;0.02;0.0
1182_8.txt;0;0;0;0;53;0.0;0.0;0.0
6290_7.txt;4;0;2;6;147;0.03;0.0;0.01
11879_10.txt;4;0;0;4;130;0.03;0.0;0.0
1235_10.txt;9;1;0;10;149;0.06;0.01;0.0
8379_10.txt;0;0;0;0;176;0.0;0.0;0.0
9248_9.txt;21;1;1;23;335;0.06;0.0;0.0
4465_7.txt;29;2;1;32;301;0.1;0.01;0.0
1033_10.txt;11;2;0;13;377;0.03;0.01;0.0
1158_9.txt;48;1;0;49;545;0.09;0.0;0.0
10587_8.txt;1;0;1;2;90;0.01;0.0;0.01
6300_8.txt;0;0;0;0;68;0.0;0.0;0.0
8847_9.txt;3;1;0;4;167;0.02;0.01;0.0
5447_10.txt;15;0;5;20;403;0.04;0.0;0.01
7814_10.txt;0;0;0;0;42;0.0;0.0;0.0
945_10.txt;20;6;0;26;616;0.03;0.01;0.0
3928_7.txt;6;0;1;7;295;0.02;0.0;0.0
9015_8.txt;21;1;0;22;269;0.08;0.0;0.0
10572_8.txt;11;0;5;16;363;0.03;0.0;0.01
3819_8.txt;2;1;0;3;137;0.01;0.01;0.0
9763_8.txt;9;0;0;9;169;0.05;0.0;0.0
8002_7.txt;1;5;3;9;144;0.01;0.03;0.02
11986_8.txt;14;1;0;15;233;0.06;0.0;0.0
5417_10.txt;0;0;0;0;44;0.0;0.0;0.0
10022_7.txt;3;1;0;4;117;0.03;0.01;0.0
5548_7.txt;11;0;0;11;168;0.07;0.0;0.0
5937_9.txt;15;0;1;16;347;0.04;0.0;0.0
11753_10.txt;1;4;0;5;151;0.01;0.03;0.0
1139_8.txt;17;0;0;17;263;0.06;0.0;0.0
9176_10.txt;7;0;2;9;288;0.02;0.0;0.01
9928_7.txt;18;2;0;20;638;0.03;0.0;0.0
4571_9.txt;9;0;0;9;122;0.07;0.0;0.0
4176_10.txt;0;1;0;1;52;0.0;0.02;0.0
2981_10.txt;13;13;5;31;348;0.04;0.04;0.01
5333_10.txt;2;0;0;2;265;0.01;0.0;0.0
7427_9.txt;2;0;0;2;234;0.01;0.0;0.0
11793_8.txt;9;0;10;19;429;0.02;0.0;0.02
1955_9.txt;5;0;0;5;146;0.03;0.0;0.0
11134_9.txt;70;8;3;81;953;0.07;0.01;0.0
1463_10.txt;2;10;0;12;235;0.01;0.04;0.0
2918_9.txt;9;0;2;11;171;0.05;0.0;0.01
8306_10.txt;5;0;0;5;124;0.04;0.0;0.0
9692_10.txt;0;0;0;0;74;0.0;0.0;0.0
7175_10.txt;0;0;0;0;53;0.0;0.0;0.0
11725_10.txt;4;0;0;4;180;0.02;0.0;0.0
5057_10.txt;0;0;0;0;85;0.0;0.0;0.0
8779_8.txt;34;1;0;35;450;0.08;0.0;0.0
6235_8.txt;16;0;1;17;283;0.06;0.0;0.0
12131_7.txt;30;0;5;35;265;0.11;0.0;0.02
4224_10.txt;16;0;0;16;149;0.11;0.0;0.0
1145_8.txt;48;3;0;51;438;0.11;0.01;0.0
7964_10.txt;2;0;0;2;106;0.02;0.0;0.0
6277_7.txt;0;0;0;0;71;0.0;0.0;0.0
5196_9.txt;7;0;0;7;151;0.05;0.0;0.0
4661_10.txt;9;0;0;9;369;0.02;0.0;0.0
3040_8.txt;16;6;5;27;449;0.04;0.01;0.01
2329_10.txt;9;0;0;9;171;0.05;0.0;0.0
10529_10.txt;11;2;0;13;131;0.08;0.02;0.0
5003_10.txt;0;0;0;0;159;0.0;0.0;0.0
1041_9.txt;66;21;9;96;713;0.09;0.03;0.01
832_8.txt;14;0;0;14;222;0.06;0.0;0.0
6651_10.txt;13;2;0;15;246;0.05;0.01;0.0
5556_10.txt;7;0;0;7;61;0.11;0.0;0.0
6211_8.txt;3;4;1;8;199;0.02;0.02;0.01
6344_7.txt;8;0;0;8;120;0.07;0.0;0.0
4198_7.txt;21;0;1;22;269;0.08;0.0;0.0
11121_10.txt;6;0;3;9;205;0.03;0.0;0.01
900_10.txt;10;0;0;10;144;0.07;0.0;0.0
12011_10.txt;5;0;0;5;214;0.02;0.0;0.0
3832_8.txt;11;1;1;13;184;0.06;0.01;0.01
6742_8.txt;18;0;0;18;173;0.1;0.0;0.0
8826_9.txt;0;0;0;0;194;0.0;0.0;0.0
2952_8.txt;9;3;0;12;148;0.06;0.02;0.0
4243_8.txt;13;1;0;14;401;0.03;0.0;0.0
6646_10.txt;12;6;0;18;308;0.04;0.02;0.0
8004_9.txt;29;27;2;58;1101;0.03;0.02;0.0
1712_9.txt;4;0;2;6;136;0.03;0.0;0.01
10817_10.txt;2;0;0;2;93;0.02;0.0;0.0
6602_7.txt;13;11;0;24;475;0.03;0.02;0.0
9556_10.txt;2;0;0;2;192;0.01;0.0;0.0
6813_10.txt;24;0;0;24;699;0.03;0.0;0.0
3072_8.txt;16;0;0;16;130;0.12;0.0;0.0
8014_7.txt;0;4;0;4;74;0.0;0.05;0.0
6903_9.txt;5;0;0;5;82;0.06;0.0;0.0
8687_9.txt;12;1;1;14;254;0.05;0.0;0.0
11714_10.txt;8;2;5;15;343;0.02;0.01;0.01
4925_7.txt;8;4;1;13;349;0.02;0.01;0.0
6765_9.txt;42;4;4;50;852;0.05;0.0;0.0
11711_10.txt;6;0;2;8;240;0.03;0.0;0.01
7661_10.txt;6;0;0;6;176;0.03;0.0;0.0
4240_9.txt;6;0;0;6;55;0.11;0.0;0.0
9111_10.txt;4;2;0;6;124;0.03;0.02;0.0
11679_7.txt;0;0;0;0;102;0.0;0.0;0.0
3685_8.txt;4;1;0;5;146;0.03;0.01;0.0
10548_7.txt;27;1;0;28;899;0.03;0.0;0.0
6780_10.txt;4;2;0;6;245;0.02;0.01;0.0
11700_10.txt;0;0;0;0;163;0.0;0.0;0.0
1189_9.txt;26;2;3;31;401;0.06;0.0;0.01
8670_8.txt;58;10;8;76;1060;0.05;0.01;0.01
5591_8.txt;2;2;0;4;154;0.01;0.01;0.0
1435_8.txt;2;0;2;4;132;0.02;0.0;0.02
11891_9.txt;1;0;0;1;152;0.01;0.0;0.0
9463_10.txt;15;0;0;15;469;0.03;0.0;0.0
3887_10.txt;2;3;0;5;91;0.02;0.03;0.0
2065_7.txt;9;10;0;19;251;0.04;0.04;0.0
9855_7.txt;0;0;3;3;138;0.0;0.0;0.02
3927_9.txt;14;2;3;19;194;0.07;0.01;0.02
5407_7.txt;2;0;0;2;247;0.01;0.0;0.0
9670_9.txt;2;5;0;7;186;0.01;0.03;0.0
11002_8.txt;22;1;8;31;478;0.05;0.0;0.02
3236_7.txt;0;2;0;2;152;0.0;0.01;0.0
714_10.txt;0;0;5;5;101;0.0;0.0;0.05
6386_10.txt;10;1;9;20;1050;0.01;0.0;0.01
9647_10.txt;0;0;0;0;118;0.0;0.0;0.0
8109_10.txt;14;1;0;15;148;0.09;0.01;0.0
10038_10.txt;4;0;0;4;601;0.01;0.0;0.0
954_10.txt;56;0;4;60;633;0.09;0.0;0.01
5758_10.txt;11;1;0;12;160;0.07;0.01;0.0
695_10.txt;2;0;0;2;168;0.01;0.0;0.0
8735_8.txt;17;8;5;30;1127;0.02;0.01;0.0
5313_7.txt;3;0;0;3;169;0.02;0.0;0.0
10699_9.txt;6;0;0;6;410;0.01;0.0;0.0
2928_10.txt;5;0;0;5;146;0.03;0.0;0.0
1197_10.txt;0;0;0;0;150;0.0;0.0;0.0
10600_9.txt;4;6;0;10;192;0.02;0.03;0.0
7025_8.txt;14;0;2;16;193;0.07;0.0;0.01
9388_8.txt;17;6;1;24;257;0.07;0.02;0.0
4597_8.txt;8;0;4;12;308;0.03;0.0;0.01
4253_10.txt;0;0;0;0;172;0.0;0.0;0.0
6886_8.txt;11;0;0;11;260;0.04;0.0;0.0
1434_10.txt;1;0;0;1;28;0.04;0.0;0.0
3852_8.txt;28;1;0;29;771;0.04;0.0;0.0
10383_10.txt;3;3;0;6;182;0.02;0.02;0.0
3988_7.txt;0;2;0;2;46;0.0;0.04;0.0
11385_8.txt;8;0;0;8;324;0.02;0.0;0.0
9842_7.txt;12;1;0;13;472;0.03;0.0;0.0
10950_9.txt;9;0;7;16;395;0.02;0.0;0.02
11697_10.txt;0;0;0;0;79;0.0;0.0;0.0
4941_10.txt;0;2;0;2;155;0.0;0.01;0.0
661_9.txt;19;0;4;23;221;0.09;0.0;0.02
711_10.txt;33;2;8;43;277;0.12;0.01;0.03
6471_10.txt;4;0;1;5;98;0.04;0.0;0.01
11954_9.txt;10;1;0;11;210;0.05;0.0;0.0
4280_10.txt;0;1;0;1;123;0.0;0.01;0.0
6369_10.txt;0;0;2;2;99;0.0;0.0;0.02
11091_8.txt;47;2;2;51;868;0.05;0.0;0.0
7110_8.txt;5;2;0;7;190;0.03;0.01;0.0
631_10.txt;2;0;0;2;112;0.02;0.0;0.0
2121_10.txt;12;0;0;12;155;0.08;0.0;0.0
3286_10.txt;2;1;0;3;101;0.02;0.01;0.0
12099_9.txt;23;4;0;27;538;0.04;0.01;0.0
10570_8.txt;42;7;4;53;931;0.05;0.01;0.0
12193_10.txt;0;3;0;3;53;0.0;0.06;0.0
9734_7.txt;21;1;1;23;309;0.07;0.0;0.0
502_10.txt;2;1;3;6;232;0.01;0.0;0.01
8840_10.txt;7;1;0;8;227;0.03;0.0;0.0
1646_9.txt;0;0;0;0;57;0.0;0.0;0.0
5828_9.txt;0;0;0;0;152;0.0;0.0;0.0
5298_8.txt;4;0;0;4;79;0.05;0.0;0.0
12091_8.txt;31;1;0;32;338;0.09;0.0;0.0
6123_7.txt;6;0;1;7;267;0.02;0.0;0.0
8228_8.txt;14;1;3;18;177;0.08;0.01;0.02
2747_9.txt;37;8;0;45;538;0.07;0.01;0.0
3443_9.txt;8;0;0;8;312;0.03;0.0;0.0
3423_7.txt;0;1;0;1;181;0.0;0.01;0.0
11464_10.txt;3;1;0;4;188;0.02;0.01;0.0
11724_8.txt;8;1;0;9;194;0.04;0.01;0.0
7301_7.txt;11;0;0;11;321;0.03;0.0;0.0
4071_10.txt;0;0;0;0;159;0.0;0.0;0.0
2010_8.txt;9;0;0;9;99;0.09;0.0;0.0
11260_7.txt;0;0;0;0;70;0.0;0.0;0.0
19_10.txt;5;1;0;6;215;0.02;0.0;0.0
8072_10.txt;2;0;3;5;82;0.02;0.0;0.04
11722_8.txt;3;0;0;3;142;0.02;0.0;0.0
3796_8.txt;5;0;0;5;155;0.03;0.0;0.0
776_7.txt;0;0;0;0;191;0.0;0.0;0.0
3637_10.txt;6;0;0;6;177;0.03;0.0;0.0
7719_9.txt;6;1;2;9;380;0.02;0.0;0.01
7896_10.txt;2;0;0;2;72;0.03;0.0;0.0
9618_8.txt;8;0;0;8;171;0.05;0.0;0.0
11349_10.txt;0;1;0;1;99;0.0;0.01;0.0
8846_9.txt;3;0;0;3;154;0.02;0.0;0.0
9400_8.txt;24;8;4;36;318;0.08;0.03;0.01
9099_10.txt;1;1;0;2;47;0.02;0.02;0.0
7151_10.txt;0;0;0;0;218;0.0;0.0;0.0
10876_7.txt;2;2;0;4;196;0.01;0.01;0.0
5896_10.txt;8;0;0;8;133;0.06;0.0;0.0
6149_7.txt;8;0;1;9;242;0.03;0.0;0.0
11955_7.txt;12;0;0;12;251;0.05;0.0;0.0
3229_7.txt;34;0;1;35;587;0.06;0.0;0.0
4467_7.txt;17;2;0;19;142;0.12;0.01;0.0
6498_10.txt;1;0;0;1;60;0.02;0.0;0.0
1932_10.txt;4;0;0;4;196;0.02;0.0;0.0
1811_10.txt;78;3;9;90;705;0.11;0.0;0.01
5995_10.txt;3;1;0;4;410;0.01;0.0;0.0
9774_8.txt;0;0;0;0;113;0.0;0.0;0.0
9468_7.txt;14;0;0;14;226;0.06;0.0;0.0
10522_7.txt;8;0;0;8;212;0.04;0.0;0.0
4078_10.txt;2;1;0;3;214;0.01;0.0;0.0
2806_10.txt;4;0;0;4;265;0.02;0.0;0.0
7707_9.txt;20;2;0;22;406;0.05;0.0;0.0
10574_10.txt;4;0;2;6;81;0.05;0.0;0.02
1798_9.txt;18;1;0;19;232;0.08;0.0;0.0
3548_8.txt;24;1;0;25;189;0.13;0.01;0.0
3331_8.txt;50;4;5;59;800;0.06;0.01;0.01
218_9.txt;28;2;13;43;363;0.08;0.01;0.04
8960_10.txt;5;0;0;5;160;0.03;0.0;0.0
4687_8.txt;9;0;0;9;263;0.03;0.0;0.0
7169_8.txt;1;0;0;1;177;0.01;0.0;0.0
4870_10.txt;1;0;0;1;87;0.01;0.0;0.0
3668_7.txt;16;0;0;16;150;0.11;0.0;0.0
11019_10.txt;2;0;0;2;71;0.03;0.0;0.0
10833_10.txt;0;0;0;0;204;0.0;0.0;0.0
5299_8.txt;4;0;0;4;106;0.04;0.0;0.0
4548_7.txt;8;1;1;10;220;0.04;0.0;0.0
2947_10.txt;2;0;0;2;175;0.01;0.0;0.0
4472_10.txt;11;0;0;11;102;0.11;0.0;0.0
3820_8.txt;1;6;0;7;255;0.0;0.02;0.0
3059_8.txt;35;0;4;39;520;0.07;0.0;0.01
8485_8.txt;5;0;0;5;67;0.07;0.0;0.0
3061_10.txt;9;0;6;15;296;0.03;0.0;0.02
11272_10.txt;36;2;0;38;852;0.04;0.0;0.0
1722_7.txt;44;0;6;50;1080;0.04;0.0;0.01
8209_8.txt;33;4;0;37;864;0.04;0.0;0.0
507_10.txt;60;0;7;67;1100;0.05;0.0;0.01
11003_10.txt;4;2;6;12;426;0.01;0.0;0.01
8317_8.txt;29;6;3;38;552;0.05;0.01;0.01
10737_10.txt;0;0;0;0;92;0.0;0.0;0.0
7442_7.txt;6;0;0;6;185;0.03;0.0;0.0
2703_9.txt;4;0;0;4;167;0.02;0.0;0.0
7645_7.txt;11;1;0;12;158;0.07;0.01;0.0
7125_10.txt;13;0;0;13;161;0.08;0.0;0.0
5077_9.txt;2;0;0;2;142;0.01;0.0;0.0
7153_8.txt;2;0;0;2;275;0.01;0.0;0.0
12398_8.txt;0;0;0;0;154;0.0;0.0;0.0
2570_10.txt;9;1;0;10;156;0.06;0.01;0.0
3986_10.txt;0;0;0;0;145;0.0;0.0;0.0
9321_8.txt;4;0;0;4;118;0.03;0.0;0.0
11681_9.txt;6;0;0;6;129;0.05;0.0;0.0
7515_8.txt;24;1;0;25;466;0.05;0.0;0.0
1053_8.txt;0;3;0;3;222;0.0;0.01;0.0
3306_8.txt;13;4;0;17;450;0.03;0.01;0.0
10807_9.txt;3;0;0;3;191;0.02;0.0;0.0
2599_10.txt;7;2;3;12;260;0.03;0.01;0.01
5619_9.txt;6;0;0;6;389;0.02;0.0;0.0
6503_10.txt;4;5;3;12;419;0.01;0.01;0.01
7765_7.txt;28;2;3;33;161;0.17;0.01;0.02
5914_8.txt;10;1;3;14;315;0.03;0.0;0.01
9396_9.txt;16;0;1;17;276;0.06;0.0;0.0
2146_9.txt;11;9;0;20;523;0.02;0.02;0.0
2381_9.txt;12;1;0;13;185;0.06;0.01;0.0
5032_10.txt;17;0;1;18;813;0.02;0.0;0.0
8444_10.txt;2;1;5;8;545;0.0;0.0;0.01
6184_7.txt;20;3;3;26;269;0.07;0.01;0.01
28_10.txt;12;1;6;19;397;0.03;0.0;0.02
944_10.txt;42;1;1;44;955;0.04;0.0;0.0
11626_9.txt;14;0;0;14;236;0.06;0.0;0.0
8696_10.txt;4;0;0;4;145;0.03;0.0;0.0
12225_7.txt;6;0;0;6;162;0.04;0.0;0.0
10180_7.txt;7;1;0;8;303;0.02;0.0;0.0
7921_10.txt;2;0;3;5;163;0.01;0.0;0.02
1354_9.txt;19;13;3;35;837;0.02;0.02;0.0
8629_9.txt;9;2;1;12;576;0.02;0.0;0.0
9745_7.txt;7;0;0;7;150;0.05;0.0;0.0
9249_9.txt;10;0;0;10;239;0.04;0.0;0.0
2692_8.txt;5;3;0;8;305;0.02;0.01;0.0
12248_7.txt;39;7;2;48;583;0.07;0.01;0.0
3579_8.txt;15;2;2;19;564;0.03;0.0;0.0
4808_8.txt;26;4;4;34;298;0.09;0.01;0.01
10528_10.txt;18;0;0;18;360;0.05;0.0;0.0
5855_9.txt;0;0;3;3;156;0.0;0.0;0.02
10917_8.txt;2;0;0;2;194;0.01;0.0;0.0
9893_7.txt;12;0;0;12;252;0.05;0.0;0.0
11909_7.txt;11;1;0;12;217;0.05;0.0;0.0
5652_10.txt;0;2;3;5;138;0.0;0.01;0.02
12416_10.txt;6;1;0;7;61;0.1;0.02;0.0
7180_9.txt;5;4;0;9;313;0.02;0.01;0.0
11987_7.txt;5;1;2;8;327;0.02;0.0;0.01
5295_8.txt;8;0;2;10;112;0.07;0.0;0.02
6853_10.txt;18;0;0;18;151;0.12;0.0;0.0
7168_10.txt;4;0;0;4;497;0.01;0.0;0.0
614_10.txt;47;5;4;56;958;0.05;0.01;0.0
9052_8.txt;6;2;0;8;237;0.03;0.01;0.0
1803_10.txt;15;2;7;24;640;0.02;0.0;0.01
2334_9.txt;3;0;0;3;135;0.02;0.0;0.0
326_10.txt;7;1;0;8;337;0.02;0.0;0.0
9636_7.txt;15;0;0;15;367;0.04;0.0;0.0
460_9.txt;17;1;0;18;265;0.06;0.0;0.0
12169_7.txt;19;1;0;20;300;0.06;0.0;0.0
8902_7.txt;4;2;0;6;145;0.03;0.01;0.0
7421_7.txt;29;4;2;35;438;0.07;0.01;0.0
8194_9.txt;3;0;0;3;196;0.02;0.0;0.0
9573_8.txt;9;2;0;11;461;0.02;0.0;0.0
6250_10.txt;5;9;0;14;468;0.01;0.02;0.0
8479_9.txt;2;1;4;7;228;0.01;0.0;0.02
6500_10.txt;2;0;0;2;46;0.04;0.0;0.0
4801_7.txt;4;0;0;4;149;0.03;0.0;0.0
1168_8.txt;20;1;2;23;372;0.05;0.0;0.01
2183_8.txt;11;1;0;12;123;0.09;0.01;0.0
10444_9.txt;8;4;1;13;301;0.03;0.01;0.0
1654_7.txt;9;2;2;13;272;0.03;0.01;0.01
10083_7.txt;6;0;0;6;226;0.03;0.0;0.0
10295_7.txt;0;0;0;0;73;0.0;0.0;0.0
5264_7.txt;4;2;0;6;280;0.01;0.01;0.0
10567_9.txt;5;0;0;5;103;0.05;0.0;0.0
3211_7.txt;1;0;0;1;120;0.01;0.0;0.0
5321_10.txt;7;0;1;8;200;0.04;0.0;0.01
1427_9.txt;6;12;0;18;812;0.01;0.01;0.0
4741_7.txt;11;6;0;17;617;0.02;0.01;0.0
3287_9.txt;11;0;0;11;760;0.01;0.0;0.0
9275_9.txt;12;2;0;14;935;0.01;0.0;0.0
3029_8.txt;3;0;0;3;127;0.02;0.0;0.0
9605_10.txt;2;0;0;2;216;0.01;0.0;0.0
10269_7.txt;0;0;0;0;92;0.0;0.0;0.0
12235_7.txt;11;0;0;11;277;0.04;0.0;0.0
2509_9.txt;1;0;1;2;137;0.01;0.0;0.01
9669_9.txt;7;2;0;9;99;0.07;0.02;0.0
1948_10.txt;5;0;0;5;157;0.03;0.0;0.0
32_10.txt;16;0;1;17;479;0.03;0.0;0.0
9006_7.txt;8;0;0;8;53;0.15;0.0;0.0
12359_8.txt;3;0;0;3;142;0.02;0.0;0.0
10907_9.txt;4;0;1;5;192;0.02;0.0;0.01
8888_7.txt;0;0;0;0;99;0.0;0.0;0.0
10630_8.txt;0;0;0;0;144;0.0;0.0;0.0
9441_9.txt;10;0;0;10;136;0.07;0.0;0.0
1382_8.txt;2;0;0;2;119;0.02;0.0;0.0
10235_8.txt;4;1;2;7;211;0.02;0.0;0.01
289_10.txt;16;0;3;19;167;0.1;0.0;0.02
11949_8.txt;21;3;0;24;289;0.07;0.01;0.0
2819_10.txt;4;0;0;4;279;0.01;0.0;0.0
10880_8.txt;0;0;0;0;134;0.0;0.0;0.0
1627_10.txt;6;1;1;8;164;0.04;0.01;0.01
11427_10.txt;0;1;0;1;114;0.0;0.01;0.0
3645_8.txt;11;0;8;19;266;0.04;0.0;0.03
10113_10.txt;20;0;0;20;575;0.03;0.0;0.0
9712_10.txt;4;0;0;4;140;0.03;0.0;0.0
1273_7.txt;4;0;0;4;157;0.03;0.0;0.0
4097_8.txt;0;0;0;0;96;0.0;0.0;0.0
7579_8.txt;12;0;3;15;585;0.02;0.0;0.01
4620_10.txt;3;0;0;3;173;0.02;0.0;0.0
9589_10.txt;3;7;0;10;278;0.01;0.03;0.0
9917_10.txt;2;1;0;3;154;0.01;0.01;0.0
11650_9.txt;1;0;0;1;101;0.01;0.0;0.0
8332_9.txt;4;0;2;6;167;0.02;0.0;0.01
11858_9.txt;4;0;0;4;237;0.02;0.0;0.0
8128_10.txt;0;0;2;2;149;0.0;0.0;0.01
165_7.txt;0;0;0;0;31;0.0;0.0;0.0
8131_8.txt;0;0;0;0;177;0.0;0.0;0.0
10186_8.txt;5;2;0;7;160;0.03;0.01;0.0
1011_10.txt;6;0;0;6;195;0.03;0.0;0.0
2659_8.txt;31;1;10;42;723;0.04;0.0;0.01
4639_10.txt;7;0;0;7;206;0.03;0.0;0.0
4469_9.txt;5;1;0;6;405;0.01;0.0;0.0
5167_7.txt;12;0;0;12;281;0.04;0.0;0.0
11085_10.txt;0;0;1;1;55;0.0;0.0;0.02
2160_8.txt;0;0;0;0;251;0.0;0.0;0.0
4753_10.txt;0;0;0;0;156;0.0;0.0;0.0
2785_7.txt;4;0;0;4;155;0.03;0.0;0.0
9969_10.txt;1;6;0;7;244;0.0;0.02;0.0
6673_7.txt;0;0;0;0;118;0.0;0.0;0.0
906_10.txt;12;0;1;13;394;0.03;0.0;0.0
9744_7.txt;8;0;1;9;254;0.03;0.0;0.0
7117_10.txt;6;0;2;8;234;0.03;0.0;0.01
8494_8.txt;8;3;0;11;448;0.02;0.01;0.0
11304_7.txt;15;0;0;15;208;0.07;0.0;0.0
12468_7.txt;2;0;0;2;216;0.01;0.0;0.0
2363_7.txt;2;0;7;9;256;0.01;0.0;0.03
6913_9.txt;11;1;0;12;257;0.04;0.0;0.0
3847_9.txt;9;0;0;9;342;0.03;0.0;0.0
8920_10.txt;5;0;0;5;316;0.02;0.0;0.0
11690_9.txt;2;0;0;2;85;0.02;0.0;0.0
11333_9.txt;2;0;0;2;142;0.01;0.0;0.0
3196_10.txt;14;0;0;14;253;0.06;0.0;0.0
11362_9.txt;8;0;2;10;83;0.1;0.0;0.02
9919_9.txt;0;0;0;0;122;0.0;0.0;0.0
6576_8.txt;13;0;0;13;546;0.02;0.0;0.0
1968_8.txt;10;2;1;13;558;0.02;0.0;0.0
1365_8.txt;2;0;0;2;176;0.01;0.0;0.0
1747_10.txt;4;0;0;4;233;0.02;0.0;0.0
3626_7.txt;6;0;4;10;187;0.03;0.0;0.02
4762_10.txt;7;0;1;8;135;0.05;0.0;0.01
548_7.txt;15;2;0;17;159;0.09;0.01;0.0
5657_9.txt;2;0;1;3;148;0.01;0.0;0.01
641_8.txt;3;0;0;3;138;0.02;0.0;0.0
9807_10.txt;0;1;0;1;118;0.0;0.01;0.0
7344_10.txt;3;0;0;3;231;0.01;0.0;0.0
9220_8.txt;0;2;2;4;169;0.0;0.01;0.01
6026_8.txt;8;1;0;9;249;0.03;0.0;0.0
3369_7.txt;2;0;0;2;158;0.01;0.0;0.0
12228_8.txt;23;1;0;24;522;0.04;0.0;0.0
4347_8.txt;5;0;5;10;199;0.03;0.0;0.03
2349_9.txt;1;0;0;1;128;0.01;0.0;0.0
5873_8.txt;15;1;2;18;342;0.04;0.0;0.01
4088_7.txt;0;0;0;0;148;0.0;0.0;0.0
6685_10.txt;48;2;3;53;694;0.07;0.0;0.0
8092_8.txt;4;0;2;6;267;0.01;0.0;0.01
3584_10.txt;2;0;0;2;183;0.01;0.0;0.0
6067_10.txt;2;0;0;2;228;0.01;0.0;0.0
3649_9.txt;11;1;0;12;148;0.07;0.01;0.0
5628_7.txt;2;0;0;2;258;0.01;0.0;0.0
5440_10.txt;22;2;10;34;458;0.05;0.0;0.02
2613_9.txt;2;0;0;2;146;0.01;0.0;0.0
8260_9.txt;4;3;0;7;228;0.02;0.01;0.0
1851_10.txt;6;1;9;16;80;0.07;0.01;0.11
10321_10.txt;16;0;1;17;142;0.11;0.0;0.01
2966_10.txt;0;0;0;0;77;0.0;0.0;0.0
6288_7.txt;57;5;6;68;773;0.07;0.01;0.01
8069_8.txt;21;3;10;34;429;0.05;0.01;0.02
7276_8.txt;6;0;0;6;55;0.11;0.0;0.0
3664_10.txt;17;4;1;22;555;0.03;0.01;0.0
636_10.txt;8;0;0;8;134;0.06;0.0;0.0
7253_10.txt;5;0;1;6;252;0.02;0.0;0.0
9621_8.txt;21;1;1;23;460;0.05;0.0;0.0
7799_8.txt;9;1;0;10;426;0.02;0.0;0.0
6561_10.txt;2;0;1;3;157;0.01;0.0;0.01
10368_7.txt;5;0;0;5;170;0.03;0.0;0.0
7014_10.txt;2;1;0;3;224;0.01;0.0;0.0
6961_7.txt;5;0;0;5;144;0.03;0.0;0.0
9163_10.txt;21;4;1;26;347;0.06;0.01;0.0
2958_10.txt;0;2;0;2;116;0.0;0.02;0.0
9946_9.txt;0;0;0;0;88;0.0;0.0;0.0
7_7.txt;8;0;3;11;136;0.06;0.0;0.02
6041_10.txt;0;1;3;4;148;0.0;0.01;0.02
4219_7.txt;52;4;0;56;589;0.09;0.01;0.0
375_9.txt;0;0;0;0;75;0.0;0.0;0.0
11244_10.txt;3;1;0;4;142;0.02;0.01;0.0
7032_10.txt;31;0;0;31;299;0.1;0.0;0.0
322_10.txt;1;0;0;1;130;0.01;0.0;0.0
7605_8.txt;0;0;0;0;202;0.0;0.0;0.0
5490_9.txt;2;3;0;5;259;0.01;0.01;0.0
9840_10.txt;1;1;0;2;325;0.0;0.0;0.0
5022_8.txt;5;0;0;5;135;0.04;0.0;0.0
3484_10.txt;2;5;0;7;218;0.01;0.02;0.0
10982_10.txt;13;8;0;21;431;0.03;0.02;0.0
2671_7.txt;38;8;2;48;456;0.08;0.02;0.0
11579_10.txt;3;0;0;3;134;0.02;0.0;0.0
11227_9.txt;2;0;14;16;291;0.01;0.0;0.05
6515_7.txt;0;0;0;0;155;0.0;0.0;0.0
12286_7.txt;11;0;0;11;288;0.04;0.0;0.0
11402_10.txt;17;7;0;24;257;0.07;0.03;0.0
6900_8.txt;16;0;0;16;245;0.07;0.0;0.0
1807_7.txt;1;0;0;1;167;0.01;0.0;0.0
1570_8.txt;7;0;2;9;244;0.03;0.0;0.01
4875_7.txt;6;1;0;7;132;0.05;0.01;0.0
5357_8.txt;7;0;0;7;130;0.05;0.0;0.0
6009_10.txt;19;2;0;21;349;0.05;0.01;0.0
4657_10.txt;10;1;0;11;170;0.06;0.01;0.0
8363_8.txt;10;1;0;11;208;0.05;0.0;0.0
1102_8.txt;18;3;0;21;287;0.06;0.01;0.0
5899_7.txt;16;7;2;25;287;0.06;0.02;0.01
5644_8.txt;35;5;2;42;324;0.11;0.02;0.01
3790_10.txt;0;0;0;0;147;0.0;0.0;0.0
1551_8.txt;3;0;0;3;283;0.01;0.0;0.0
8085_7.txt;0;0;0;0;269;0.0;0.0;0.0
10277_9.txt;2;0;0;2;125;0.02;0.0;0.0
8097_7.txt;16;4;5;25;980;0.02;0.0;0.01
4876_10.txt;4;6;0;10;224;0.02;0.03;0.0
1672_8.txt;11;0;0;11;207;0.05;0.0;0.0
1673_8.txt;3;4;0;7;119;0.03;0.03;0.0
4147_8.txt;0;1;0;1;167;0.0;0.01;0.0
9672_7.txt;7;0;0;7;161;0.04;0.0;0.0
2080_9.txt;10;0;0;10;282;0.04;0.0;0.0
7342_7.txt;18;0;1;19;665;0.03;0.0;0.0
9667_9.txt;6;3;0;9;62;0.1;0.05;0.0
2855_8.txt;0;1;0;1;242;0.0;0.0;0.0
4899_10.txt;0;0;0;0;134;0.0;0.0;0.0
6291_10.txt;35;0;4;39;604;0.06;0.0;0.01
8156_10.txt;0;0;1;1;55;0.0;0.0;0.02
12351_8.txt;28;4;0;32;484;0.06;0.01;0.0
3197_10.txt;16;0;0;16;328;0.05;0.0;0.0
11212_8.txt;13;0;0;13;172;0.08;0.0;0.0
7759_10.txt;11;3;0;14;122;0.09;0.02;0.0
2547_10.txt;15;2;0;17;237;0.06;0.01;0.0
8782_9.txt;26;2;0;28;421;0.06;0.0;0.0
5981_7.txt;17;4;6;27;429;0.04;0.01;0.01
10706_7.txt;11;0;0;11;138;0.08;0.0;0.0
8147_10.txt;3;0;0;3;64;0.05;0.0;0.0
6908_7.txt;33;3;3;39;302;0.11;0.01;0.01
4490_7.txt;3;0;0;3;53;0.06;0.0;0.0
1097_9.txt;26;3;2;31;207;0.13;0.01;0.01
10710_9.txt;0;1;0;1;239;0.0;0.0;0.0
1390_9.txt;2;0;2;4;98;0.02;0.0;0.02
3808_10.txt;0;0;0;0;138;0.0;0.0;0.0
2387_10.txt;0;0;0;0;226;0.0;0.0;0.0
9918_10.txt;2;1;3;6;525;0.0;0.0;0.01
7112_9.txt;4;3;0;7;136;0.03;0.02;0.0
11026_7.txt;16;0;2;18;709;0.02;0.0;0.0
2221_8.txt;6;0;0;6;145;0.04;0.0;0.0
7651_8.txt;5;0;0;5;207;0.02;0.0;0.0
10861_7.txt;2;5;0;7;748;0.0;0.01;0.0
8000_10.txt;0;1;1;2;161;0.0;0.01;0.01
8998_10.txt;0;0;0;0;49;0.0;0.0;0.0
5687_7.txt;18;1;3;22;603;0.03;0.0;0.0
2742_9.txt;12;0;0;12;136;0.09;0.0;0.0
4002_8.txt;25;1;0;26;482;0.05;0.0;0.0
10955_7.txt;5;0;0;5;366;0.01;0.0;0.0
5823_10.txt;15;0;0;15;204;0.07;0.0;0.0
5800_10.txt;2;0;0;2;132;0.02;0.0;0.0
11962_7.txt;20;0;0;20;481;0.04;0.0;0.0
4696_10.txt;9;0;0;9;155;0.06;0.0;0.0
2129_8.txt;6;3;0;9;109;0.06;0.03;0.0
9574_9.txt;3;0;0;3;137;0.02;0.0;0.0
5495_8.txt;18;9;8;35;591;0.03;0.02;0.01
6251_7.txt;0;0;0;0;123;0.0;0.0;0.0
11741_10.txt;1;2;0;3;165;0.01;0.01;0.0
3292_10.txt;6;0;0;6;392;0.02;0.0;0.0
7552_10.txt;3;1;0;4;181;0.02;0.01;0.0
6086_8.txt;2;1;2;5;188;0.01;0.01;0.01
5829_10.txt;8;0;2;10;212;0.04;0.0;0.01
11494_7.txt;8;2;2;12;231;0.03;0.01;0.01
6513_9.txt;0;0;2;2;191;0.0;0.0;0.01
8675_8.txt;7;0;0;7;232;0.03;0.0;0.0
6674_9.txt;2;0;1;3;182;0.01;0.0;0.01
9030_10.txt;3;0;0;3;134;0.02;0.0;0.0
4527_9.txt;11;4;0;15;279;0.04;0.01;0.0
9603_10.txt;4;0;0;4;157;0.03;0.0;0.0
2502_8.txt;11;2;0;13;381;0.03;0.01;0.0
5392_10.txt;24;0;6;30;320;0.07;0.0;0.02
8550_8.txt;25;0;2;27;402;0.06;0.0;0.0
6823_10.txt;4;0;0;4;225;0.02;0.0;0.0
6568_9.txt;6;0;0;6;176;0.03;0.0;0.0
7099_10.txt;23;1;0;24;552;0.04;0.0;0.0
791_9.txt;4;0;2;6;227;0.02;0.0;0.01
4229_10.txt;4;0;1;5;135;0.03;0.0;0.01
7977_8.txt;10;3;0;13;304;0.03;0.01;0.0
473_9.txt;0;0;0;0;42;0.0;0.0;0.0
12326_10.txt;0;2;0;2;98;0.0;0.02;0.0
2197_7.txt;14;3;0;17;446;0.03;0.01;0.0
5223_7.txt;13;1;0;14;516;0.03;0.0;0.0
9782_10.txt;2;1;1;4;401;0.0;0.0;0.0
2781_8.txt;3;1;0;4;132;0.02;0.01;0.0
3282_8.txt;4;0;0;4;79;0.05;0.0;0.0
2841_10.txt;20;9;2;31;330;0.06;0.03;0.01
286_10.txt;3;0;0;3;173;0.02;0.0;0.0
4712_7.txt;0;0;0;0;110;0.0;0.0;0.0
9369_10.txt;0;1;2;3;99;0.0;0.01;0.02
4363_8.txt;12;1;1;14;205;0.06;0.0;0.0
10019_8.txt;5;0;0;5;649;0.01;0.0;0.0
4953_8.txt;34;4;1;39;515;0.07;0.01;0.0
2946_10.txt;0;0;0;0;88;0.0;0.0;0.0
9302_10.txt;0;0;0;0;134;0.0;0.0;0.0
7316_10.txt;6;0;0;6;391;0.02;0.0;0.0
7289_10.txt;0;0;0;0;145;0.0;0.0;0.0
12426_7.txt;4;1;3;8;129;0.03;0.01;0.02
7992_7.txt;29;5;2;36;481;0.06;0.01;0.0
11892_9.txt;10;1;0;11;232;0.04;0.0;0.0
8129_9.txt;31;2;9;42;695;0.04;0.0;0.01
12336_9.txt;11;0;1;12;164;0.07;0.0;0.01
3089_9.txt;1;3;3;7;179;0.01;0.02;0.02
9566_7.txt;12;2;0;14;243;0.05;0.01;0.0
7266_7.txt;14;0;0;14;193;0.07;0.0;0.0
7302_10.txt;9;0;0;9;352;0.03;0.0;0.0
11791_8.txt;8;0;0;8;133;0.06;0.0;0.0
6280_7.txt;5;0;1;6;263;0.02;0.0;0.0
275_10.txt;20;0;0;20;185;0.11;0.0;0.0
11984_10.txt;77;0;9;86;906;0.08;0.0;0.01
4769_7.txt;0;2;0;2;257;0.0;0.01;0.0
6906_8.txt;1;0;0;1;169;0.01;0.0;0.0
6569_7.txt;12;1;0;13;371;0.03;0.0;0.0
7672_10.txt;13;3;6;22;471;0.03;0.01;0.01
10914_8.txt;13;0;0;13;166;0.08;0.0;0.0
2816_7.txt;26;0;0;26;412;0.06;0.0;0.0
4332_10.txt;10;0;0;10;179;0.06;0.0;0.0
4880_9.txt;37;9;0;46;820;0.05;0.01;0.0
5976_7.txt;5;0;8;13;294;0.02;0.0;0.03
11835_8.txt;4;0;0;4;165;0.02;0.0;0.0
8645_8.txt;18;3;0;21;649;0.03;0.0;0.0
10185_10.txt;22;3;0;25;560;0.04;0.01;0.0
10208_7.txt;2;0;0;2;425;0.0;0.0;0.0
7369_7.txt;6;0;0;6;162;0.04;0.0;0.0
11102_10.txt;29;0;2;31;574;0.05;0.0;0.0
1888_8.txt;6;0;0;6;186;0.03;0.0;0.0
11241_10.txt;5;2;0;7;174;0.03;0.01;0.0
5932_10.txt;6;0;3;9;146;0.04;0.0;0.02
6005_8.txt;3;0;2;5;216;0.01;0.0;0.01
12304_10.txt;1;0;0;1;161;0.01;0.0;0.0
10302_9.txt;16;0;0;16;155;0.1;0.0;0.0
6256_8.txt;0;0;1;1;154;0.0;0.0;0.01
5768_8.txt;8;0;0;8;288;0.03;0.0;0.0
4525_8.txt;2;0;0;2;58;0.03;0.0;0.0
3259_7.txt;14;0;0;14;230;0.06;0.0;0.0
10000_8.txt;20;1;0;21;488;0.04;0.0;0.0
479_10.txt;11;1;0;12;364;0.03;0.0;0.0
729_10.txt;2;0;5;7;216;0.01;0.0;0.02
1371_8.txt;6;2;0;8;438;0.01;0.0;0.0
6025_9.txt;18;3;2;23;1103;0.02;0.0;0.0
1678_9.txt;25;1;0;26;488;0.05;0.0;0.0
8347_10.txt;6;0;0;6;181;0.03;0.0;0.0
10543_8.txt;0;0;0;0;252;0.0;0.0;0.0
7343_10.txt;3;0;0;3;105;0.03;0.0;0.0
6118_10.txt;7;0;0;7;134;0.05;0.0;0.0
1343_9.txt;2;1;0;3;273;0.01;0.0;0.0
9237_7.txt;15;0;2;17;163;0.09;0.0;0.01
3507_7.txt;33;0;0;33;307;0.11;0.0;0.0
2648_8.txt;4;0;0;4;133;0.03;0.0;0.0
4460_9.txt;11;0;0;11;192;0.06;0.0;0.0
500_9.txt;0;0;0;0;124;0.0;0.0;0.0
11689_8.txt;10;0;0;10;378;0.03;0.0;0.0
2228_7.txt;11;0;0;11;532;0.02;0.0;0.0
765_9.txt;7;3;0;10;408;0.02;0.01;0.0
5885_10.txt;2;0;0;2;84;0.02;0.0;0.0
4364_7.txt;24;2;0;26;131;0.18;0.02;0.0
4435_7.txt;13;0;0;13;168;0.08;0.0;0.0
923_9.txt;0;0;1;1;171;0.0;0.0;0.01
11744_9.txt;13;7;2;22;435;0.03;0.02;0.0
7264_8.txt;11;0;0;11;99;0.11;0.0;0.0
3600_7.txt;2;0;0;2;199;0.01;0.0;0.0
1392_7.txt;17;1;0;18;239;0.07;0.0;0.0
3807_8.txt;16;0;1;17;461;0.03;0.0;0.0
4233_7.txt;23;0;0;23;651;0.04;0.0;0.0
12178_7.txt;4;0;0;4;130;0.03;0.0;0.0
1869_9.txt;7;0;2;9;359;0.02;0.0;0.01
9620_7.txt;0;2;2;4;159;0.0;0.01;0.01
9426_10.txt;6;4;0;10;135;0.04;0.03;0.0
5253_10.txt;4;0;0;4;147;0.03;0.0;0.0
10294_8.txt;12;0;0;12;166;0.07;0.0;0.0
2553_7.txt;2;0;0;2;46;0.04;0.0;0.0
8562_10.txt;12;0;0;12;281;0.04;0.0;0.0
1441_9.txt;18;5;0;23;122;0.15;0.04;0.0
3559_10.txt;14;1;0;15;276;0.05;0.0;0.0
8399_10.txt;0;1;0;1;213;0.0;0.0;0.0
10841_10.txt;1;0;0;1;42;0.02;0.0;0.0
4617_10.txt;2;0;0;2;121;0.02;0.0;0.0
1203_8.txt;2;3;0;5;198;0.01;0.02;0.0
6331_10.txt;40;0;0;40;174;0.23;0.0;0.0
7420_7.txt;9;0;0;9;141;0.06;0.0;0.0
4933_8.txt;4;1;0;5;135;0.03;0.01;0.0
4427_10.txt;4;0;0;4;63;0.06;0.0;0.0
7574_10.txt;4;0;0;4;93;0.04;0.0;0.0
1384_7.txt;0;0;0;0;202;0.0;0.0;0.0
11168_8.txt;18;4;0;22;320;0.06;0.01;0.0
213_9.txt;27;2;0;29;329;0.08;0.01;0.0
11721_7.txt;7;0;0;7;299;0.02;0.0;0.0
6736_10.txt;8;2;8;18;876;0.01;0.0;0.01
3793_7.txt;6;9;0;15;533;0.01;0.02;0.0
9141_8.txt;13;0;6;19;358;0.04;0.0;0.02
202_10.txt;14;0;7;21;375;0.04;0.0;0.02
1017_8.txt;6;0;1;7;179;0.03;0.0;0.01
10886_10.txt;2;0;0;2;581;0.0;0.0;0.0
11163_9.txt;1;0;0;1;158;0.01;0.0;0.0
6915_9.txt;10;3;0;13;156;0.06;0.02;0.0
5947_7.txt;9;1;0;10;218;0.04;0.0;0.0
7469_10.txt;0;0;0;0;80;0.0;0.0;0.0
8401_10.txt;0;0;0;0;143;0.0;0.0;0.0
7525_7.txt;6;2;1;9;211;0.03;0.01;0.0
9802_10.txt;10;0;0;10;600;0.02;0.0;0.0
920_10.txt;8;0;0;8;89;0.09;0.0;0.0
3838_7.txt;11;0;0;11;283;0.04;0.0;0.0
8124_9.txt;0;0;0;0;297;0.0;0.0;0.0
2843_7.txt;0;2;0;2;236;0.0;0.01;0.0
5386_7.txt;10;1;2;13;570;0.02;0.0;0.0
1008_10.txt;7;0;0;7;171;0.04;0.0;0.0
5220_8.txt;32;3;9;44;764;0.04;0.0;0.01
1982_10.txt;17;0;0;17;255;0.07;0.0;0.0
333_10.txt;1;0;0;1;174;0.01;0.0;0.0
6185_8.txt;26;2;3;31;327;0.08;0.01;0.01
12138_7.txt;8;0;0;8;277;0.03;0.0;0.0
1519_10.txt;33;0;0;33;326;0.1;0.0;0.0
9687_9.txt;7;0;0;7;204;0.03;0.0;0.0
1368_10.txt;3;0;1;4;106;0.03;0.0;0.01
6003_8.txt;0;0;0;0;118;0.0;0.0;0.0
3109_10.txt;9;3;15;27;362;0.02;0.01;0.04
7726_10.txt;12;0;0;12;454;0.03;0.0;0.0
5009_9.txt;3;3;3;9;390;0.01;0.01;0.01
2006_7.txt;10;1;0;11;381;0.03;0.0;0.0
2343_10.txt;5;0;1;6;139;0.04;0.0;0.01
5420_7.txt;23;2;1;26;312;0.07;0.01;0.0
8621_10.txt;0;0;0;0;29;0.0;0.0;0.0
7087_9.txt;14;2;0;16;575;0.02;0.0;0.0
2489_7.txt;9;0;0;9;205;0.04;0.0;0.0
3234_9.txt;0;0;0;0;132;0.0;0.0;0.0
4354_8.txt;6;0;1;7;184;0.03;0.0;0.01
1723_7.txt;27;3;0;30;429;0.06;0.01;0.0
7145_9.txt;11;0;0;11;119;0.09;0.0;0.0
8301_7.txt;49;2;4;55;386;0.13;0.01;0.01
3186_8.txt;2;0;0;2;134;0.01;0.0;0.0
3605_8.txt;0;0;0;0;158;0.0;0.0;0.0
4453_10.txt;0;0;0;0;146;0.0;0.0;0.0
8599_7.txt;12;1;5;18;159;0.08;0.01;0.03
5421_7.txt;17;2;3;22;293;0.06;0.01;0.01
6946_10.txt;5;1;0;6;199;0.03;0.01;0.0
9169_8.txt;18;4;0;22;174;0.1;0.02;0.0
5443_8.txt;7;0;4;11;270;0.03;0.0;0.01
10967_10.txt;6;1;0;7;154;0.04;0.01;0.0
2920_8.txt;2;0;0;2;48;0.04;0.0;0.0
10213_8.txt;14;3;0;17;358;0.04;0.01;0.0
6723_10.txt;3;0;0;3;161;0.02;0.0;0.0
6492_10.txt;1;0;0;1;175;0.01;0.0;0.0
4200_9.txt;18;7;5;30;303;0.06;0.02;0.02
2998_7.txt;30;3;1;34;188;0.16;0.02;0.01
397_9.txt;8;2;0;10;333;0.02;0.01;0.0
4125_8.txt;5;0;0;5;138;0.04;0.0;0.0
4188_8.txt;10;3;0;13;281;0.04;0.01;0.0
7478_10.txt;0;2;0;2;298;0.0;0.01;0.0
6496_10.txt;0;0;0;0;126;0.0;0.0;0.0
2646_10.txt;0;0;0;0;383;0.0;0.0;0.0
10617_8.txt;17;5;0;22;253;0.07;0.02;0.0
465_10.txt;8;0;0;8;71;0.11;0.0;0.0
4223_8.txt;10;0;0;10;409;0.02;0.0;0.0
5052_10.txt;6;0;0;6;112;0.05;0.0;0.0
10015_8.txt;28;5;1;34;375;0.07;0.01;0.0
8580_9.txt;1;0;0;1;34;0.03;0.0;0.0
5629_10.txt;2;0;0;2;135;0.01;0.0;0.0
6150_7.txt;4;0;1;5;188;0.02;0.0;0.01
10417_8.txt;10;2;0;12;262;0.04;0.01;0.0
2776_8.txt;49;8;0;57;694;0.07;0.01;0.0
7508_7.txt;3;0;0;3;154;0.02;0.0;0.0
12055_10.txt;0;0;0;0;597;0.0;0.0;0.0
8357_10.txt;3;0;0;3;160;0.02;0.0;0.0
9873_7.txt;18;6;0;24;271;0.07;0.02;0.0
1016_8.txt;6;0;1;7;145;0.04;0.0;0.01
7243_10.txt;26;1;0;27;361;0.07;0.0;0.0
12118_7.txt;21;1;0;22;524;0.04;0.0;0.0
2779_7.txt;18;0;0;18;342;0.05;0.0;0.0
211_9.txt;0;0;0;0;63;0.0;0.0;0.0
8674_9.txt;4;0;0;4;85;0.05;0.0;0.0
541_7.txt;0;1;0;1;220;0.0;0.0;0.0
3317_10.txt;2;0;0;2;125;0.02;0.0;0.0
8148_8.txt;0;0;0;0;226;0.0;0.0;0.0
10060_9.txt;7;2;0;9;260;0.03;0.01;0.0
1901_7.txt;7;0;0;7;123;0.06;0.0;0.0
7671_10.txt;9;0;0;9;176;0.05;0.0;0.0
1484_10.txt;5;2;0;7;120;0.04;0.02;0.0
2009_10.txt;1;0;0;1;52;0.02;0.0;0.0
4526_10.txt;1;0;0;1;50;0.02;0.0;0.0
8322_7.txt;2;0;0;2;75;0.03;0.0;0.0
10427_8.txt;10;2;0;12;169;0.06;0.01;0.0
1149_8.txt;24;0;0;24;178;0.13;0.0;0.0
8012_8.txt;2;0;0;2;150;0.01;0.0;0.0
4814_10.txt;10;2;1;13;159;0.06;0.01;0.01
9027_7.txt;3;0;0;3;83;0.04;0.0;0.0
10462_7.txt;0;0;0;0;41;0.0;0.0;0.0
329_10.txt;1;0;3;4;170;0.01;0.0;0.02
11380_7.txt;13;2;0;15;185;0.07;0.01;0.0
10988_10.txt;2;0;0;2;219;0.01;0.0;0.0
4127_8.txt;12;3;0;15;364;0.03;0.01;0.0
11381_10.txt;9;2;0;11;132;0.07;0.02;0.0
2956_8.txt;11;0;0;11;394;0.03;0.0;0.0
9674_9.txt;14;0;2;16;458;0.03;0.0;0.0
7539_10.txt;2;0;0;2;163;0.01;0.0;0.0
11492_7.txt;27;7;0;34;721;0.04;0.01;0.0
2755_10.txt;0;0;0;0;76;0.0;0.0;0.0
4659_8.txt;8;3;0;11;176;0.05;0.02;0.0
4080_10.txt;10;2;0;12;413;0.02;0.0;0.0
6327_10.txt;0;2;0;2;45;0.0;0.04;0.0
8410_10.txt;4;0;0;4;340;0.01;0.0;0.0
10076_9.txt;0;1;0;1;61;0.0;0.02;0.0
4807_10.txt;3;1;2;6;191;0.02;0.01;0.01
4689_10.txt;0;0;0;0;140;0.0;0.0;0.0
7792_10.txt;2;1;0;3;184;0.01;0.01;0.0
9714_10.txt;3;3;2;8;709;0.0;0.0;0.0
8942_8.txt;2;2;0;4;185;0.01;0.01;0.0
11745_10.txt;7;0;2;9;145;0.05;0.0;0.01
6744_8.txt;9;0;0;9;119;0.08;0.0;0.0
9303_8.txt;0;0;0;0;152;0.0;0.0;0.0
3429_10.txt;8;3;0;11;153;0.05;0.02;0.0
2577_10.txt;9;0;0;9;151;0.06;0.0;0.0
9897_10.txt;1;0;1;2;228;0.0;0.0;0.0
5146_9.txt;10;0;0;10;216;0.05;0.0;0.0
3218_9.txt;16;2;0;18;715;0.02;0.0;0.0
5558_7.txt;9;0;0;9;167;0.05;0.0;0.0
8656_9.txt;46;3;6;55;1039;0.04;0.0;0.01
7580_7.txt;5;1;0;6;277;0.02;0.0;0.0
7285_9.txt;0;0;0;0;119;0.0;0.0;0.0
10745_10.txt;2;3;0;5;225;0.01;0.01;0.0
3724_9.txt;4;5;0;9;275;0.01;0.02;0.0
755_10.txt;5;0;0;5;177;0.03;0.0;0.0
8748_8.txt;0;0;0;0;114;0.0;0.0;0.0
10972_10.txt;4;2;0;6;251;0.02;0.01;0.0
33_7.txt;8;1;0;9;206;0.04;0.0;0.0
10126_10.txt;6;2;3;11;351;0.02;0.01;0.01
7468_10.txt;2;0;0;2;194;0.01;0.0;0.0
6462_10.txt;10;0;0;10;267;0.04;0.0;0.0
11914_7.txt;4;0;2;6;205;0.02;0.0;0.01
1065_10.txt;5;1;1;7;167;0.03;0.01;0.01
2637_7.txt;0;0;1;1;368;0.0;0.0;0.0
7923_8.txt;53;4;1;58;878;0.06;0.0;0.0
4267_8.txt;10;1;0;11;214;0.05;0.0;0.0
3688_8.txt;19;10;0;29;261;0.07;0.04;0.0
10510_7.txt;16;3;0;19;163;0.1;0.02;0.0
4060_10.txt;0;0;0;0;32;0.0;0.0;0.0
8992_9.txt;5;0;0;5;164;0.03;0.0;0.0
7049_7.txt;28;3;1;32;522;0.05;0.01;0.0
8071_9.txt;2;1;0;3;143;0.01;0.01;0.0
9595_10.txt;2;4;0;6;329;0.01;0.01;0.0
2817_9.txt;6;1;0;7;309;0.02;0.0;0.0
4927_8.txt;3;9;0;12;146;0.02;0.06;0.0
4949_8.txt;8;0;0;8;202;0.04;0.0;0.0
5385_7.txt;1;2;0;3;289;0.0;0.01;0.0
7256_9.txt;4;0;0;4;147;0.03;0.0;0.0
7059_10.txt;3;0;0;3;134;0.02;0.0;0.0
3545_7.txt;21;2;0;23;337;0.06;0.01;0.0
1388_10.txt;0;0;0;0;180;0.0;0.0;0.0
328_10.txt;1;0;0;1;236;0.0;0.0;0.0
10067_9.txt;0;0;0;0;50;0.0;0.0;0.0
11688_10.txt;0;1;0;1;66;0.0;0.02;0.0
689_10.txt;0;0;0;0;100;0.0;0.0;0.0
2917_7.txt;2;0;1;3;73;0.03;0.0;0.01
1007_10.txt;3;0;0;3;191;0.02;0.0;0.0
11500_10.txt;15;0;0;15;174;0.09;0.0;0.0
8989_9.txt;21;1;0;22;504;0.04;0.0;0.0
1314_7.txt;0;0;0;0;81;0.0;0.0;0.0
4655_7.txt;15;0;0;15;386;0.04;0.0;0.0
3185_10.txt;1;0;0;1;139;0.01;0.0;0.0
8378_10.txt;1;0;2;3;80;0.01;0.0;0.03
8049_7.txt;5;0;0;5;91;0.05;0.0;0.0
5405_10.txt;3;0;0;3;107;0.03;0.0;0.0
9958_7.txt;0;1;0;1;284;0.0;0.0;0.0
93_10.txt;0;0;1;1;154;0.0;0.0;0.01
5784_8.txt;2;0;0;2;162;0.01;0.0;0.0
8651_9.txt;9;0;0;9;191;0.05;0.0;0.0
3343_7.txt;11;1;2;14;179;0.06;0.01;0.01
1910_9.txt;9;0;0;9;152;0.06;0.0;0.0
8965_8.txt;9;3;0;12;94;0.1;0.03;0.0
10990_7.txt;10;2;1;13;640;0.02;0.0;0.0
4691_10.txt;7;0;0;7;45;0.16;0.0;0.0
1836_7.txt;56;2;3;61;800;0.07;0.0;0.0
11364_10.txt;10;3;2;15;246;0.04;0.01;0.01
4550_10.txt;16;3;0;19;323;0.05;0.01;0.0
6999_7.txt;15;2;2;19;387;0.04;0.01;0.01
5970_10.txt;4;0;0;4;46;0.09;0.0;0.0
7695_9.txt;5;1;2;8;202;0.02;0.0;0.01
693_10.txt;6;0;0;6;150;0.04;0.0;0.0
5573_10.txt;14;0;0;14;180;0.08;0.0;0.0
10018_8.txt;3;0;0;3;255;0.01;0.0;0.0
9281_10.txt;4;1;0;5;282;0.01;0.0;0.0
7971_10.txt;0;0;0;0;146;0.0;0.0;0.0
11571_9.txt;4;0;2;6;297;0.01;0.0;0.01
3836_8.txt;5;2;0;7;245;0.02;0.01;0.0
12478_9.txt;15;0;0;15;205;0.07;0.0;0.0
5568_8.txt;3;0;4;7;168;0.02;0.0;0.02
8370_10.txt;3;0;1;4;52;0.06;0.0;0.02
629_9.txt;4;0;0;4;361;0.01;0.0;0.0
9748_10.txt;0;0;1;1;118;0.0;0.0;0.01
11265_10.txt;3;1;4;8;134;0.02;0.01;0.03
10962_10.txt;17;7;0;24;394;0.04;0.02;0.0
8634_9.txt;3;0;0;3;203;0.01;0.0;0.0
11206_10.txt;0;1;0;1;143;0.0;0.01;0.0
4796_8.txt;19;5;0;24;497;0.04;0.01;0.0
3110_8.txt;1;0;0;1;159;0.01;0.0;0.0
5075_7.txt;1;0;0;1;87;0.01;0.0;0.0
2145_7.txt;0;1;0;1;89;0.0;0.01;0.0
5215_10.txt;4;0;0;4;149;0.03;0.0;0.0
6170_10.txt;2;0;0;2;86;0.02;0.0;0.0
6825_10.txt;7;2;0;9;347;0.02;0.01;0.0
3263_7.txt;14;0;0;14;272;0.05;0.0;0.0
1566_8.txt;41;0;2;43;632;0.06;0.0;0.0
4906_9.txt;2;0;0;2;67;0.03;0.0;0.0
6536_7.txt;5;0;1;6;177;0.03;0.0;0.01
9686_7.txt;4;0;0;4;206;0.02;0.0;0.0
3212_7.txt;7;0;0;7;252;0.03;0.0;0.0
5428_10.txt;7;0;3;10;184;0.04;0.0;0.02
8971_9.txt;3;1;0;4;286;0.01;0.0;0.0
7413_9.txt;0;0;0;0;119;0.0;0.0;0.0
8100_10.txt;31;7;10;48;1090;0.03;0.01;0.01
2504_10.txt;5;0;0;5;146;0.03;0.0;0.0
12379_8.txt;0;2;0;2;151;0.0;0.01;0.0
795_8.txt;10;2;2;14;248;0.04;0.01;0.01
3329_7.txt;16;0;3;19;318;0.05;0.0;0.01
6537_7.txt;18;2;0;20;147;0.12;0.01;0.0
12141_8.txt;36;0;0;36;315;0.11;0.0;0.0
4317_10.txt;6;4;0;10;141;0.04;0.03;0.0
10584_10.txt;6;3;9;18;375;0.02;0.01;0.02
2193_10.txt;0;1;0;1;66;0.0;0.02;0.0
5103_8.txt;2;0;0;2;49;0.04;0.0;0.0
6957_7.txt;15;0;0;15;174;0.09;0.0;0.0
1762_7.txt;13;1;2;16;840;0.02;0.0;0.0
11927_10.txt;2;1;0;3;139;0.01;0.01;0.0
7109_10.txt;2;0;0;2;281;0.01;0.0;0.0
9462_9.txt;3;0;0;3;144;0.02;0.0;0.0
8266_10.txt;7;2;0;9;267;0.03;0.01;0.0
11961_8.txt;5;0;0;5;191;0.03;0.0;0.0
12475_10.txt;6;0;1;7;67;0.09;0.0;0.01
5805_9.txt;1;0;6;7;572;0.0;0.0;0.01
8431_9.txt;16;0;5;21;376;0.04;0.0;0.01
2704_10.txt;4;1;0;5;235;0.02;0.0;0.0
7111_8.txt;26;15;15;56;646;0.04;0.02;0.02
2404_8.txt;2;0;0;2;115;0.02;0.0;0.0
734_10.txt;16;1;1;18;313;0.05;0.0;0.0
9366_9.txt;37;6;0;43;545;0.07;0.01;0.0
10323_10.txt;8;0;0;8;274;0.03;0.0;0.0
8891_10.txt;0;0;0;0;128;0.0;0.0;0.0
5766_10.txt;4;0;3;7;697;0.01;0.0;0.0
5485_10.txt;5;8;1;14;264;0.02;0.03;0.0
11443_10.txt;5;0;0;5;141;0.04;0.0;0.0
54_10.txt;12;1;0;13;274;0.04;0.0;0.0
1799_7.txt;9;0;1;10;160;0.06;0.0;0.01
1610_10.txt;51;0;2;53;666;0.08;0.0;0.0
10241_8.txt;20;0;0;20;413;0.05;0.0;0.0
4732_10.txt;6;0;0;6;129;0.05;0.0;0.0
11346_10.txt;16;2;0;18;183;0.09;0.01;0.0
3122_8.txt;45;2;4;51;1079;0.04;0.0;0.0
9452_9.txt;24;0;0;24;422;0.06;0.0;0.0
2458_8.txt;8;7;0;15;341;0.02;0.02;0.0
8060_9.txt;50;8;9;67;781;0.06;0.01;0.01
6867_9.txt;0;0;0;0;125;0.0;0.0;0.0
3083_10.txt;4;0;0;4;119;0.03;0.0;0.0
9300_10.txt;14;0;0;14;244;0.06;0.0;0.0
7697_9.txt;2;3;0;5;125;0.02;0.02;0.0
861_7.txt;2;0;0;2;214;0.01;0.0;0.0
12198_10.txt;77;28;6;111;1241;0.06;0.02;0.0
3753_9.txt;1;0;0;1;153;0.01;0.0;0.0
3920_9.txt;1;0;0;1;107;0.01;0.0;0.0
9103_10.txt;19;8;0;27;255;0.07;0.03;0.0
2295_7.txt;7;1;0;8;174;0.04;0.01;0.0
6630_10.txt;0;0;0;0;139;0.0;0.0;0.0
11118_10.txt;3;0;0;3;203;0.01;0.0;0.0
6144_7.txt;2;0;1;3;137;0.01;0.0;0.01
11652_10.txt;0;0;0;0;127;0.0;0.0;0.0
5165_9.txt;20;0;0;20;228;0.09;0.0;0.0
8911_8.txt;4;1;0;5;341;0.01;0.0;0.0
662_8.txt;0;1;0;1;120;0.0;0.01;0.0
9476_9.txt;8;4;0;12;221;0.04;0.02;0.0
3535_8.txt;2;2;0;4;439;0.0;0.0;0.0
510_8.txt;1;2;2;5;118;0.01;0.02;0.02
2114_10.txt;6;2;0;8;117;0.05;0.02;0.0
10125_8.txt;4;0;3;7;265;0.02;0.0;0.01
2775_7.txt;7;2;0;9;204;0.03;0.01;0.0
1623_10.txt;2;0;0;2;162;0.01;0.0;0.0
3026_7.txt;31;1;0;32;308;0.1;0.0;0.0
4918_7.txt;10;0;0;10;428;0.02;0.0;0.0
6117_10.txt;3;0;3;6;424;0.01;0.0;0.01
7241_8.txt;26;2;0;28;345;0.08;0.01;0.0
7820_8.txt;53;22;3;78;890;0.06;0.02;0.0
9794_7.txt;10;0;0;10;203;0.05;0.0;0.0
4596_10.txt;6;3;0;9;187;0.03;0.02;0.0
2428_8.txt;6;1;0;7;125;0.05;0.01;0.0
10394_10.txt;11;1;0;12;175;0.06;0.01;0.0
6362_7.txt;4;2;0;6;332;0.01;0.01;0.0
4552_9.txt;13;0;0;13;85;0.15;0.0;0.0
2922_10.txt;9;0;3;12;281;0.03;0.0;0.01
3570_10.txt;0;0;0;0;66;0.0;0.0;0.0
9409_8.txt;4;0;0;4;126;0.03;0.0;0.0
6234_8.txt;7;0;0;7;140;0.05;0.0;0.0
9107_7.txt;17;6;0;23;458;0.04;0.01;0.0
5065_7.txt;0;0;0;0;86;0.0;0.0;0.0
2623_7.txt;3;2;2;7;189;0.02;0.01;0.01
4966_10.txt;48;27;2;77;918;0.05;0.03;0.0
2856_10.txt;4;0;0;4;197;0.02;0.0;0.0
3192_10.txt;7;1;0;8;139;0.05;0.01;0.0
3979_10.txt;3;0;3;6;203;0.01;0.0;0.01
3405_9.txt;2;0;1;3;145;0.01;0.0;0.01
9638_8.txt;0;0;0;0;161;0.0;0.0;0.0
4122_10.txt;1;0;0;1;158;0.01;0.0;0.0
5935_9.txt;0;0;0;0;120;0.0;0.0;0.0
797_8.txt;36;7;0;43;363;0.1;0.02;0.0
12184_10.txt;2;3;0;5;128;0.02;0.02;0.0
7222_8.txt;4;0;0;4;112;0.04;0.0;0.0
6206_8.txt;14;0;0;14;175;0.08;0.0;0.0
12154_7.txt;4;1;2;7;185;0.02;0.01;0.01
10103_8.txt;7;0;0;7;138;0.05;0.0;0.0
11885_7.txt;9;1;0;10;152;0.06;0.01;0.0
881_8.txt;2;0;0;2;100;0.02;0.0;0.0
5704_7.txt;11;1;0;12;257;0.04;0.0;0.0
7683_10.txt;4;1;0;5;303;0.01;0.0;0.0
8707_10.txt;1;0;0;1;390;0.0;0.0;0.0
9868_9.txt;0;0;5;5;262;0.0;0.0;0.02
5312_7.txt;9;0;1;10;233;0.04;0.0;0.0
8851_7.txt;15;0;0;15;249;0.06;0.0;0.0
10673_10.txt;0;0;0;0;82;0.0;0.0;0.0
2690_9.txt;8;4;0;12;118;0.07;0.03;0.0
2005_10.txt;25;2;2;29;690;0.04;0.0;0.0
2798_8.txt;2;0;0;2;129;0.02;0.0;0.0
4194_10.txt;16;3;0;19;416;0.04;0.01;0.0
8425_9.txt;5;3;0;8;133;0.04;0.02;0.0
1616_9.txt;1;0;2;3;161;0.01;0.0;0.01
9183_10.txt;16;2;4;22;390;0.04;0.01;0.01
7849_9.txt;1;0;0;1;95;0.01;0.0;0.0
12181_8.txt;12;4;1;17;301;0.04;0.01;0.0
1230_10.txt;6;0;0;6;130;0.05;0.0;0.0
6795_9.txt;2;0;0;2;201;0.01;0.0;0.0
3262_8.txt;6;0;0;6;138;0.04;0.0;0.0
2267_8.txt;8;0;0;8;260;0.03;0.0;0.0
26_9.txt;11;0;0;11;282;0.04;0.0;0.0
1214_10.txt;20;0;7;27;372;0.05;0.0;0.02
11352_9.txt;6;2;0;8;175;0.03;0.01;0.0
9666_10.txt;2;0;0;2;125;0.02;0.0;0.0
3901_10.txt;2;0;0;2;76;0.03;0.0;0.0
10309_7.txt;12;0;0;12;327;0.04;0.0;0.0
11581_10.txt;24;1;0;25;516;0.05;0.0;0.0
12256_9.txt;25;0;0;25;232;0.11;0.0;0.0
9887_9.txt;2;2;0;4;223;0.01;0.01;0.0
5808_10.txt;2;0;0;2;69;0.03;0.0;0.0
9655_10.txt;5;4;1;10;549;0.01;0.01;0.0
241_8.txt;3;2;0;5;136;0.02;0.01;0.0
2082_10.txt;18;5;0;23;563;0.03;0.01;0.0
2141_10.txt;10;3;0;13;182;0.05;0.02;0.0
5539_10.txt;0;0;0;0;384;0.0;0.0;0.0
2523_9.txt;2;0;0;2;298;0.01;0.0;0.0
6443_9.txt;3;1;0;4;235;0.01;0.0;0.0
8662_8.txt;0;2;0;2;333;0.0;0.01;0.0
521_10.txt;21;0;0;21;322;0.07;0.0;0.0
10494_10.txt;2;0;0;2;143;0.01;0.0;0.0
9843_7.txt;0;0;2;2;229;0.0;0.0;0.01
11764_10.txt;4;3;6;13;131;0.03;0.02;0.05
5838_8.txt;48;5;10;63;803;0.06;0.01;0.01
4345_10.txt;18;0;0;18;501;0.04;0.0;0.0
12319_8.txt;5;0;0;5;227;0.02;0.0;0.0
526_10.txt;9;1;0;10;189;0.05;0.01;0.0
6810_7.txt;4;0;1;5;398;0.01;0.0;0.0
4694_10.txt;6;0;3;9;170;0.04;0.0;0.02
12232_8.txt;3;0;0;3;202;0.01;0.0;0.0
3239_10.txt;17;0;0;17;513;0.03;0.0;0.0
63_10.txt;0;0;0;0;141;0.0;0.0;0.0
5356_8.txt;2;0;0;2;78;0.03;0.0;0.0
11582_10.txt;7;0;2;9;184;0.04;0.0;0.01
6691_9.txt;3;0;0;3;111;0.03;0.0;0.0
12300_10.txt;11;1;0;12;72;0.15;0.01;0.0
2265_7.txt;11;0;0;11;813;0.01;0.0;0.0
12310_10.txt;3;0;0;3;73;0.04;0.0;0.0
11783_10.txt;0;0;3;3;173;0.0;0.0;0.02
8190_10.txt;4;0;0;4;180;0.02;0.0;0.0
9344_8.txt;6;6;2;14;570;0.01;0.01;0.0
5301_8.txt;0;0;0;0;57;0.0;0.0;0.0
3523_9.txt;13;0;0;13;147;0.09;0.0;0.0
7783_7.txt;1;2;0;3;174;0.01;0.01;0.0
4900_8.txt;9;1;0;10;189;0.05;0.01;0.0
7996_8.txt;4;2;0;6;211;0.02;0.01;0.0
2219_10.txt;0;0;0;0;129;0.0;0.0;0.0
1200_10.txt;8;0;0;8;218;0.04;0.0;0.0
573_9.txt;12;0;0;12;167;0.07;0.0;0.0
11287_8.txt;3;0;0;3;166;0.02;0.0;0.0
8554_7.txt;2;0;0;2;177;0.01;0.0;0.0
2872_10.txt;6;0;0;6;168;0.04;0.0;0.0
12061_10.txt;2;0;0;2;313;0.01;0.0;0.0
7152_9.txt;2;0;3;5;83;0.02;0.0;0.04
3998_10.txt;4;0;0;4;155;0.03;0.0;0.0
9926_7.txt;14;2;0;16;250;0.06;0.01;0.0
2495_9.txt;4;0;0;4;197;0.02;0.0;0.0
10708_8.txt;10;2;0;12;229;0.04;0.01;0.0
10692_8.txt;6;0;0;6;171;0.04;0.0;0.0
3917_9.txt;0;1;0;1;179;0.0;0.01;0.0
7246_10.txt;0;0;0;0;152;0.0;0.0;0.0
1856_9.txt;30;3;5;38;386;0.08;0.01;0.01
3437_8.txt;0;0;0;0;194;0.0;0.0;0.0
7238_9.txt;12;1;0;13;350;0.03;0.0;0.0
246_7.txt;7;0;0;7;205;0.03;0.0;0.0
4393_7.txt;7;0;0;7;193;0.04;0.0;0.0
12439_8.txt;7;2;0;9;157;0.04;0.01;0.0
7319_10.txt;17;0;0;17;374;0.05;0.0;0.0
8788_10.txt;20;0;0;20;364;0.05;0.0;0.0
7403_8.txt;0;0;0;0;44;0.0;0.0;0.0
9741_8.txt;3;0;0;3;189;0.02;0.0;0.0
7447_8.txt;1;0;0;1;212;0.0;0.0;0.0
1984_10.txt;9;1;0;10;124;0.07;0.01;0.0
988_8.txt;0;0;0;0;89;0.0;0.0;0.0
7703_8.txt;7;3;0;10;132;0.05;0.02;0.0
5660_10.txt;8;0;0;8;148;0.05;0.0;0.0
8162_9.txt;9;0;1;10;180;0.05;0.0;0.01
3560_8.txt;26;2;0;28;237;0.11;0.01;0.0
2661_10.txt;8;0;0;8;367;0.02;0.0;0.0
1338_7.txt;21;2;1;24;340;0.06;0.01;0.0
1351_10.txt;24;3;0;27;235;0.1;0.01;0.0
10824_10.txt;12;0;0;12;177;0.07;0.0;0.0
187_8.txt;22;4;1;27;253;0.09;0.02;0.0
4312_10.txt;8;1;0;9;345;0.02;0.0;0.0
7587_9.txt;1;0;0;1;199;0.01;0.0;0.0
10_9.txt;3;0;0;3;87;0.03;0.0;0.0
11966_10.txt;5;0;0;5;174;0.03;0.0;0.0
1381_7.txt;34;1;0;35;606;0.06;0.0;0.0
9009_10.txt;0;0;0;0;146;0.0;0.0;0.0
8121_8.txt;3;3;0;6;379;0.01;0.01;0.0
9731_8.txt;19;4;2;25;507;0.04;0.01;0.0
6719_8.txt;5;0;0;5;286;0.02;0.0;0.0
12035_8.txt;7;1;2;10;156;0.04;0.01;0.01
3907_10.txt;4;0;0;4;46;0.09;0.0;0.0
4902_8.txt;34;1;7;42;435;0.08;0.0;0.02
7298_7.txt;0;0;1;1;273;0.0;0.0;0.0
4482_7.txt;67;5;0;72;1286;0.05;0.0;0.0
3398_10.txt;13;1;6;20;328;0.04;0.0;0.02
4948_7.txt;7;0;1;8;365;0.02;0.0;0.0
1739_10.txt;8;1;8;17;205;0.04;0.0;0.04
1714_8.txt;5;0;0;5;188;0.03;0.0;0.0
11881_9.txt;20;0;0;20;449;0.04;0.0;0.0
986_10.txt;15;0;1;16;165;0.09;0.0;0.01
10305_8.txt;5;0;0;5;80;0.06;0.0;0.0
4869_10.txt;1;0;1;2;151;0.01;0.0;0.01
3050_9.txt;0;0;0;0;70;0.0;0.0;0.0
312_10.txt;10;4;0;14;375;0.03;0.01;0.0
9264_9.txt;8;5;0;13;719;0.01;0.01;0.0
581_10.txt;4;0;0;4;93;0.04;0.0;0.0
7182_10.txt;0;0;0;0;137;0.0;0.0;0.0
12004_10.txt;5;0;0;5;137;0.04;0.0;0.0
2003_8.txt;4;0;0;4;292;0.01;0.0;0.0
8684_10.txt;25;0;0;25;159;0.16;0.0;0.0
4809_10.txt;28;6;7;41;385;0.07;0.02;0.02
8575_10.txt;21;1;4;26;292;0.07;0.0;0.01
3940_9.txt;30;3;3;36;384;0.08;0.01;0.01
11551_7.txt;18;0;0;18;211;0.09;0.0;0.0
3594_7.txt;2;0;0;2;189;0.01;0.0;0.0
12305_8.txt;0;1;0;1;222;0.0;0.0;0.0
11249_7.txt;6;0;3;9;223;0.03;0.0;0.01
1468_9.txt;2;0;0;2;227;0.01;0.0;0.0
2283_9.txt;5;4;1;10;201;0.02;0.02;0.0
8643_7.txt;9;1;0;10;100;0.09;0.01;0.0
10685_7.txt;3;1;0;4;187;0.02;0.01;0.0
6143_7.txt;8;1;3;12;163;0.05;0.01;0.02
6898_9.txt;19;4;0;23;282;0.07;0.01;0.0
11223_9.txt;16;4;2;22;382;0.04;0.01;0.01
9682_10.txt;11;0;0;11;205;0.05;0.0;0.0
9069_7.txt;9;0;6;15;397;0.02;0.0;0.02
6419_10.txt;4;5;4;13;394;0.01;0.01;0.01
2601_10.txt;52;3;14;69;578;0.09;0.01;0.02
819_10.txt;15;3;10;28;462;0.03;0.01;0.02
9937_10.txt;0;0;0;0;237;0.0;0.0;0.0
10606_10.txt;10;4;0;14;157;0.06;0.03;0.0
3973_7.txt;24;3;11;38;413;0.06;0.01;0.03
5089_9.txt;5;1;0;6;148;0.03;0.01;0.0
11478_8.txt;6;0;1;7;219;0.03;0.0;0.0
5309_7.txt;11;0;0;11;216;0.05;0.0;0.0
2759_10.txt;0;0;0;0;191;0.0;0.0;0.0
10084_10.txt;0;2;0;2;129;0.0;0.02;0.0
9026_9.txt;0;0;0;0;67;0.0;0.0;0.0
2923_10.txt;12;0;1;13;152;0.08;0.0;0.01
8108_10.txt;2;0;0;2;154;0.01;0.0;0.0
5149_8.txt;3;3;1;7;220;0.01;0.01;0.0
7546_7.txt;0;0;0;0;139;0.0;0.0;0.0
7569_10.txt;4;0;0;4;198;0.02;0.0;0.0
12401_8.txt;4;7;2;13;536;0.01;0.01;0.0
1151_9.txt;23;1;0;24;348;0.07;0.0;0.0
4765_7.txt;2;1;0;3;85;0.02;0.01;0.0
6977_9.txt;6;2;0;8;103;0.06;0.02;0.0
4269_10.txt;0;1;0;1;57;0.0;0.02;0.0
5433_10.txt;8;0;0;8;81;0.1;0.0;0.0
1175_9.txt;210;9;12;231;2740;0.08;0.0;0.0
10815_10.txt;0;0;0;0;106;0.0;0.0;0.0
4662_8.txt;11;0;1;12;231;0.05;0.0;0.0
2413_10.txt;0;0;0;0;224;0.0;0.0;0.0
11473_10.txt;0;0;0;0;215;0.0;0.0;0.0
9047_10.txt;5;0;7;12;490;0.01;0.0;0.01
10361_7.txt;2;1;0;3;241;0.01;0.0;0.0
8477_10.txt;0;0;0;0;118;0.0;0.0;0.0
2900_9.txt;8;1;0;9;439;0.02;0.0;0.0
10228_8.txt;3;1;2;6;539;0.01;0.0;0.0
9418_10.txt;16;0;0;16;156;0.1;0.0;0.0
6485_10.txt;1;0;0;1;98;0.01;0.0;0.0
8392_8.txt;0;0;0;0;210;0.0;0.0;0.0
122_9.txt;4;1;0;5;226;0.02;0.0;0.0
8297_10.txt;17;0;0;17;212;0.08;0.0;0.0
3549_8.txt;17;2;1;20;547;0.03;0.0;0.0
8917_7.txt;22;1;0;23;239;0.09;0.0;0.0
6658_10.txt;6;0;0;6;184;0.03;0.0;0.0
5973_9.txt;0;0;0;0;189;0.0;0.0;0.0
2362_9.txt;36;9;8;53;1076;0.03;0.01;0.01
3077_10.txt;2;0;3;5;136;0.01;0.0;0.02
10331_10.txt;49;5;2;56;559;0.09;0.01;0.0
8975_10.txt;3;3;0;6;484;0.01;0.01;0.0
3440_8.txt;3;0;0;3;204;0.01;0.0;0.0
4553_10.txt;14;1;7;22;260;0.05;0.0;0.03
3772_10.txt;9;0;0;9;157;0.06;0.0;0.0
9271_8.txt;0;0;0;0;307;0.0;0.0;0.0
1625_7.txt;0;0;0;0;132;0.0;0.0;0.0
5951_10.txt;14;0;1;15;227;0.06;0.0;0.0
1541_8.txt;2;1;4;7;120;0.02;0.01;0.03
403_8.txt;8;2;0;10;316;0.03;0.01;0.0
3713_10.txt;12;1;1;14;183;0.07;0.01;0.01
889_10.txt;4;2;2;8;101;0.04;0.02;0.02
8184_7.txt;16;0;0;16;533;0.03;0.0;0.0
5470_10.txt;62;13;5;80;1090;0.06;0.01;0.0
6453_10.txt;9;0;0;9;196;0.05;0.0;0.0
2119_10.txt;10;1;1;12;154;0.06;0.01;0.01
11199_9.txt;15;0;2;17;618;0.02;0.0;0.0
12292_10.txt;3;0;5;8;99;0.03;0.0;0.05
9469_10.txt;18;3;2;23;431;0.04;0.01;0.0
5450_10.txt;11;2;0;13;315;0.03;0.01;0.0
6845_10.txt;12;0;0;12;138;0.09;0.0;0.0
5152_9.txt;9;7;0;16;278;0.03;0.03;0.0
4805_8.txt;14;2;2;18;217;0.06;0.01;0.01
5346_7.txt;21;9;0;30;269;0.08;0.03;0.0
8895_10.txt;6;1;0;7;160;0.04;0.01;0.0
12161_7.txt;10;0;0;10;120;0.08;0.0;0.0
4510_7.txt;10;0;3;13;196;0.05;0.0;0.02
11827_9.txt;4;0;0;4;158;0.03;0.0;0.0
11784_10.txt;14;0;4;18;226;0.06;0.0;0.02
5222_8.txt;6;1;0;7;172;0.03;0.01;0.0
7528_10.txt;32;4;0;36;407;0.08;0.01;0.0
3851_10.txt;11;3;1;15;520;0.02;0.01;0.0
5168_10.txt;29;5;0;34;638;0.05;0.01;0.0
11201_7.txt;6;0;0;6;196;0.03;0.0;0.0
11503_10.txt;25;1;0;26;123;0.2;0.01;0.0
12344_8.txt;6;0;0;6;155;0.04;0.0;0.0
3538_10.txt;51;4;6;61;1019;0.05;0.0;0.01
10718_10.txt;5;2;4;11;254;0.02;0.01;0.02
818_10.txt;6;0;7;13;201;0.03;0.0;0.03
7084_10.txt;14;0;0;14;517;0.03;0.0;0.0
6335_10.txt;2;1;0;3;93;0.02;0.01;0.0
8242_8.txt;10;0;0;10;168;0.06;0.0;0.0
1148_8.txt;3;0;2;5;128;0.02;0.0;0.02
12395_8.txt;0;0;0;0;80;0.0;0.0;0.0
10341_7.txt;2;0;2;4;203;0.01;0.0;0.01
11625_7.txt;15;0;0;15;809;0.02;0.0;0.0
5695_8.txt;22;0;0;22;308;0.07;0.0;0.0
2836_7.txt;22;3;0;25;598;0.04;0.01;0.0
3749_9.txt;5;0;0;5;155;0.03;0.0;0.0
647_10.txt;3;0;0;3;161;0.02;0.0;0.0
3454_8.txt;20;0;0;20;347;0.06;0.0;0.0
2544_8.txt;74;3;4;81;1109;0.07;0.0;0.0
1472_8.txt;7;2;0;9;181;0.04;0.01;0.0
10947_8.txt;10;0;3;13;337;0.03;0.0;0.01
5021_10.txt;5;0;0;5;109;0.05;0.0;0.0
10725_9.txt;0;0;0;0;125;0.0;0.0;0.0
10531_10.txt;1;0;0;1;145;0.01;0.0;0.0
1523_9.txt;23;1;2;26;329;0.07;0.0;0.01
4046_8.txt;8;2;0;10;150;0.05;0.01;0.0
4448_10.txt;4;0;0;4;196;0.02;0.0;0.0
3831_10.txt;21;3;0;24;612;0.03;0.0;0.0
1152_10.txt;10;0;0;10;114;0.09;0.0;0.0
1366_8.txt;0;0;0;0;196;0.0;0.0;0.0
978_9.txt;18;0;0;18;465;0.04;0.0;0.0
11702_10.txt;3;0;0;3;372;0.01;0.0;0.0
2976_10.txt;4;0;0;4;61;0.07;0.0;0.0
4477_7.txt;13;0;0;13;178;0.07;0.0;0.0
10678_9.txt;9;0;0;9;130;0.07;0.0;0.0
12456_10.txt;0;0;0;0;193;0.0;0.0;0.0
2353_10.txt;46;0;0;46;953;0.05;0.0;0.0
4487_9.txt;23;0;0;23;354;0.06;0.0;0.0
10291_7.txt;13;0;0;13;220;0.06;0.0;0.0
5588_10.txt;12;3;4;19;339;0.04;0.01;0.01
11410_7.txt;24;0;2;26;214;0.11;0.0;0.01
10498_10.txt;3;0;1;4;119;0.03;0.0;0.01
10092_8.txt;7;3;1;11;123;0.06;0.02;0.01
10137_7.txt;14;0;2;16;472;0.03;0.0;0.0
5537_10.txt;7;1;0;8;147;0.05;0.01;0.0
4723_8.txt;1;0;0;1;132;0.01;0.0;0.0
1344_9.txt;34;6;1;41;643;0.05;0.01;0.0
7949_10.txt;5;2;0;7;735;0.01;0.0;0.0
7307_10.txt;8;0;0;8;153;0.05;0.0;0.0
3580_10.txt;2;0;0;2;241;0.01;0.0;0.0
9330_8.txt;0;0;0;0;193;0.0;0.0;0.0
7862_7.txt;14;1;0;15;297;0.05;0.0;0.0
8534_10.txt;34;1;0;35;368;0.09;0.0;0.0
11706_10.txt;0;0;0;0;180;0.0;0.0;0.0
8003_8.txt;2;0;0;2;163;0.01;0.0;0.0
4908_10.txt;9;1;2;12;460;0.02;0.0;0.0
4818_9.txt;10;1;6;17;373;0.03;0.0;0.02
1559_7.txt;16;1;1;18;510;0.03;0.0;0.0
11316_8.txt;43;4;0;47;881;0.05;0.0;0.0
10993_10.txt;2;0;0;2;278;0.01;0.0;0.0
1967_8.txt;5;1;0;6;146;0.03;0.01;0.0
12313_10.txt;0;0;0;0;56;0.0;0.0;0.0
7907_7.txt;0;1;0;1;236;0.0;0.0;0.0
2163_10.txt;6;7;1;14;371;0.02;0.02;0.0
2143_9.txt;0;1;0;1;76;0.0;0.01;0.0
389_10.txt;2;0;0;2;289;0.01;0.0;0.0
11696_7.txt;2;0;0;2;162;0.01;0.0;0.0
2850_9.txt;5;0;0;5;87;0.06;0.0;0.0
9955_9.txt;5;0;0;5;163;0.03;0.0;0.0
9064_7.txt;4;0;0;4;189;0.02;0.0;0.0
3607_8.txt;1;0;0;1;304;0.0;0.0;0.0
8054_8.txt;17;0;0;17;229;0.07;0.0;0.0
8983_8.txt;0;0;0;0;139;0.0;0.0;0.0
963_8.txt;14;1;0;15;326;0.04;0.0;0.0
9839_7.txt;2;0;0;2;132;0.02;0.0;0.0
11654_9.txt;0;0;0;0;265;0.0;0.0;0.0
6846_10.txt;4;0;0;4;62;0.06;0.0;0.0
11828_8.txt;24;0;0;24;258;0.09;0.0;0.0
1582_8.txt;25;16;4;45;1024;0.02;0.02;0.0
2702_9.txt;5;3;0;8;657;0.01;0.0;0.0
6356_8.txt;5;0;0;5;158;0.03;0.0;0.0
3463_7.txt;12;0;4;16;316;0.04;0.0;0.01
5957_9.txt;2;0;0;2;131;0.02;0.0;0.0
445_10.txt;0;1;0;1;150;0.0;0.01;0.0
857_8.txt;15;1;1;17;287;0.05;0.0;0.0
7976_7.txt;12;5;3;20;161;0.07;0.03;0.02
2766_9.txt;14;1;4;19;528;0.03;0.0;0.01
9698_10.txt;10;3;3;16;385;0.03;0.01;0.01
1989_8.txt;10;0;0;10;318;0.03;0.0;0.0
6390_8.txt;4;0;0;4;45;0.09;0.0;0.0
11495_10.txt;0;4;0;4;255;0.0;0.02;0.0
10821_8.txt;3;0;0;3;157;0.02;0.0;0.0
10282_8.txt;13;0;0;13;300;0.04;0.0;0.0
8101_8.txt;11;0;3;14;395;0.03;0.0;0.01
2251_8.txt;17;1;10;28;130;0.13;0.01;0.08
6878_8.txt;7;2;8;17;177;0.04;0.01;0.05
9599_9.txt;1;1;1;3;126;0.01;0.01;0.01
8408_10.txt;8;2;0;10;132;0.06;0.02;0.0
3475_9.txt;22;5;1;28;437;0.05;0.01;0.0
3853_9.txt;31;4;5;40;693;0.04;0.01;0.01
519_10.txt;0;0;0;0;126;0.0;0.0;0.0
1347_10.txt;2;0;1;3;88;0.02;0.0;0.01
10573_10.txt;9;0;4;13;262;0.03;0.0;0.02
3966_9.txt;11;5;8;24;264;0.04;0.02;0.03
11028_8.txt;3;0;0;3;168;0.02;0.0;0.0
3971_8.txt;13;0;6;19;521;0.02;0.0;0.01
4828_7.txt;10;0;0;10;151;0.07;0.0;0.0
2820_7.txt;12;0;0;12;421;0.03;0.0;0.0
2790_10.txt;33;4;2;39;324;0.1;0.01;0.01
2127_9.txt;3;0;0;3;172;0.02;0.0;0.0
3844_8.txt;12;1;0;13;399;0.03;0.0;0.0
5717_9.txt;13;2;0;15;283;0.05;0.01;0.0
10041_10.txt;60;7;2;69;1087;0.06;0.01;0.0
1125_8.txt;11;2;2;15;193;0.06;0.01;0.01
10507_10.txt;4;0;1;5;147;0.03;0.0;0.01
367_10.txt;0;0;0;0;78;0.0;0.0;0.0
11090_8.txt;42;0;0;42;283;0.15;0.0;0.0
909_8.txt;6;0;0;6;284;0.02;0.0;0.0
2433_8.txt;4;1;2;7;312;0.01;0.0;0.01
7824_10.txt;11;2;0;13;165;0.07;0.01;0.0
7131_9.txt;18;1;1;20;176;0.1;0.01;0.01
268_8.txt;5;0;0;5;155;0.03;0.0;0.0
1801_8.txt;7;0;0;7;149;0.05;0.0;0.0
11200_8.txt;3;0;0;3;344;0.01;0.0;0.0
12386_8.txt;7;0;0;7;229;0.03;0.0;0.0
9581_10.txt;2;1;0;3;124;0.02;0.01;0.0
1103_10.txt;10;0;0;10;155;0.06;0.0;0.0
4403_10.txt;6;2;0;8;206;0.03;0.01;0.0
8680_9.txt;3;0;4;7;413;0.01;0.0;0.01
5466_8.txt;4;0;0;4;139;0.03;0.0;0.0
137_7.txt;7;0;2;9;222;0.03;0.0;0.01
5790_7.txt;9;1;0;10;361;0.02;0.0;0.0
6358_10.txt;28;1;0;29;205;0.14;0.0;0.0
1470_10.txt;27;0;8;35;875;0.03;0.0;0.01
5063_7.txt;4;2;0;6;105;0.04;0.02;0.0
11143_10.txt;3;0;0;3;266;0.01;0.0;0.0
4414_9.txt;0;3;0;3;181;0.0;0.02;0.0
1014_9.txt;23;0;2;25;447;0.05;0.0;0.0
7286_8.txt;7;0;0;7;236;0.03;0.0;0.0
774_8.txt;2;0;0;2;141;0.01;0.0;0.0
126_10.txt;2;1;0;3;130;0.02;0.01;0.0
3747_10.txt;5;0;0;5;221;0.02;0.0;0.0
6650_8.txt;6;0;0;6;219;0.03;0.0;0.0
8169_8.txt;5;2;0;7;127;0.04;0.02;0.0
6841_7.txt;17;0;2;19;172;0.1;0.0;0.01
5592_10.txt;7;1;0;8;260;0.03;0.0;0.0
7141_8.txt;11;0;0;11;179;0.06;0.0;0.0
2635_7.txt;17;5;1;23;265;0.06;0.02;0.0
10715_8.txt;2;5;5;12;151;0.01;0.03;0.03
10101_8.txt;0;0;0;0;62;0.0;0.0;0.0
10139_8.txt;10;0;0;10;575;0.02;0.0;0.0
10695_8.txt;4;2;0;6;52;0.08;0.04;0.0
4444_10.txt;0;0;0;0;232;0.0;0.0;0.0
11825_8.txt;3;0;0;3;72;0.04;0.0;0.0
10590_8.txt;0;2;0;2;132;0.0;0.02;0.0
5625_8.txt;19;0;0;19;179;0.11;0.0;0.0
550_10.txt;30;3;0;33;421;0.07;0.01;0.0
1221_7.txt;2;2;0;4;409;0.0;0.0;0.0
2394_7.txt;0;0;0;0;74;0.0;0.0;0.0
1491_9.txt;15;4;1;20;1031;0.01;0.0;0.0
6154_10.txt;40;7;3;50;709;0.06;0.01;0.0
7166_9.txt;3;0;1;4;340;0.01;0.0;0.0
6083_8.txt;15;0;0;15;184;0.08;0.0;0.0
553_7.txt;0;1;0;1;68;0.0;0.01;0.0
4066_10.txt;2;0;0;2;120;0.02;0.0;0.0
152_9.txt;4;0;0;4;255;0.02;0.0;0.0
8607_9.txt;10;2;0;12;197;0.05;0.01;0.0
4706_8.txt;2;0;1;3;113;0.02;0.0;0.01
9122_7.txt;8;0;0;8;132;0.06;0.0;0.0
1933_8.txt;4;1;0;5;120;0.03;0.01;0.0
3915_9.txt;2;1;0;3;140;0.01;0.01;0.0
8900_10.txt;2;0;0;2;157;0.01;0.0;0.0
5243_9.txt;13;2;0;15;499;0.03;0.0;0.0
4466_8.txt;48;4;2;54;851;0.06;0.0;0.0
9518_10.txt;2;0;0;2;129;0.02;0.0;0.0
3936_7.txt;51;4;4;59;363;0.14;0.01;0.01
8592_7.txt;11;0;4;15;191;0.06;0.0;0.02
11216_7.txt;0;0;1;1;144;0.0;0.0;0.01
2085_7.txt;5;0;0;5;235;0.02;0.0;0.0
12233_8.txt;33;1;3;37;476;0.07;0.0;0.01
2786_7.txt;8;0;0;8;178;0.04;0.0;0.0
10278_7.txt;7;0;0;7;255;0.03;0.0;0.0
946_8.txt;28;10;2;40;405;0.07;0.02;0.0
1279_9.txt;1;0;0;1;110;0.01;0.0;0.0
2891_8.txt;2;0;3;5;273;0.01;0.0;0.01
1222_10.txt;0;0;0;0;219;0.0;0.0;0.0
7766_7.txt;13;3;0;16;295;0.04;0.01;0.0
1348_10.txt;2;0;0;2;73;0.03;0.0;0.0
6699_8.txt;24;1;0;25;324;0.07;0.0;0.0
2823_7.txt;49;6;1;56;568;0.09;0.01;0.0
5531_10.txt;3;0;0;3;177;0.02;0.0;0.0
34_8.txt;8;0;2;10;327;0.02;0.0;0.01
4714_10.txt;15;0;0;15;168;0.09;0.0;0.0
1183_8.txt;2;0;0;2;144;0.01;0.0;0.0
6577_8.txt;18;2;1;21;285;0.06;0.01;0.0
2589_7.txt;5;2;0;7;189;0.03;0.01;0.0
10037_9.txt;9;0;0;9;190;0.05;0.0;0.0
5279_8.txt;0;0;0;0;136;0.0;0.0;0.0
11155_10.txt;15;4;1;20;431;0.03;0.01;0.0
10209_7.txt;3;0;0;3;212;0.01;0.0;0.0
3728_10.txt;0;2;0;2;166;0.0;0.01;0.0
4544_10.txt;5;1;0;6;77;0.06;0.01;0.0
11055_10.txt;8;0;0;8;287;0.03;0.0;0.0
1295_10.txt;5;0;0;5;178;0.03;0.0;0.0
542_9.txt;9;1;0;10;159;0.06;0.01;0.0
8978_10.txt;39;6;1;46;783;0.05;0.01;0.0
11031_8.txt;8;0;2;10;146;0.05;0.0;0.01
7347_10.txt;4;0;0;4;301;0.01;0.0;0.0
9063_8.txt;17;0;1;18;507;0.03;0.0;0.0
10046_9.txt;16;1;0;17;643;0.02;0.0;0.0
8181_10.txt;3;0;0;3;82;0.04;0.0;0.0
10280_10.txt;8;0;0;8;541;0.01;0.0;0.0
11884_8.txt;1;0;0;1;97;0.01;0.0;0.0
10991_9.txt;2;0;0;2;138;0.01;0.0;0.0
6865_7.txt;0;0;0;0;76;0.0;0.0;0.0
8624_7.txt;5;0;0;5;479;0.01;0.0;0.0
1737_8.txt;10;0;0;10;219;0.05;0.0;0.0
1736_10.txt;8;1;0;9;133;0.06;0.01;0.0
3503_7.txt;1;0;0;1;229;0.0;0.0;0.0
4504_9.txt;3;0;0;3;279;0.01;0.0;0.0
9952_8.txt;9;2;0;11;214;0.04;0.01;0.0
1730_10.txt;2;0;0;2;67;0.03;0.0;0.0
5879_10.txt;10;2;2;14;140;0.07;0.01;0.01
1896_8.txt;47;7;1;55;517;0.09;0.01;0.0
1359_7.txt;7;0;0;7;166;0.04;0.0;0.0
3063_10.txt;10;0;0;10;204;0.05;0.0;0.0
6489_10.txt;7;1;0;8;334;0.02;0.0;0.0
8741_10.txt;1;0;0;1;168;0.01;0.0;0.0
8133_7.txt;0;0;0;0;144;0.0;0.0;0.0
3065_10.txt;5;0;0;5;69;0.07;0.0;0.0
9746_9.txt;9;1;0;10;322;0.03;0.0;0.0
9680_8.txt;4;0;0;4;50;0.08;0.0;0.0
12314_10.txt;23;0;3;26;577;0.04;0.0;0.01
301_10.txt;19;0;0;19;170;0.11;0.0;0.0
8579_8.txt;0;0;2;2;289;0.0;0.0;0.01
2173_10.txt;17;2;0;19;227;0.07;0.01;0.0
750_8.txt;38;5;1;44;506;0.08;0.01;0.0
4415_10.txt;10;1;0;11;191;0.05;0.01;0.0
10776_8.txt;8;2;0;10;249;0.03;0.01;0.0
8483_7.txt;5;0;0;5;141;0.04;0.0;0.0
12200_8.txt;25;10;0;35;371;0.07;0.03;0.0
4916_9.txt;22;4;2;28;411;0.05;0.01;0.0
10150_9.txt;6;1;2;9;378;0.02;0.0;0.01
10187_7.txt;6;0;0;6;151;0.04;0.0;0.0
599_10.txt;11;3;0;14;181;0.06;0.02;0.0
87_10.txt;1;0;0;1;198;0.01;0.0;0.0
9974_8.txt;3;0;0;3;163;0.02;0.0;0.0
10097_9.txt;1;0;3;4;294;0.0;0.0;0.01
7606_9.txt;0;0;0;0;117;0.0;0.0;0.0
8569_9.txt;4;2;0;6;97;0.04;0.02;0.0
270_10.txt;10;0;0;10;160;0.06;0.0;0.0
7197_7.txt;24;1;0;25;147;0.16;0.01;0.0
8261_8.txt;0;0;1;1;353;0.0;0.0;0.0
369_10.txt;5;0;0;5;90;0.06;0.0;0.0
6226_10.txt;11;2;1;14;197;0.06;0.01;0.01
7989_10.txt;20;0;4;24;501;0.04;0.0;0.01
8132_10.txt;3;0;0;3;142;0.02;0.0;0.0
2451_8.txt;10;0;2;12;190;0.05;0.0;0.01
4793_7.txt;3;1;0;4;154;0.02;0.01;0.0
11748_8.txt;3;0;0;3;121;0.02;0.0;0.0
4009_9.txt;31;1;4;36;830;0.04;0.0;0.0
3298_10.txt;0;0;0;0;145;0.0;0.0;0.0
753_8.txt;19;1;0;20;332;0.06;0.0;0.0
3307_8.txt;7;2;0;9;206;0.03;0.01;0.0
1847_10.txt;0;0;0;0;146;0.0;0.0;0.0
4104_9.txt;5;2;0;7;226;0.02;0.01;0.0
6126_10.txt;8;0;0;8;157;0.05;0.0;0.0
3458_10.txt;14;3;0;17;221;0.06;0.01;0.0
1890_10.txt;5;0;0;5;219;0.02;0.0;0.0
7558_8.txt;4;0;0;4;100;0.04;0.0;0.0
10001_10.txt;7;0;0;7;173;0.04;0.0;0.0
7126_10.txt;4;2;0;6;209;0.02;0.01;0.0
10691_7.txt;2;1;0;3;117;0.02;0.01;0.0
3987_7.txt;0;1;0;1;404;0.0;0.0;0.0
5508_10.txt;15;5;0;20;223;0.07;0.02;0.0
7906_7.txt;10;0;0;10;182;0.05;0.0;0.0
1828_8.txt;15;1;0;16;120;0.13;0.01;0.0
8610_10.txt;8;0;0;8;139;0.06;0.0;0.0
318_10.txt;4;0;0;4;142;0.03;0.0;0.0
1167_7.txt;15;0;0;15;386;0.04;0.0;0.0
10720_9.txt;2;0;0;2;124;0.02;0.0;0.0
3892_10.txt;3;0;0;3;140;0.02;0.0;0.0
4885_9.txt;4;0;0;4;211;0.02;0.0;0.0
627_8.txt;2;0;0;2;125;0.02;0.0;0.0
3534_10.txt;16;1;0;17;254;0.06;0.0;0.0
6725_9.txt;2;0;0;2;129;0.02;0.0;0.0
6472_10.txt;4;0;0;4;206;0.02;0.0;0.0
5834_9.txt;38;4;16;58;595;0.06;0.01;0.03
3770_10.txt;6;0;0;6;129;0.05;0.0;0.0
11768_7.txt;8;0;0;8;174;0.05;0.0;0.0
2304_9.txt;1;0;0;1;169;0.01;0.0;0.0
5202_8.txt;8;4;2;14;1047;0.01;0.0;0.0
4507_7.txt;2;0;0;2;162;0.01;0.0;0.0
10871_7.txt;6;0;0;6;194;0.03;0.0;0.0
1287_9.txt;18;3;0;21;458;0.04;0.01;0.0
1879_10.txt;0;0;0;0;237;0.0;0.0;0.0
9956_9.txt;6;0;0;6;853;0.01;0.0;0.0
11010_10.txt;2;0;1;3;214;0.01;0.0;0.0
4847_9.txt;10;1;0;11;255;0.04;0.0;0.0
1768_9.txt;8;0;0;8;214;0.04;0.0;0.0
12346_10.txt;0;1;0;1;140;0.0;0.01;0.0
6887_8.txt;4;0;0;4;129;0.03;0.0;0.0
2111_7.txt;38;8;1;47;621;0.06;0.01;0.0
2926_8.txt;2;0;0;2;68;0.03;0.0;0.0
3258_10.txt;0;0;0;0;75;0.0;0.0;0.0
7148_10.txt;6;3;1;10;170;0.04;0.02;0.01
6442_9.txt;6;0;0;6;131;0.05;0.0;0.0
2676_10.txt;6;0;0;6;196;0.03;0.0;0.0
4033_9.txt;4;6;1;11;205;0.02;0.03;0.0
10550_8.txt;0;2;2;4;307;0.0;0.01;0.01
8022_8.txt;6;10;0;16;136;0.04;0.07;0.0
2287_8.txt;6;0;0;6;81;0.07;0.0;0.0
3008_7.txt;4;0;0;4;150;0.03;0.0;0.0
7428_10.txt;10;0;0;10;169;0.06;0.0;0.0
7425_9.txt;12;0;1;13;220;0.05;0.0;0.0
7405_10.txt;0;0;1;1;68;0.0;0.0;0.01
4950_8.txt;8;1;0;9;507;0.02;0.0;0.0
423_10.txt;4;0;0;4;157;0.03;0.0;0.0
2105_8.txt;7;1;0;8;258;0.03;0.0;0.0
161_8.txt;0;0;0;0;79;0.0;0.0;0.0
10262_10.txt;4;0;0;4;45;0.09;0.0;0.0
9048_8.txt;5;3;2;10;312;0.02;0.01;0.01
2372_8.txt;1;1;0;2;137;0.01;0.01;0.0
5627_10.txt;6;0;0;6;149;0.04;0.0;0.0
7318_10.txt;43;1;0;44;563;0.08;0.0;0.0
7361_10.txt;2;0;0;2;203;0.01;0.0;0.0
4020_10.txt;5;2;0;7;274;0.02;0.01;0.0
3390_8.txt;26;3;2;31;311;0.08;0.01;0.01
9706_10.txt;13;2;4;19;423;0.03;0.0;0.01
8419_9.txt;22;1;2;25;168;0.13;0.01;0.01
1070_8.txt;8;0;0;8;65;0.12;0.0;0.0
3665_9.txt;31;1;3;35;936;0.03;0.0;0.0
350_9.txt;6;0;0;6;190;0.03;0.0;0.0
11751_10.txt;10;2;0;12;102;0.1;0.02;0.0
10805_10.txt;1;0;0;1;52;0.02;0.0;0.0
1645_9.txt;3;1;0;4;94;0.03;0.01;0.0
1478_7.txt;0;2;0;2;120;0.0;0.02;0.0
10408_10.txt;0;0;0;0;102;0.0;0.0;0.0
8418_7.txt;8;4;0;12;228;0.04;0.02;0.0
8921_8.txt;0;0;0;0;169;0.0;0.0;0.0
8996_8.txt;18;1;0;19;689;0.03;0.0;0.0
3766_10.txt;4;1;2;7;441;0.01;0.0;0.0
10328_8.txt;9;0;0;9;222;0.04;0.0;0.0
4153_10.txt;0;0;2;2;148;0.0;0.0;0.01
11734_10.txt;9;5;0;14;340;0.03;0.01;0.0
728_10.txt;6;0;5;11;169;0.04;0.0;0.03
4744_9.txt;4;0;0;4;49;0.08;0.0;0.0
6415_8.txt;4;0;1;5;144;0.03;0.0;0.01
11534_7.txt;0;1;0;1;179;0.0;0.01;0.0
12410_8.txt;0;0;0;0;112;0.0;0.0;0.0
12001_8.txt;5;0;0;5;118;0.04;0.0;0.0
11100_10.txt;7;0;0;7;120;0.06;0.0;0.0
4861_8.txt;19;0;0;19;225;0.08;0.0;0.0
1671_8.txt;35;2;1;38;509;0.07;0.0;0.0
4658_8.txt;23;1;1;25;287;0.08;0.0;0.0
1849_7.txt;4;1;2;7;95;0.04;0.01;0.02
11614_7.txt;7;3;0;10;536;0.01;0.01;0.0
8503_8.txt;33;7;1;41;633;0.05;0.01;0.0
3125_10.txt;7;0;6;13;229;0.03;0.0;0.03
3467_7.txt;12;0;2;14;309;0.04;0.0;0.01
7138_10.txt;8;2;0;10;180;0.04;0.01;0.0
1024_9.txt;53;6;2;61;847;0.06;0.01;0.0
9750_10.txt;2;0;0;2;97;0.02;0.0;0.0
5862_8.txt;0;1;0;1;81;0.0;0.01;0.0
8387_8.txt;11;0;0;11;169;0.07;0.0;0.0
8635_7.txt;1;1;6;8;79;0.01;0.01;0.08
681_9.txt;28;4;1;33;623;0.04;0.01;0.0
103_7.txt;2;2;0;4;111;0.02;0.02;0.0
10870_8.txt;0;4;2;6;160;0.0;0.03;0.01
6352_10.txt;2;0;0;2;66;0.03;0.0;0.0
1105_8.txt;41;4;0;45;396;0.1;0.01;0.0
7393_7.txt;0;0;0;0;86;0.0;0.0;0.0
3541_7.txt;39;3;6;48;361;0.11;0.01;0.02
814_10.txt;12;0;0;12;194;0.06;0.0;0.0
7603_10.txt;0;0;0;0;146;0.0;0.0;0.0
6055_8.txt;0;3;0;3;188;0.0;0.02;0.0
8081_9.txt;0;0;0;0;30;0.0;0.0;0.0
2198_8.txt;22;3;7;32;239;0.09;0.01;0.03
2694_10.txt;4;1;0;5;189;0.02;0.01;0.0
748_9.txt;2;0;0;2;120;0.02;0.0;0.0
198_8.txt;7;0;0;7;172;0.04;0.0;0.0
3403_9.txt;16;2;0;18;321;0.05;0.01;0.0
1031_10.txt;29;7;4;40;535;0.05;0.01;0.01
4235_7.txt;7;0;0;7;100;0.07;0.0;0.0
7751_7.txt;2;0;1;3;177;0.01;0.0;0.01
1069_10.txt;2;0;4;6;197;0.01;0.0;0.02
9317_8.txt;0;0;0;0;188;0.0;0.0;0.0
9783_9.txt;3;1;0;4;390;0.01;0.0;0.0
2118_9.txt;65;4;6;75;1329;0.05;0.0;0.0
11046_8.txt;10;4;4;18;775;0.01;0.01;0.01
10558_10.txt;4;0;0;4;110;0.04;0.0;0.0
1258_9.txt;6;0;0;6;28;0.21;0.0;0.0
5379_7.txt;1;6;1;8;533;0.0;0.01;0.0
9757_8.txt;6;0;0;6;97;0.06;0.0;0.0
5940_7.txt;6;0;0;6;125;0.05;0.0;0.0
9760_8.txt;2;1;1;4;146;0.01;0.01;0.01
3313_10.txt;4;0;0;4;93;0.04;0.0;0.0
11752_10.txt;27;4;6;37;365;0.07;0.01;0.02
6145_8.txt;12;0;0;12;177;0.07;0.0;0.0
1877_7.txt;8;0;0;8;126;0.06;0.0;0.0
4800_7.txt;2;0;0;2;208;0.01;0.0;0.0
11815_10.txt;4;0;0;4;172;0.02;0.0;0.0
2814_10.txt;0;0;0;0;75;0.0;0.0;0.0
4518_9.txt;2;0;0;2;14;0.14;0.0;0.0
6343_10.txt;15;0;0;15;270;0.06;0.0;0.0
7127_10.txt;3;3;0;6;202;0.01;0.01;0.0
3288_10.txt;9;0;0;9;220;0.04;0.0;0.0
1179_9.txt;32;0;2;34;584;0.05;0.0;0.0
10141_9.txt;0;0;0;0;176;0.0;0.0;0.0
6021_7.txt;2;0;2;4;235;0.01;0.0;0.01
3909_10.txt;3;0;0;3;71;0.04;0.0;0.0
12480_10.txt;0;0;0;0;156;0.0;0.0;0.0
8406_10.txt;0;0;1;1;170;0.0;0.0;0.01
9577_8.txt;36;9;4;49;946;0.04;0.01;0.0
4959_7.txt;23;3;1;27;614;0.04;0.0;0.0
6514_10.txt;1;0;0;1;131;0.01;0.0;0.0
6720_9.txt;7;3;0;10;354;0.02;0.01;0.0
12446_8.txt;12;0;0;12;185;0.06;0.0;0.0
2666_10.txt;40;0;6;46;1103;0.04;0.0;0.01
7657_10.txt;2;0;0;2;66;0.03;0.0;0.0
5464_7.txt;6;2;3;11;164;0.04;0.01;0.02
970_10.txt;0;0;1;1;383;0.0;0.0;0.0
9890_8.txt;2;0;2;4;240;0.01;0.0;0.01
8470_8.txt;17;8;0;25;467;0.04;0.02;0.0
2170_9.txt;0;1;0;1;241;0.0;0.0;0.0
9075_10.txt;5;0;0;5;149;0.03;0.0;0.0
1831_10.txt;8;0;0;8;134;0.06;0.0;0.0
1195_8.txt;6;0;1;7;212;0.03;0.0;0.0
1229_8.txt;1;0;0;1;94;0.01;0.0;0.0
10119_7.txt;5;2;0;7;255;0.02;0.01;0.0
7943_10.txt;3;0;0;3;226;0.01;0.0;0.0
4561_10.txt;5;0;0;5;131;0.04;0.0;0.0
8804_10.txt;4;7;0;11;239;0.02;0.03;0.0
5370_7.txt;18;0;3;21;635;0.03;0.0;0.0
6434_7.txt;32;3;1;36;490;0.07;0.01;0.0
10207_10.txt;2;1;0;3;48;0.04;0.02;0.0
6901_10.txt;6;0;0;6;47;0.13;0.0;0.0
3422_10.txt;2;3;2;7;617;0.0;0.0;0.0
440_10.txt;17;0;0;17;132;0.13;0.0;0.0
266_7.txt;2;0;0;2;188;0.01;0.0;0.0
3053_8.txt;14;1;1;16;232;0.06;0.0;0.0
12381_8.txt;2;1;1;4;191;0.01;0.01;0.01
308_8.txt;25;0;3;28;479;0.05;0.0;0.01
2189_10.txt;0;0;0;0;47;0.0;0.0;0.0
4856_10.txt;4;0;0;4;247;0.02;0.0;0.0
7358_10.txt;9;0;0;9;237;0.04;0.0;0.0
4787_10.txt;34;6;0;40;648;0.05;0.01;0.0
7648_7.txt;4;0;0;4;99;0.04;0.0;0.0
2309_9.txt;2;0;0;2;178;0.01;0.0;0.0
11018_10.txt;4;0;0;4;53;0.08;0.0;0.0
5950_10.txt;9;1;0;10;149;0.06;0.01;0.0
1688_9.txt;0;0;0;0;64;0.0;0.0;0.0
10202_10.txt;2;0;0;2;172;0.01;0.0;0.0
434_8.txt;2;0;0;2;208;0.01;0.0;0.0
10547_9.txt;1;0;1;2;159;0.01;0.0;0.01
2884_7.txt;10;0;3;13;460;0.02;0.0;0.01
8323_10.txt;6;0;0;6;89;0.07;0.0;0.0
3049_9.txt;3;2;2;7;457;0.01;0.0;0.0
1210_8.txt;0;0;0;0;99;0.0;0.0;0.0
4468_7.txt;28;0;1;29;321;0.09;0.0;0.0
926_7.txt;0;0;0;0;112;0.0;0.0;0.0
6603_8.txt;0;2;0;2;300;0.0;0.01;0.0
9601_10.txt;9;11;0;20;259;0.03;0.04;0.0
9678_8.txt;5;0;0;5;169;0.03;0.0;0.0
9458_10.txt;0;0;0;0;304;0.0;0.0;0.0
759_10.txt;4;4;0;8;145;0.03;0.03;0.0
4738_7.txt;2;0;0;2;72;0.03;0.0;0.0
1917_9.txt;14;0;0;14;148;0.09;0.0;0.0
1346_9.txt;5;0;4;9;117;0.04;0.0;0.03
3616_7.txt;12;0;0;12;545;0.02;0.0;0.0
6666_7.txt;12;0;1;13;492;0.02;0.0;0.0
3941_9.txt;76;4;2;82;742;0.1;0.01;0.0
8155_7.txt;0;0;1;1;140;0.0;0.0;0.01
3471_8.txt;0;0;0;0;186;0.0;0.0;0.0
2712_10.txt;28;0;4;32;437;0.06;0.0;0.01
3118_9.txt;4;0;3;7;228;0.02;0.0;0.01
2497_8.txt;5;0;1;6;370;0.01;0.0;0.0
724_10.txt;15;0;3;18;399;0.04;0.0;0.01
12012_10.txt;4;12;1;17;209;0.02;0.06;0.0
10108_10.txt;5;1;2;8;195;0.03;0.01;0.01
9427_10.txt;12;3;0;15;1013;0.01;0.0;0.0
4282_10.txt;0;0;0;0;134;0.0;0.0;0.0
5034_7.txt;12;0;1;13;547;0.02;0.0;0.0
11024_9.txt;8;0;0;8;126;0.06;0.0;0.0
4337_7.txt;2;0;0;2;146;0.01;0.0;0.0
1059_10.txt;2;0;0;2;90;0.02;0.0;0.0
1509_10.txt;2;0;0;2;168;0.01;0.0;0.0
3701_10.txt;3;2;0;5;156;0.02;0.01;0.0
9726_7.txt;5;2;2;9;195;0.03;0.01;0.01
5567_7.txt;1;0;0;1;105;0.01;0.0;0.0
9432_9.txt;16;1;3;20;269;0.06;0.0;0.01
8388_7.txt;2;0;0;2;119;0.02;0.0;0.0
6802_9.txt;11;1;0;12;240;0.05;0.0;0.0
5955_10.txt;4;0;0;4;149;0.03;0.0;0.0
10753_10.txt;0;2;1;3;371;0.0;0.01;0.0
5980_10.txt;0;0;1;1;140;0.0;0.0;0.01
9570_8.txt;4;6;0;10;880;0.0;0.01;0.0
8183_7.txt;22;0;1;23;620;0.04;0.0;0.0
92_9.txt;5;0;0;5;121;0.04;0.0;0.0
1670_8.txt;2;0;2;4;229;0.01;0.0;0.01
12122_7.txt;5;1;2;8;153;0.03;0.01;0.01
3929_9.txt;16;1;2;19;514;0.03;0.0;0.0
1571_10.txt;3;0;0;3;133;0.02;0.0;0.0
7878_7.txt;9;1;2;12;157;0.06;0.01;0.01
3348_7.txt;20;0;0;20;494;0.04;0.0;0.0
2415_10.txt;0;0;0;0;155;0.0;0.0;0.0
11727_7.txt;1;0;0;1;55;0.02;0.0;0.0
10169_7.txt;0;0;0;0;159;0.0;0.0;0.0
1153_10.txt;24;0;3;27;674;0.04;0.0;0.0
2094_10.txt;5;7;0;12;238;0.02;0.03;0.0
939_10.txt;21;0;0;21;411;0.05;0.0;0.0
2097_9.txt;25;1;0;26;708;0.04;0.0;0.0
11203_8.txt;25;1;0;26;685;0.04;0.0;0.0
9308_7.txt;6;0;0;6;141;0.04;0.0;0.0
9191_10.txt;13;2;0;15;518;0.03;0.0;0.0
1641_10.txt;0;0;1;1;244;0.0;0.0;0.0
5977_8.txt;5;0;1;6;141;0.04;0.0;0.01
11529_7.txt;17;1;1;19;398;0.04;0.0;0.0
7156_10.txt;0;0;5;5;220;0.0;0.0;0.02
1058_10.txt;2;0;0;2;47;0.04;0.0;0.0
9779_9.txt;0;0;0;0;279;0.0;0.0;0.0
10491_7.txt;0;0;0;0;103;0.0;0.0;0.0
4574_10.txt;8;0;0;8;151;0.05;0.0;0.0
1321_10.txt;40;7;9;56;1130;0.04;0.01;0.01
5727_9.txt;23;4;0;27;957;0.02;0.0;0.0
3983_10.txt;14;1;1;16;175;0.08;0.01;0.01
2525_8.txt;5;1;5;11;303;0.02;0.0;0.02
361_10.txt;2;1;0;3;226;0.01;0.0;0.0
4909_8.txt;0;2;0;2;140;0.0;0.01;0.0
12352_8.txt;0;2;0;2;95;0.0;0.02;0.0
9894_8.txt;4;0;0;4;209;0.02;0.0;0.0
9416_10.txt;24;0;7;31;638;0.04;0.0;0.01
1862_8.txt;58;7;7;72;949;0.06;0.01;0.01
11465_7.txt;0;0;0;0;67;0.0;0.0;0.0
368_10.txt;8;0;0;8;75;0.11;0.0;0.0
5721_10.txt;2;0;0;2;258;0.01;0.0;0.0
4473_8.txt;81;6;4;91;1135;0.07;0.01;0.0
9554_8.txt;3;0;0;3;213;0.01;0.0;0.0
4203_8.txt;18;1;1;20;348;0.05;0.0;0.0
2943_10.txt;8;0;0;8;153;0.05;0.0;0.0
6258_8.txt;1;5;0;6;274;0.0;0.02;0.0
142_8.txt;17;0;0;17;170;0.1;0.0;0.0
6831_9.txt;8;4;0;12;281;0.03;0.01;0.0
8916_8.txt;0;0;0;0;190;0.0;0.0;0.0
6995_7.txt;7;0;0;7;251;0.03;0.0;0.0
6850_7.txt;40;2;0;42;673;0.06;0.0;0.0
11991_10.txt;18;0;0;18;750;0.02;0.0;0.0
6060_10.txt;5;0;0;5;71;0.07;0.0;0.0
9508_8.txt;8;3;0;11;230;0.03;0.01;0.0
11760_8.txt;6;0;0;6;51;0.12;0.0;0.0
11252_9.txt;6;1;7;14;542;0.01;0.0;0.01
7809_10.txt;4;1;0;5;162;0.02;0.01;0.0
11276_10.txt;36;2;0;38;985;0.04;0.0;0.0
10965_9.txt;9;0;0;9;301;0.03;0.0;0.0
5227_10.txt;1;0;0;1;150;0.01;0.0;0.0
3501_9.txt;4;7;0;11;111;0.04;0.06;0.0
2586_10.txt;2;0;0;2;172;0.01;0.0;0.0
7401_9.txt;0;0;0;0;94;0.0;0.0;0.0
1749_10.txt;7;0;0;7;257;0.03;0.0;0.0
3420_10.txt;3;2;1;6;133;0.02;0.02;0.01
3116_10.txt;14;1;0;15;300;0.05;0.0;0.0
11152_10.txt;4;0;0;4;169;0.02;0.0;0.0
3975_10.txt;0;0;0;0;143;0.0;0.0;0.0
3375_9.txt;0;0;0;0;172;0.0;0.0;0.0
858_8.txt;9;0;0;9;302;0.03;0.0;0.0
735_8.txt;32;0;10;42;379;0.08;0.0;0.03
6910_9.txt;2;0;0;2;150;0.01;0.0;0.0
9473_10.txt;0;0;0;0;186;0.0;0.0;0.0
3895_8.txt;6;0;0;6;134;0.04;0.0;0.0
11867_8.txt;43;3;0;46;671;0.06;0.0;0.0
9290_9.txt;18;8;0;26;627;0.03;0.01;0.0
7096_10.txt;4;1;0;5;328;0.01;0.0;0.0
11173_7.txt;4;0;0;4;158;0.03;0.0;0.0
2653_10.txt;16;1;0;17;339;0.05;0.0;0.0
7251_10.txt;0;0;0;0;82;0.0;0.0;0.0
12079_7.txt;9;0;2;11;297;0.03;0.0;0.01
2072_10.txt;7;0;0;7;114;0.06;0.0;0.0
10179_9.txt;18;0;0;18;177;0.1;0.0;0.0
1826_10.txt;4;0;0;4;170;0.02;0.0;0.0
1795_8.txt;48;0;2;50;803;0.06;0.0;0.0
7159_10.txt;13;4;3;20;199;0.07;0.02;0.02
4993_10.txt;6;0;0;6;146;0.04;0.0;0.0
12189_7.txt;43;29;0;72;1156;0.04;0.03;0.0
4113_7.txt;9;0;0;9;547;0.02;0.0;0.0
3508_8.txt;2;0;0;2;226;0.01;0.0;0.0
5709_10.txt;0;0;0;0;213;0.0;0.0;0.0
9883_8.txt;10;0;3;13;187;0.05;0.0;0.02
8205_8.txt;43;4;2;49;614;0.07;0.01;0.0
4748_7.txt;0;0;0;0;87;0.0;0.0;0.0
4851_7.txt;2;0;0;2;101;0.02;0.0;0.0
3166_9.txt;11;4;0;15;269;0.04;0.01;0.0
3679_7.txt;0;3;4;7;202;0.0;0.01;0.02
5964_8.txt;22;2;3;27;488;0.05;0.0;0.01
10191_10.txt;2;0;0;2;168;0.01;0.0;0.0
598_9.txt;0;5;0;5;163;0.0;0.03;0.0
11919_7.txt;0;0;0;0;39;0.0;0.0;0.0
11708_8.txt;0;0;0;0;163;0.0;0.0;0.0
2812_8.txt;2;0;0;2;197;0.01;0.0;0.0
8940_9.txt;7;0;3;10;260;0.03;0.0;0.01
12393_8.txt;0;0;0;0;276;0.0;0.0;0.0
5597_10.txt;8;1;0;9;220;0.04;0.0;0.0
3243_8.txt;0;0;0;0;201;0.0;0.0;0.0
8083_7.txt;1;0;1;2;106;0.01;0.0;0.01
11483_10.txt;5;0;0;5;156;0.03;0.0;0.0
11794_7.txt;2;2;3;7;155;0.01;0.01;0.02
6059_10.txt;0;0;0;0;85;0.0;0.0;0.0
11662_9.txt;14;0;0;14;228;0.06;0.0;0.0
7660_10.txt;4;0;0;4;176;0.02;0.0;0.0
10937_9.txt;4;2;3;9;408;0.01;0.0;0.01
5217_8.txt;4;0;0;4;120;0.03;0.0;0.0
2555_10.txt;5;0;0;5;108;0.05;0.0;0.0
3177_9.txt;5;0;0;5;165;0.03;0.0;0.0
6800_9.txt;9;0;0;9;164;0.05;0.0;0.0
1431_10.txt;0;0;0;0;198;0.0;0.0;0.0
8951_7.txt;49;7;6;62;807;0.06;0.01;0.01
692_8.txt;5;0;0;5;171;0.03;0.0;0.0
3421_10.txt;3;1;1;5;143;0.02;0.01;0.01
9864_8.txt;11;4;0;15;293;0.04;0.01;0.0
4638_10.txt;0;3;0;3;124;0.0;0.02;0.0
4271_10.txt;0;0;0;0;165;0.0;0.0;0.0
2070_9.txt;15;1;1;17;196;0.08;0.01;0.01
650_9.txt;3;0;0;3;234;0.01;0.0;0.0
2719_10.txt;24;5;0;29;569;0.04;0.01;0.0
4008_9.txt;6;0;0;6;492;0.01;0.0;0.0
9151_10.txt;2;2;2;6;124;0.02;0.02;0.02
7818_9.txt;0;0;0;0;166;0.0;0.0;0.0
4050_9.txt;6;0;0;6;356;0.02;0.0;0.0
1717_8.txt;27;2;0;29;528;0.05;0.0;0.0
1704_8.txt;0;1;2;3;163;0.0;0.01;0.01
3074_8.txt;24;0;0;24;376;0.06;0.0;0.0
5832_9.txt;10;0;0;10;164;0.06;0.0;0.0
7721_7.txt;12;0;6;18;575;0.02;0.0;0.01
3461_9.txt;12;0;1;13;196;0.06;0.0;0.01
11331_8.txt;7;1;0;8;437;0.02;0.0;0.0
8226_8.txt;0;1;0;1;112;0.0;0.01;0.0
5211_8.txt;6;1;14;21;378;0.02;0.0;0.04
3776_10.txt;2;0;0;2;50;0.04;0.0;0.0
12213_10.txt;0;0;0;0;48;0.0;0.0;0.0
42_10.txt;4;0;0;4;72;0.06;0.0;0.0
10346_9.txt;10;1;3;14;213;0.05;0.0;0.01
6909_9.txt;17;1;1;19;222;0.08;0.0;0.0
459_10.txt;0;0;1;1;169;0.0;0.0;0.01
1350_9.txt;34;10;2;46;478;0.07;0.02;0.0
5503_10.txt;7;5;0;12;256;0.03;0.02;0.0
11622_10.txt;24;1;2;27;407;0.06;0.0;0.0
8058_8.txt;1;1;1;3;507;0.0;0.0;0.0
12328_10.txt;2;0;0;2;88;0.02;0.0;0.0
684_10.txt;2;0;2;4;220;0.01;0.0;0.01
11898_8.txt;1;0;3;4;185;0.01;0.0;0.02
11750_10.txt;4;3;6;13;130;0.03;0.02;0.05
11930_10.txt;15;0;0;15;135;0.11;0.0;0.0
4069_10.txt;7;1;0;8;549;0.01;0.0;0.0
2967_9.txt;2;0;0;2;53;0.04;0.0;0.0
11366_8.txt;20;1;2;23;274;0.07;0.0;0.01
8300_10.txt;7;1;0;8;295;0.02;0.0;0.0
3414_8.txt;5;1;0;6;244;0.02;0.0;0.0
9488_10.txt;6;1;1;8;192;0.03;0.01;0.01
12260_10.txt;5;0;0;5;89;0.06;0.0;0.0
3671_7.txt;8;8;0;16;235;0.03;0.03;0.0
2260_10.txt;2;0;0;2;86;0.02;0.0;0.0
11738_9.txt;35;5;3;43;417;0.08;0.01;0.01
9988_8.txt;7;0;0;7;171;0.04;0.0;0.0
1093_8.txt;2;0;0;2;77;0.03;0.0;0.0
5053_8.txt;0;0;2;2;197;0.0;0.0;0.01
6944_9.txt;30;1;3;34;366;0.08;0.0;0.01
11915_10.txt;32;0;1;33;279;0.11;0.0;0.0
5741_10.txt;7;2;0;9;147;0.05;0.01;0.0
3376_9.txt;2;0;0;2;146;0.01;0.0;0.0
3659_9.txt;2;0;0;2;228;0.01;0.0;0.0
381_10.txt;1;0;0;1;141;0.01;0.0;0.0
7984_10.txt;7;1;0;8;352;0.02;0.0;0.0
2435_8.txt;1;1;0;2;187;0.01;0.01;0.0
9502_8.txt;0;0;0;0;63;0.0;0.0;0.0
3916_8.txt;0;0;1;1;56;0.0;0.0;0.02
9058_7.txt;5;0;0;5;125;0.04;0.0;0.0
3588_8.txt;5;0;0;5;152;0.03;0.0;0.0
3204_10.txt;2;0;0;2;52;0.04;0.0;0.0
9758_10.txt;0;0;0;0;188;0.0;0.0;0.0
908_8.txt;6;0;0;6;283;0.02;0.0;0.0
12059_9.txt;0;3;0;3;359;0.0;0.01;0.0
11607_10.txt;0;2;0;2;143;0.0;0.01;0.0
458_10.txt;1;0;0;1;177;0.01;0.0;0.0
7095_9.txt;21;2;0;23;166;0.13;0.01;0.0
9701_10.txt;4;4;1;9;737;0.01;0.01;0.0
11332_8.txt;0;0;0;0;183;0.0;0.0;0.0
181_10.txt;12;0;0;12;293;0.04;0.0;0.0
10984_10.txt;30;4;1;35;531;0.06;0.01;0.0
406_8.txt;0;0;0;0;67;0.0;0.0;0.0
11335_9.txt;4;0;0;4;178;0.02;0.0;0.0
11937_8.txt;2;1;1;4;146;0.01;0.01;0.01
7432_10.txt;24;7;1;32;839;0.03;0.01;0.0
5171_10.txt;5;1;0;6;230;0.02;0.0;0.0
6299_8.txt;5;1;0;6;103;0.05;0.01;0.0
11718_10.txt;10;2;0;12;163;0.06;0.01;0.0
1867_9.txt;4;1;0;5;244;0.02;0.0;0.0
6616_7.txt;0;0;0;0;232;0.0;0.0;0.0
6161_9.txt;12;1;1;14;259;0.05;0.0;0.0
7504_7.txt;1;0;0;1;166;0.01;0.0;0.0
1816_9.txt;0;0;0;0;169;0.0;0.0;0.0
8946_8.txt;8;0;0;8;131;0.06;0.0;0.0
1761_9.txt;34;6;2;42;731;0.05;0.01;0.0
7254_10.txt;0;0;0;0;51;0.0;0.0;0.0
1981_9.txt;16;5;0;21;673;0.02;0.01;0.0
5724_10.txt;0;0;0;0;159;0.0;0.0;0.0
7575_10.txt;5;0;0;5;212;0.02;0.0;0.0
12128_8.txt;10;0;0;10;412;0.02;0.0;0.0
7200_9.txt;4;0;0;4;145;0.03;0.0;0.0
8590_7.txt;8;0;2;10;134;0.06;0.0;0.01
6762_9.txt;23;0;0;23;491;0.05;0.0;0.0
11177_8.txt;2;0;0;2;332;0.01;0.0;0.0
8449_9.txt;3;1;0;4;208;0.01;0.0;0.0
800_9.txt;0;0;1;1;199;0.0;0.0;0.01
3051_9.txt;7;0;0;7;56;0.13;0.0;0.0
200_10.txt;66;4;4;74;303;0.22;0.01;0.01
8446_10.txt;0;1;0;1;58;0.0;0.02;0.0
10029_10.txt;6;0;0;6;178;0.03;0.0;0.0
6767_8.txt;7;4;2;13;404;0.02;0.01;0.0
3230_8.txt;11;1;0;12;292;0.04;0.0;0.0
11220_10.txt;29;1;2;32;402;0.07;0.0;0.0
5354_10.txt;5;0;2;7;162;0.03;0.0;0.01
6963_8.txt;5;0;0;5;265;0.02;0.0;0.0
10232_10.txt;2;2;0;4;133;0.02;0.02;0.0
8328_10.txt;2;0;0;2;53;0.04;0.0;0.0
11229_10.txt;0;0;0;0;149;0.0;0.0;0.0
8389_8.txt;9;2;0;11;165;0.05;0.01;0.0
4089_8.txt;0;0;4;4;104;0.0;0.0;0.04
12166_10.txt;1;0;0;1;143;0.01;0.0;0.0
1289_7.txt;0;0;2;2;264;0.0;0.0;0.01
12223_10.txt;19;1;0;20;224;0.08;0.0;0.0
3295_10.txt;2;0;0;2;75;0.03;0.0;0.0
7074_7.txt;9;1;0;10;131;0.07;0.01;0.0
9950_8.txt;3;2;0;5;61;0.05;0.03;0.0
5661_10.txt;2;0;1;3;176;0.01;0.0;0.01
9267_7.txt;1;2;0;3;163;0.01;0.01;0.0
3952_10.txt;0;0;0;0;126;0.0;0.0;0.0
3869_9.txt;3;5;0;8;275;0.01;0.02;0.0
12052_9.txt;0;0;0;0;139;0.0;0.0;0.0
10242_8.txt;4;1;0;5;469;0.01;0.0;0.0
7853_9.txt;14;0;6;20;457;0.03;0.0;0.01
12309_10.txt;0;2;0;2;51;0.0;0.04;0.0
11590_10.txt;1;0;2;3;166;0.01;0.0;0.01
1050_9.txt;0;3;0;3;140;0.0;0.02;0.0
8369_8.txt;0;0;0;0;290;0.0;0.0;0.0
11231_10.txt;0;0;6;6;143;0.0;0.0;0.04
9725_7.txt;28;2;3;33;331;0.08;0.01;0.01
12257_8.txt;3;2;0;5;94;0.03;0.02;0.0
4996_9.txt;7;0;0;7;214;0.03;0.0;0.0
130_9.txt;29;4;0;33;324;0.09;0.01;0.0
9381_8.txt;7;2;0;9;139;0.05;0.01;0.0
7260_10.txt;7;0;0;7;380;0.02;0.0;0.0
3357_9.txt;5;1;2;8;187;0.03;0.01;0.01
3092_10.txt;9;0;0;9;169;0.05;0.0;0.0
1508_7.txt;4;0;0;4;362;0.01;0.0;0.0
9765_10.txt;1;0;1;2;201;0.0;0.0;0.0
11692_7.txt;12;0;0;12;148;0.08;0.0;0.0
5361_10.txt;3;0;0;3;247;0.01;0.0;0.0
8841_8.txt;11;0;0;11;117;0.09;0.0;0.0
7093_10.txt;11;0;0;11;316;0.03;0.0;0.0
727_9.txt;0;0;1;1;183;0.0;0.0;0.01
7854_10.txt;0;0;0;0;52;0.0;0.0;0.0
12205_8.txt;28;10;4;42;776;0.04;0.01;0.01
8695_9.txt;3;0;0;3;67;0.04;0.0;0.0
5108_10.txt;28;1;0;29;346;0.08;0.0;0.0
10918_8.txt;1;0;2;3;68;0.01;0.0;0.03
3708_7.txt;9;0;0;9;127;0.07;0.0;0.0
9288_8.txt;4;1;0;5;447;0.01;0.0;0.0
5020_10.txt;6;0;1;7;188;0.03;0.0;0.01
7130_10.txt;1;0;0;1;172;0.01;0.0;0.0
1668_8.txt;3;0;0;3;116;0.03;0.0;0.0
1331_7.txt;4;2;0;6;503;0.01;0.0;0.0
10599_8.txt;9;8;4;21;278;0.03;0.03;0.01
3368_8.txt;13;1;0;14;303;0.04;0.0;0.0
11887_8.txt;26;2;0;28;357;0.07;0.01;0.0
7573_9.txt;0;0;0;0;77;0.0;0.0;0.0
3720_10.txt;3;0;0;3;192;0.02;0.0;0.0
5883_10.txt;0;0;0;0;153;0.0;0.0;0.0
4624_8.txt;3;0;0;3;526;0.01;0.0;0.0
7039_7.txt;26;2;0;28;388;0.07;0.01;0.0
6808_8.txt;6;1;0;7;158;0.04;0.01;0.0
5621_10.txt;10;0;0;10;186;0.05;0.0;0.0
5068_9.txt;6;4;2;12;224;0.03;0.02;0.01
9915_8.txt;0;4;0;4;140;0.0;0.03;0.0
8501_8.txt;0;0;0;0;98;0.0;0.0;0.0
11165_8.txt;11;0;0;11;148;0.07;0.0;0.0
9114_10.txt;3;0;3;6;258;0.01;0.0;0.01
7685_10.txt;8;1;0;9;115;0.07;0.01;0.0
7800_8.txt;0;0;0;0;139;0.0;0.0;0.0
6566_8.txt;3;0;2;5;112;0.03;0.0;0.02
10492_10.txt;9;0;0;9;135;0.07;0.0;0.0
10638_8.txt;0;0;0;0;110;0.0;0.0;0.0
5581_7.txt;9;0;0;9;213;0.04;0.0;0.0
11123_10.txt;3;0;0;3;179;0.02;0.0;0.0
6056_9.txt;0;0;2;2;128;0.0;0.0;0.02
1122_7.txt;0;4;0;4;125;0.0;0.03;0.0
10395_8.txt;20;5;0;25;279;0.07;0.02;0.0
9192_7.txt;20;0;0;20;392;0.05;0.0;0.0
6167_7.txt;1;1;0;2;88;0.01;0.01;0.0
9201_8.txt;6;0;0;6;176;0.03;0.0;0.0
10495_7.txt;2;1;0;3;197;0.01;0.01;0.0
1964_7.txt;8;0;0;8;182;0.04;0.0;0.0
3994_8.txt;0;0;0;0;139;0.0;0.0;0.0
12339_10.txt;3;0;0;3;140;0.02;0.0;0.0
1443_8.txt;8;10;9;27;632;0.01;0.02;0.01
8639_9.txt;4;0;0;4;164;0.02;0.0;0.0
6320_10.txt;2;0;0;2;165;0.01;0.0;0.0
360_10.txt;15;8;0;23;271;0.06;0.03;0.0
11234_10.txt;0;0;0;0;130;0.0;0.0;0.0
7383_9.txt;15;4;0;19;262;0.06;0.02;0.0
9854_7.txt;0;0;0;0;62;0.0;0.0;0.0
10598_8.txt;0;1;0;1;51;0.0;0.02;0.0
11860_10.txt;26;1;0;27;231;0.11;0.0;0.0
7305_10.txt;12;0;0;12;301;0.04;0.0;0.0
7644_7.txt;11;0;0;11;199;0.06;0.0;0.0
11960_8.txt;59;5;0;64;940;0.06;0.01;0.0
309_9.txt;4;0;0;4;73;0.05;0.0;0.0
2339_8.txt;4;0;1;5;181;0.02;0.0;0.01
2355_7.txt;0;0;0;0;189;0.0;0.0;0.0
5612_8.txt;21;2;0;23;199;0.11;0.01;0.0
10741_10.txt;2;0;0;2;165;0.01;0.0;0.0
8548_10.txt;0;0;0;0;106;0.0;0.0;0.0
4498_8.txt;13;0;1;14;176;0.07;0.0;0.01
4202_10.txt;34;0;0;34;640;0.05;0.0;0.0
1386_8.txt;4;0;0;4;363;0.01;0.0;0.0
1718_7.txt;8;0;0;8;422;0.02;0.0;0.0
3450_7.txt;4;0;0;4;212;0.02;0.0;0.0
11878_10.txt;38;1;2;41;889;0.04;0.0;0.0
7098_9.txt;4;0;0;4;202;0.02;0.0;0.0
7058_8.txt;0;0;3;3;113;0.0;0.0;0.03
10892_7.txt;4;0;0;4;156;0.03;0.0;0.0
9167_7.txt;6;3;1;10;133;0.05;0.02;0.01
7922_7.txt;15;2;0;17;256;0.06;0.01;0.0
3106_8.txt;12;0;5;17;325;0.04;0.0;0.02
4978_7.txt;0;0;0;0;164;0.0;0.0;0.0
9121_10.txt;10;1;1;12;394;0.03;0.0;0.0
7466_10.txt;0;0;0;0;74;0.0;0.0;0.0
5347_7.txt;10;2;0;12;175;0.06;0.01;0.0
3393_9.txt;18;9;6;33;419;0.04;0.02;0.01
10204_8.txt;2;0;0;2;172;0.01;0.0;0.0
1474_8.txt;16;0;2;18;367;0.04;0.0;0.01
1432_7.txt;5;4;0;9;279;0.02;0.01;0.0
985_7.txt;16;0;0;16;207;0.08;0.0;0.0
10171_7.txt;5;2;0;7;252;0.02;0.01;0.0
4385_9.txt;8;0;0;8;107;0.07;0.0;0.0
491_7.txt;1;0;0;1;157;0.01;0.0;0.0
4669_10.txt;7;0;0;7;196;0.04;0.0;0.0
123_10.txt;24;6;3;33;649;0.04;0.01;0.0
6464_9.txt;0;0;0;0;135;0.0;0.0;0.0
6008_7.txt;20;3;3;26;402;0.05;0.01;0.01
8117_8.txt;6;2;3;11;139;0.04;0.01;0.02
3540_8.txt;2;0;0;2;161;0.01;0.0;0.0
10709_10.txt;16;1;6;23;490;0.03;0.0;0.01
4656_8.txt;23;2;0;25;139;0.17;0.01;0.0
4667_10.txt;31;4;2;37;337;0.09;0.01;0.01
8536_9.txt;0;0;0;0;153;0.0;0.0;0.0
2550_9.txt;4;1;0;5;128;0.03;0.01;0.0
5198_7.txt;1;0;0;1;152;0.01;0.0;0.0
11676_8.txt;4;1;2;7;222;0.02;0.0;0.01
8640_10.txt;8;0;2;10;197;0.04;0.0;0.01
86_10.txt;1;2;0;3;144;0.01;0.01;0.0
5777_8.txt;0;2;0;2;127;0.0;0.02;0.0
9429_9.txt;0;0;0;0;171;0.0;0.0;0.0
2507_7.txt;6;2;0;8;512;0.01;0.0;0.0
7488_7.txt;27;0;0;27;404;0.07;0.0;0.0
2609_10.txt;0;3;1;4;184;0.0;0.02;0.01
717_7.txt;3;0;1;4;140;0.02;0.0;0.01
10382_10.txt;0;0;0;0;159;0.0;0.0;0.0
3113_9.txt;23;0;6;29;658;0.03;0.0;0.01
7263_10.txt;2;0;0;2;49;0.04;0.0;0.0
12361_7.txt;11;1;0;12;713;0.02;0.0;0.0
3003_9.txt;11;0;0;11;77;0.14;0.0;0.0
6747_8.txt;45;0;3;48;628;0.07;0.0;0.0
5451_8.txt;19;4;7;30;687;0.03;0.01;0.01
166_7.txt;11;0;0;11;150;0.07;0.0;0.0
5007_10.txt;0;0;0;0;59;0.0;0.0;0.0
880_10.txt;18;0;0;18;325;0.06;0.0;0.0
7091_9.txt;9;0;0;9;210;0.04;0.0;0.0
3947_7.txt;4;0;0;4;121;0.03;0.0;0.0
12343_7.txt;3;1;0;4;196;0.02;0.01;0.0
2455_8.txt;1;6;0;7;174;0.01;0.03;0.0
3174_9.txt;3;0;0;3;146;0.02;0.0;0.0
3603_7.txt;0;2;0;2;246;0.0;0.01;0.0
4185_8.txt;1;0;0;1;140;0.01;0.0;0.0
8246_9.txt;22;3;3;28;653;0.03;0.0;0.0
8415_7.txt;1;1;0;2;175;0.01;0.01;0.0
6039_10.txt;7;2;0;9;175;0.04;0.01;0.0
3233_10.txt;2;2;0;4;95;0.02;0.02;0.0
9199_8.txt;5;0;0;5;276;0.02;0.0;0.0
320_8.txt;34;5;2;41;1008;0.03;0.0;0.0
9120_10.txt;0;0;0;0;149;0.0;0.0;0.0
515_10.txt;0;2;0;2;210;0.0;0.01;0.0
6438_10.txt;3;0;0;3;225;0.01;0.0;0.0
2803_10.txt;1;0;0;1;123;0.01;0.0;0.0
12441_9.txt;6;0;0;6;201;0.03;0.0;0.0
2765_9.txt;21;3;0;24;281;0.07;0.01;0.0
1171_10.txt;5;0;0;5;134;0.04;0.0;0.0
5430_10.txt;1;2;0;3;219;0.0;0.01;0.0
11932_7.txt;2;0;0;2;153;0.01;0.0;0.0
3358_9.txt;4;0;0;4;178;0.02;0.0;0.0
1745_7.txt;9;3;1;13;323;0.03;0.01;0.0
1140_10.txt;14;0;0;14;137;0.1;0.0;0.0
11557_8.txt;6;0;0;6;121;0.05;0.0;0.0
1818_8.txt;11;2;5;18;330;0.03;0.01;0.02
7137_8.txt;2;1;3;6;201;0.01;0.0;0.01
6229_7.txt;8;2;0;10;229;0.03;0.01;0.0
12293_10.txt;0;0;0;0;119;0.0;0.0;0.0
11334_10.txt;0;0;0;0;102;0.0;0.0;0.0
5137_10.txt;4;0;0;4;124;0.03;0.0;0.0
817_10.txt;37;3;7;47;1443;0.03;0.0;0.0
6213_7.txt;1;0;0;1;52;0.02;0.0;0.0
5095_7.txt;16;6;1;23;278;0.06;0.02;0.0
10163_8.txt;2;0;0;2;138;0.01;0.0;0.0
8928_10.txt;35;7;0;42;855;0.04;0.01;0.0
8186_10.txt;12;0;0;12;213;0.06;0.0;0.0
3101_9.txt;19;0;3;22;627;0.03;0.0;0.0
6814_7.txt;7;5;0;12;607;0.01;0.01;0.0
644_9.txt;6;0;0;6;228;0.03;0.0;0.0
2859_10.txt;1;2;0;3;147;0.01;0.01;0.0
6840_10.txt;0;0;0;0;147;0.0;0.0;0.0
6779_8.txt;22;0;0;22;183;0.12;0.0;0.0
9159_10.txt;15;5;1;21;537;0.03;0.01;0.0
9913_10.txt;0;0;0;0;147;0.0;0.0;0.0
2722_8.txt;6;1;0;7;121;0.05;0.01;0.0
9481_9.txt;6;0;0;6;78;0.08;0.0;0.0
6902_7.txt;20;12;1;33;432;0.05;0.03;0.0
10431_10.txt;0;0;0;0;173;0.0;0.0;0.0
1952_8.txt;4;1;0;5;132;0.03;0.01;0.0
10919_10.txt;12;2;0;14;139;0.09;0.01;0.0
12071_8.txt;13;2;0;15;375;0.03;0.01;0.0
8691_7.txt;11;0;2;13;217;0.05;0.0;0.01
3687_7.txt;38;0;2;40;283;0.13;0.0;0.01
10474_9.txt;2;0;0;2;242;0.01;0.0;0.0
2303_8.txt;14;2;0;16;185;0.08;0.01;0.0
10900_8.txt;11;0;0;11;224;0.05;0.0;0.0
5594_10.txt;28;0;3;31;686;0.04;0.0;0.0
11540_10.txt;17;3;0;20;262;0.06;0.01;0.0
1994_10.txt;63;3;0;66;1170;0.05;0.0;0.0
8584_8.txt;1;0;0;1;57;0.02;0.0;0.0
9845_8.txt;2;0;0;2;142;0.01;0.0;0.0
5956_9.txt;4;0;0;4;285;0.01;0.0;0.0
5586_8.txt;10;2;0;12;378;0.03;0.01;0.0
7642_9.txt;18;0;0;18;210;0.09;0.0;0.0
1124_10.txt;0;0;0;0;131;0.0;0.0;0.0
7599_10.txt;0;0;0;0;170;0.0;0.0;0.0
101_8.txt;0;0;0;0;142;0.0;0.0;0.0
8125_7.txt;10;2;0;12;359;0.03;0.01;0.0
12269_8.txt;27;1;0;28;236;0.11;0.0;0.0
4935_7.txt;22;3;4;29;228;0.1;0.01;0.02
9545_7.txt;3;1;0;4;324;0.01;0.0;0.0
928_10.txt;0;0;1;1;281;0.0;0.0;0.0
2405_10.txt;5;0;0;5;380;0.01;0.0;0.0
10739_10.txt;0;0;0;0;167;0.0;0.0;0.0
7355_10.txt;2;0;0;2;139;0.01;0.0;0.0
2206_7.txt;2;0;0;2;226;0.01;0.0;0.0
11989_10.txt;14;2;6;22;447;0.03;0.0;0.01
4375_9.txt;14;0;0;14;215;0.07;0.0;0.0
8787_8.txt;5;2;0;7;177;0.03;0.01;0.0
11388_8.txt;32;1;1;34;508;0.06;0.0;0.0
5126_7.txt;21;5;13;39;409;0.05;0.01;0.03
12371_8.txt;42;0;0;42;455;0.09;0.0;0.0
1591_10.txt;4;0;0;4;155;0.03;0.0;0.0
3569_8.txt;10;0;0;10;89;0.11;0.0;0.0
6676_9.txt;29;5;4;38;1107;0.03;0.0;0.0
1404_10.txt;24;0;0;24;349;0.07;0.0;0.0
11775_10.txt;6;0;0;6;143;0.04;0.0;0.0
9696_8.txt;2;0;0;2;111;0.02;0.0;0.0
10453_10.txt;14;8;0;22;222;0.06;0.04;0.0
2333_10.txt;1;0;0;1;182;0.01;0.0;0.0
2471_10.txt;7;0;1;8;194;0.04;0.0;0.01
8672_8.txt;57;2;0;59;359;0.16;0.01;0.0
12421_10.txt;2;0;0;2;41;0.05;0.0;0.0
2328_10.txt;8;1;1;10;214;0.04;0.0;0.0
5927_9.txt;10;1;0;11;291;0.03;0.0;0.0
3840_10.txt;12;0;0;12;138;0.09;0.0;0.0
2236_9.txt;0;0;2;2;125;0.0;0.0;0.02
8288_7.txt;0;3;0;3;68;0.0;0.04;0.0
9646_7.txt;2;0;0;2;150;0.01;0.0;0.0
8511_10.txt;8;4;0;12;171;0.05;0.02;0.0
9108_10.txt;6;7;0;13;231;0.03;0.03;0.0
8982_8.txt;2;1;0;3;141;0.01;0.01;0.0
896_10.txt;19;2;0;21;1050;0.02;0.0;0.0
6737_7.txt;34;0;1;35;319;0.11;0.0;0.0
9628_8.txt;5;0;0;5;262;0.02;0.0;0.0
1687_10.txt;2;0;0;2;64;0.03;0.0;0.0
4005_10.txt;0;1;0;1;149;0.0;0.01;0.0
6487_10.txt;0;0;0;0;65;0.0;0.0;0.0
6214_7.txt;22;1;6;29;450;0.05;0.0;0.01
8577_8.txt;9;0;0;9;63;0.14;0.0;0.0
11587_10.txt;0;0;0;0;173;0.0;0.0;0.0
4972_9.txt;10;2;4;16;338;0.03;0.01;0.01
5045_8.txt;2;0;0;2;278;0.01;0.0;0.0
7277_7.txt;0;0;0;0;369;0.0;0.0;0.0
7057_9.txt;1;1;0;2;76;0.01;0.01;0.0
6707_9.txt;7;1;0;8;256;0.03;0.0;0.0
2431_8.txt;7;0;0;7;184;0.04;0.0;0.0
10774_8.txt;1;0;0;1;64;0.02;0.0;0.0
4083_10.txt;0;0;0;0;62;0.0;0.0;0.0
3623_8.txt;1;1;1;3;124;0.01;0.01;0.01
1418_9.txt;0;0;1;1;192;0.0;0.0;0.01
4310_9.txt;24;4;0;28;516;0.05;0.01;0.0
4653_10.txt;6;3;0;9;157;0.04;0.02;0.0
8336_10.txt;11;4;8;23;104;0.11;0.04;0.08
9630_10.txt;12;0;0;12;154;0.08;0.0;0.0
2487_10.txt;5;1;1;7;215;0.02;0.0;0.0
8036_8.txt;8;1;0;9;306;0.03;0.0;0.0
6797_8.txt;2;0;2;4;118;0.02;0.0;0.02
2288_9.txt;11;0;1;12;228;0.05;0.0;0.0
11325_10.txt;3;1;0;4;184;0.02;0.01;0.0
2734_9.txt;23;3;0;26;662;0.03;0.0;0.0
1993_10.txt;4;0;0;4;282;0.01;0.0;0.0
2250_8.txt;19;5;0;24;382;0.05;0.01;0.0
4479_8.txt;15;3;1;19;310;0.05;0.01;0.0
11147_9.txt;37;5;2;44;583;0.06;0.01;0.0
10043_10.txt;0;0;0;0;98;0.0;0.0;0.0
7990_7.txt;23;3;0;26;785;0.03;0.0;0.0
12291_10.txt;0;1;0;1;83;0.0;0.01;0.0
1505_9.txt;44;0;0;44;879;0.05;0.0;0.0
11185_9.txt;4;0;0;4;193;0.02;0.0;0.0
4379_8.txt;0;0;0;0;64;0.0;0.0;0.0
2307_9.txt;10;0;1;11;196;0.05;0.0;0.01
12036_7.txt;3;3;0;6;183;0.02;0.02;0.0
11668_7.txt;28;8;3;39;695;0.04;0.01;0.0
4488_10.txt;18;0;3;21;277;0.06;0.0;0.01
8556_7.txt;0;1;0;1;98;0.0;0.01;0.0
4576_10.txt;7;0;0;7;131;0.05;0.0;0.0
417_7.txt;30;0;3;33;152;0.2;0.0;0.02
4417_9.txt;2;2;0;4;198;0.01;0.01;0.0
11873_8.txt;61;27;0;88;1090;0.06;0.02;0.0
5876_8.txt;11;0;0;11;174;0.06;0.0;0.0
9631_10.txt;6;0;0;6;112;0.05;0.0;0.0
2673_8.txt;0;2;0;2;153;0.0;0.01;0.0
7991_7.txt;26;5;4;35;519;0.05;0.01;0.01
2376_7.txt;11;3;1;15;393;0.03;0.01;0.0
3349_8.txt;14;0;0;14;241;0.06;0.0;0.0
256_9.txt;13;0;4;17;582;0.02;0.0;0.01
11310_10.txt;29;1;3;33;477;0.06;0.0;0.01
8303_10.txt;6;0;0;6;102;0.06;0.0;0.0
8457_9.txt;3;0;0;3;153;0.02;0.0;0.0
2259_9.txt;0;0;2;2;185;0.0;0.0;0.01
9098_10.txt;6;0;0;6;131;0.05;0.0;0.0
3803_9.txt;7;0;0;7;260;0.03;0.0;0.0
6469_9.txt;5;0;0;5;195;0.03;0.0;0.0
8340_8.txt;24;2;1;27;330;0.07;0.01;0.0
5715_10.txt;3;0;0;3;132;0.02;0.0;0.0
12148_10.txt;4;1;0;5;88;0.05;0.01;0.0
208_9.txt;4;0;0;4;144;0.03;0.0;0.0
7713_10.txt;1;0;0;1;162;0.01;0.0;0.0
5270_7.txt;1;0;0;1;108;0.01;0.0;0.0
6033_8.txt;11;0;0;11;235;0.05;0.0;0.0
11432_9.txt;27;7;2;36;687;0.04;0.01;0.0
3176_9.txt;0;1;0;1;193;0.0;0.01;0.0
6332_8.txt;3;1;0;4;158;0.02;0.01;0.0
5424_10.txt;4;1;1;6;197;0.02;0.01;0.01
477_10.txt;8;0;1;9;285;0.03;0.0;0.0
9927_9.txt;22;1;0;23;281;0.08;0.0;0.0
6298_9.txt;1;0;0;1;263;0.0;0.0;0.0
4421_8.txt;6;0;0;6;160;0.04;0.0;0.0
3428_9.txt;4;0;0;4;169;0.02;0.0;0.0
9157_10.txt;9;1;0;10;145;0.06;0.01;0.0
10377_9.txt;5;0;0;5;117;0.04;0.0;0.0
8795_10.txt;0;4;0;4;91;0.0;0.04;0.0
7702_10.txt;16;3;0;19;714;0.02;0.0;0.0
10017_9.txt;0;0;0;0;170;0.0;0.0;0.0
7926_10.txt;3;3;2;8;602;0.0;0.0;0.0
11022_9.txt;18;0;0;18;237;0.08;0.0;0.0
9557_7.txt;9;3;0;12;168;0.05;0.02;0.0
9401_10.txt;4;4;0;8;242;0.02;0.02;0.0
8371_10.txt;3;0;1;4;52;0.06;0.0;0.02
8157_10.txt;2;0;0;2;225;0.01;0.0;0.0
5343_8.txt;61;11;4;76;558;0.11;0.02;0.01
9778_8.txt;3;0;0;3;417;0.01;0.0;0.0
11360_7.txt;9;2;1;12;192;0.05;0.01;0.01
2444_8.txt;5;0;0;5;138;0.04;0.0;0.0
6540_7.txt;9;3;0;12;242;0.04;0.01;0.0
7567_10.txt;10;4;0;14;160;0.06;0.03;0.0
3012_8.txt;6;0;0;6;88;0.07;0.0;0.0
10637_10.txt;2;1;0;3;81;0.02;0.01;0.0
6380_9.txt;2;0;0;2;158;0.01;0.0;0.0
8784_9.txt;21;2;0;23;539;0.04;0.0;0.0
12188_10.txt;3;0;0;3;141;0.02;0.0;0.0
10250_10.txt;1;3;0;4;163;0.01;0.02;0.0
5946_7.txt;19;0;2;21;632;0.03;0.0;0.0
5406_7.txt;1;0;3;4;163;0.01;0.0;0.02
4766_10.txt;13;0;0;13;424;0.03;0.0;0.0
9251_9.txt;6;1;0;7;133;0.05;0.01;0.0
12247_8.txt;7;2;0;9;147;0.05;0.01;0.0
4301_10.txt;0;0;0;0;70;0.0;0.0;0.0
3835_9.txt;2;0;4;6;157;0.01;0.0;0.03
11596_10.txt;0;0;0;0;134;0.0;0.0;0.0
5497_9.txt;5;0;0;5;193;0.03;0.0;0.0
4455_8.txt;6;0;0;6;150;0.04;0.0;0.0
4182_10.txt;0;1;0;1;91;0.0;0.01;0.0
12253_9.txt;10;2;0;12;209;0.05;0.01;0.0
9041_8.txt;17;2;4;23;431;0.04;0.0;0.01
7564_10.txt;14;1;0;15;550;0.03;0.0;0.0
7475_7.txt;13;3;0;16;272;0.05;0.01;0.0
4308_8.txt;37;6;0;43;590;0.06;0.01;0.0
5561_8.txt;2;2;1;5;241;0.01;0.01;0.0
10935_7.txt;0;0;2;2;226;0.0;0.0;0.01
1385_8.txt;2;1;0;3;155;0.01;0.01;0.0
10353_9.txt;11;0;1;12;405;0.03;0.0;0.0
11236_8.txt;0;0;8;8;263;0.0;0.0;0.03
12083_8.txt;2;1;2;5;149;0.01;0.01;0.01
10091_7.txt;12;1;0;13;248;0.05;0.0;0.0
11013_7.txt;6;1;0;7;249;0.02;0.0;0.0
1558_10.txt;0;0;0;0;298;0.0;0.0;0.0
3894_10.txt;4;0;0;4;127;0.03;0.0;0.0
6467_7.txt;17;2;0;19;226;0.08;0.01;0.0
5710_8.txt;7;2;2;11;248;0.03;0.01;0.01
6769_9.txt;0;0;0;0;176;0.0;0.0;0.0
11798_10.txt;14;0;0;14;95;0.15;0.0;0.0
4603_10.txt;9;1;0;10;464;0.02;0.0;0.0
4524_9.txt;2;0;0;2;102;0.02;0.0;0.0
2578_10.txt;11;1;0;12;144;0.08;0.01;0.0
1303_10.txt;10;2;0;12;274;0.04;0.01;0.0
7218_9.txt;19;0;0;19;365;0.05;0.0;0.0
79_10.txt;11;0;0;11;137;0.08;0.0;0.0
4418_10.txt;2;1;2;5;137;0.01;0.01;0.01
9975_10.txt;0;0;0;0;65;0.0;0.0;0.0
9236_10.txt;20;3;1;24;196;0.1;0.02;0.01
4543_7.txt;9;2;2;13;365;0.02;0.01;0.01
10849_10.txt;2;0;0;2;137;0.01;0.0;0.0
2627_9.txt;6;5;7;18;512;0.01;0.01;0.01
110_10.txt;4;0;0;4;55;0.07;0.0;0.0
11066_8.txt;0;0;0;0;148;0.0;0.0;0.0
745_10.txt;10;0;0;10;44;0.23;0.0;0.0
9820_10.txt;0;0;0;0;213;0.0;0.0;0.0
5565_8.txt;1;3;2;6;183;0.01;0.02;0.01
1565_7.txt;10;4;0;14;109;0.09;0.04;0.0
12105_10.txt;43;2;0;45;560;0.08;0.0;0.0
3031_8.txt;14;2;0;16;288;0.05;0.01;0.0
11617_9.txt;25;0;0;25;257;0.1;0.0;0.0
10966_9.txt;6;2;0;8;209;0.03;0.01;0.0
1950_8.txt;7;0;0;7;160;0.04;0.0;0.0
118_8.txt;28;9;0;37;673;0.04;0.01;0.0
6591_8.txt;7;0;0;7;148;0.05;0.0;0.0
3278_8.txt;2;1;0;3;156;0.01;0.01;0.0
2554_7.txt;2;0;0;2;38;0.05;0.0;0.0
4462_9.txt;28;3;4;35;302;0.09;0.01;0.01
943_10.txt;5;2;0;7;61;0.08;0.03;0.0
2474_10.txt;6;0;2;8;447;0.01;0.0;0.0
10441_10.txt;22;3;0;25;857;0.03;0.0;0.0
10748_10.txt;0;0;0;0;170;0.0;0.0;0.0
11225_10.txt;0;1;0;1;63;0.0;0.02;0.0
1075_10.txt;0;0;0;0;74;0.0;0.0;0.0
7804_10.txt;2;5;2;9;178;0.01;0.03;0.01
10760_8.txt;2;4;0;6;62;0.03;0.06;0.0
3576_9.txt;16;2;3;21;572;0.03;0.0;0.01
4371_8.txt;14;2;0;16;226;0.06;0.01;0.0
2784_8.txt;6;0;0;6;136;0.04;0.0;0.0
6951_10.txt;2;1;0;3;229;0.01;0.0;0.0
12207_8.txt;8;3;0;11;293;0.03;0.01;0.0
1328_10.txt;0;0;0;0;178;0.0;0.0;0.0
10158_7.txt;8;1;0;9;127;0.06;0.01;0.0
7204_8.txt;15;3;2;20;195;0.08;0.02;0.01
6387_8.txt;1;0;0;1;147;0.01;0.0;0.0
11195_7.txt;47;0;0;47;483;0.1;0.0;0.0
1497_8.txt;4;0;0;4;73;0.05;0.0;0.0
5067_10.txt;4;0;0;4;128;0.03;0.0;0.0
5258_10.txt;3;0;0;3;138;0.02;0.0;0.0
3464_10.txt;8;1;1;10;202;0.04;0.0;0.0
12290_10.txt;8;0;12;20;195;0.04;0.0;0.06
4047_10.txt;4;0;0;4;34;0.12;0.0;0.0
11396_10.txt;5;0;1;6;87;0.06;0.0;0.01
8043_9.txt;4;0;0;4;144;0.03;0.0;0.0
9000_10.txt;0;1;0;1;77;0.0;0.01;0.0
8420_9.txt;34;3;2;39;937;0.04;0.0;0.0
1929_10.txt;0;0;0;0;148;0.0;0.0;0.0
6713_10.txt;3;0;0;3;161;0.02;0.0;0.0
11939_10.txt;35;0;0;35;164;0.21;0.0;0.0
2483_7.txt;17;0;0;17;590;0.03;0.0;0.0
2338_10.txt;0;0;2;2;132;0.0;0.0;0.02
5069_7.txt;4;1;3;8;141;0.03;0.01;0.02
11106_10.txt;74;4;1;79;889;0.08;0.0;0.0
7797_10.txt;26;2;0;28;540;0.05;0.0;0.0
4160_9.txt;0;0;0;0;99;0.0;0.0;0.0
9203_9.txt;6;1;0;7;236;0.03;0.0;0.0
341_10.txt;2;0;0;2;82;0.02;0.0;0.0
781_9.txt;0;0;0;0;91;0.0;0.0;0.0
10157_10.txt;5;0;0;5;87;0.06;0.0;0.0
585_10.txt;4;1;0;5;112;0.04;0.01;0.0
8544_9.txt;22;1;2;25;407;0.05;0.0;0.0
8897_10.txt;3;0;0;3;140;0.02;0.0;0.0
8890_10.txt;2;0;0;2;76;0.03;0.0;0.0
11511_9.txt;25;1;1;27;348;0.07;0.0;0.0
263_9.txt;9;0;0;9;240;0.04;0.0;0.0
8364_10.txt;2;0;2;4;210;0.01;0.0;0.01
6866_7.txt;7;0;0;7;161;0.04;0.0;0.0
7261_8.txt;10;1;0;11;266;0.04;0.0;0.0
6531_8.txt;4;0;0;4;158;0.03;0.0;0.0
12492_7.txt;3;0;0;3;118;0.03;0.0;0.0
11615_9.txt;10;5;0;15;606;0.02;0.01;0.0
4215_9.txt;36;8;2;46;1108;0.03;0.01;0.0
10611_8.txt;2;0;0;2;89;0.02;0.0;0.0
4859_7.txt;45;3;4;52;484;0.09;0.01;0.01
3402_8.txt;15;3;2;20;786;0.02;0.0;0.0
1780_10.txt;1;5;0;6;243;0.0;0.02;0.0
10081_9.txt;0;0;0;0;285;0.0;0.0;0.0
1555_8.txt;11;1;0;12;166;0.07;0.01;0.0
6138_8.txt;19;1;0;20;339;0.06;0.0;0.0
3435_10.txt;6;0;3;9;164;0.04;0.0;0.02
4065_10.txt;3;0;2;5;137;0.02;0.0;0.01
11192_10.txt;3;0;0;3;166;0.02;0.0;0.0
10261_8.txt;0;0;0;0;174;0.0;0.0;0.0
7185_10.txt;22;1;4;27;378;0.06;0.0;0.01
6253_8.txt;3;1;0;4;279;0.01;0.0;0.0
12227_7.txt;21;1;0;22;393;0.05;0.0;0.0
2434_8.txt;1;0;5;6;214;0.0;0.0;0.02
492_7.txt;5;0;0;5;191;0.03;0.0;0.0
2624_7.txt;6;5;2;13;225;0.03;0.02;0.01
12007_10.txt;1;4;0;5;127;0.01;0.03;0.0
20_9.txt;8;0;0;8;164;0.05;0.0;0.0
10786_10.txt;0;0;0;0;149;0.0;0.0;0.0
5318_7.txt;13;4;0;17;492;0.03;0.01;0.0
8459_10.txt;0;0;2;2;417;0.0;0.0;0.0
8570_7.txt;12;0;0;12;265;0.05;0.0;0.0
6812_7.txt;39;4;3;46;842;0.05;0.0;0.0
852_7.txt;0;0;0;0;161;0.0;0.0;0.0
8605_10.txt;34;0;0;34;164;0.21;0.0;0.0
6789_8.txt;2;0;1;3;667;0.0;0.0;0.0
8372_10.txt;1;0;0;1;136;0.01;0.0;0.0
4759_7.txt;12;0;0;12;133;0.09;0.0;0.0
8922_7.txt;13;0;0;13;176;0.07;0.0;0.0
9216_10.txt;2;0;0;2;75;0.03;0.0;0.0
5645_10.txt;11;3;5;19;337;0.03;0.01;0.01
7659_10.txt;2;2;0;4;109;0.02;0.02;0.0
24_8.txt;3;0;0;3;68;0.04;0.0;0.0
10259_8.txt;2;2;0;4;407;0.0;0.0;0.0
11938_7.txt;7;0;3;10;207;0.03;0.0;0.01
6919_9.txt;82;6;4;92;544;0.15;0.01;0.01
1548_8.txt;5;0;0;5;282;0.02;0.0;0.0
6460_10.txt;0;0;4;4;129;0.0;0.0;0.03
10173_8.txt;13;8;5;26;521;0.02;0.02;0.01
8627_10.txt;5;0;0;5;75;0.07;0.0;0.0
901_8.txt;4;0;0;4;140;0.03;0.0;0.0
4496_8.txt;0;2;0;2;163;0.0;0.01;0.0
7852_9.txt;13;0;0;13;327;0.04;0.0;0.0
3384_8.txt;0;0;1;1;199;0.0;0.0;0.01
2750_10.txt;1;1;0;2;100;0.01;0.01;0.0
2140_10.txt;0;0;0;0;74;0.0;0.0;0.0
6670_8.txt;7;2;0;9;228;0.03;0.01;0.0
1054_8.txt;8;1;0;9;168;0.05;0.01;0.0
170_10.txt;9;1;0;10;250;0.04;0.0;0.0
2757_10.txt;5;0;0;5;132;0.04;0.0;0.0
3381_10.txt;0;2;0;2;77;0.0;0.03;0.0
11139_8.txt;14;1;0;15;268;0.05;0.0;0.0
12050_10.txt;2;0;1;3;654;0.0;0.0;0.0
3738_8.txt;23;0;0;23;589;0.04;0.0;0.0
11117_10.txt;23;0;0;23;514;0.04;0.0;0.0
11172_10.txt;4;1;0;5;151;0.03;0.01;0.0
7357_10.txt;4;1;0;5;202;0.02;0.0;0.0
11342_9.txt;4;0;3;7;296;0.01;0.0;0.01
10005_7.txt;2;0;0;2;118;0.02;0.0;0.0
7245_10.txt;0;0;0;0;138;0.0;0.0;0.0
9363_10.txt;2;0;0;2;180;0.01;0.0;0.0
3912_10.txt;0;0;0;0;40;0.0;0.0;0.0
6620_10.txt;1;2;1;4;166;0.01;0.01;0.01
10429_10.txt;4;0;0;4;125;0.03;0.0;0.0
7643_7.txt;2;1;1;4;166;0.01;0.01;0.01
9444_10.txt;16;1;0;17;989;0.02;0.0;0.0
4915_7.txt;15;0;0;15;220;0.07;0.0;0.0
2369_10.txt;6;0;6;12;65;0.09;0.0;0.09
6499_10.txt;2;0;0;2;155;0.01;0.0;0.0
6655_7.txt;7;0;0;7;131;0.05;0.0;0.0
704_10.txt;0;0;0;0;178;0.0;0.0;0.0
11549_7.txt;8;0;0;8;153;0.05;0.0;0.0
5296_10.txt;11;0;0;11;126;0.09;0.0;0.0
8819_10.txt;0;0;0;0;61;0.0;0.0;0.0
6231_10.txt;0;0;0;0;157;0.0;0.0;0.0
12308_10.txt;0;0;0;0;46;0.0;0.0;0.0
618_10.txt;0;0;0;0;122;0.0;0.0;0.0
4695_9.txt;4;1;1;6;132;0.03;0.01;0.01
6242_8.txt;0;0;0;0;379;0.0;0.0;0.0
6395_9.txt;3;2;0;5;131;0.02;0.02;0.0
7966_9.txt;6;2;0;8;259;0.02;0.01;0.0
9116_9.txt;0;0;0;0;279;0.0;0.0;0.0
10542_7.txt;4;1;0;5;463;0.01;0.0;0.0
1345_9.txt;38;7;8;53;783;0.05;0.01;0.01
3430_10.txt;0;0;0;0;231;0.0;0.0;0.0
9522_10.txt;37;1;0;38;328;0.11;0.0;0.0
6080_10.txt;11;0;1;12;393;0.03;0.0;0.0
8749_7.txt;3;0;0;3;208;0.01;0.0;0.0
4647_8.txt;2;0;2;4;233;0.01;0.0;0.01
1927_8.txt;5;0;0;5;97;0.05;0.0;0.0
7669_8.txt;8;0;0;8;174;0.05;0.0;0.0
10635_8.txt;3;1;0;4;124;0.02;0.01;0.0
2895_9.txt;10;1;2;13;404;0.02;0.0;0.0
514_10.txt;0;1;3;4;80;0.0;0.01;0.04
7622_10.txt;0;0;0;0;159;0.0;0.0;0.0
11980_10.txt;0;0;0;0;148;0.0;0.0;0.0
8497_7.txt;0;0;0;0;55;0.0;0.0;0.0
4812_8.txt;16;5;2;23;408;0.04;0.01;0.0
7526_8.txt;14;4;0;18;242;0.06;0.02;0.0
9172_10.txt;26;6;0;32;364;0.07;0.02;0.0
3777_10.txt;7;0;0;7;115;0.06;0.0;0.0
8807_9.txt;0;8;0;8;319;0.0;0.03;0.0
9148_7.txt;12;0;1;13;497;0.02;0.0;0.0
4999_9.txt;5;0;4;9;285;0.02;0.0;0.01
4129_10.txt;4;0;0;4;116;0.03;0.0;0.0
7503_7.txt;2;1;0;3;153;0.01;0.01;0.0
3477_10.txt;0;0;0;0;190;0.0;0.0;0.0
7065_7.txt;15;4;0;19;315;0.05;0.01;0.0
11945_9.txt;0;0;0;0;127;0.0;0.0;0.0
7396_9.txt;0;2;0;2;140;0.0;0.01;0.0
11680_8.txt;12;0;0;12;171;0.07;0.0;0.0
6560_7.txt;2;0;0;2;332;0.01;0.0;0.0
2858_10.txt;53;1;5;59;957;0.06;0.0;0.01
5473_8.txt;53;6;2;61;718;0.07;0.01;0.0
5200_10.txt;6;0;0;6;68;0.09;0.0;0.0
5432_7.txt;10;2;7;19;249;0.04;0.01;0.03
8257_9.txt;22;0;2;24;408;0.05;0.0;0.0
10248_7.txt;3;1;0;4;297;0.01;0.0;0.0
1062_10.txt;4;0;0;4;67;0.06;0.0;0.0
2314_7.txt;8;0;1;9;347;0.02;0.0;0.0
2758_7.txt;4;1;0;5;204;0.02;0.0;0.0
5773_9.txt;0;0;2;2;145;0.0;0.0;0.01
6308_8.txt;2;0;0;2;108;0.02;0.0;0.0
1023_10.txt;1;0;0;1;259;0.0;0.0;0.0
4566_9.txt;55;1;0;56;975;0.06;0.0;0.0
8641_7.txt;17;2;2;21;624;0.03;0.0;0.0
11658_10.txt;15;2;2;19;547;0.03;0.0;0.0
9383_8.txt;16;2;0;18;463;0.03;0.0;0.0
5546_7.txt;0;1;1;2;405;0.0;0.0;0.0
9356_9.txt;35;1;0;36;975;0.04;0.0;0.0
7933_10.txt;2;1;5;8;232;0.01;0.0;0.02
4734_9.txt;5;0;0;5;125;0.04;0.0;0.0
7426_10.txt;11;0;0;11;214;0.05;0.0;0.0
4211_8.txt;0;0;3;3;130;0.0;0.0;0.02
6084_8.txt;1;0;0;1;86;0.01;0.0;0.0
687_9.txt;0;0;0;0;71;0.0;0.0;0.0
4425_7.txt;4;1;2;7;250;0.02;0.0;0.01
8040_9.txt;6;1;1;8;206;0.03;0.0;0.0
12414_10.txt;11;0;0;11;99;0.11;0.0;0.0
2439_8.txt;17;3;3;23;593;0.03;0.01;0.01
2296_9.txt;7;0;2;9;273;0.03;0.0;0.01
5739_10.txt;9;1;0;10;121;0.07;0.01;0.0
9067_8.txt;0;0;0;0;182;0.0;0.0;0.0
7077_10.txt;4;1;0;5;129;0.03;0.01;0.0
300_9.txt;8;6;0;14;363;0.02;0.02;0.0
3453_7.txt;22;1;3;26;396;0.06;0.0;0.01
3714_10.txt;1;0;0;1;132;0.01;0.0;0.0
3283_8.txt;2;0;1;3;161;0.01;0.0;0.01
11146_8.txt;13;3;0;16;167;0.08;0.02;0.0
8033_7.txt;4;0;0;4;128;0.03;0.0;0.0
7517_7.txt;43;4;3;50;560;0.08;0.01;0.01
7987_8.txt;12;0;3;15;273;0.04;0.0;0.01
5881_7.txt;41;0;0;41;148;0.28;0.0;0.0
503_10.txt;2;0;0;2;169;0.01;0.0;0.0
1536_7.txt;2;2;0;4;150;0.01;0.01;0.0
5074_10.txt;62;4;0;66;873;0.07;0.0;0.0
4044_9.txt;0;0;0;0;148;0.0;0.0;0.0
930_7.txt;12;0;0;12;204;0.06;0.0;0.0
8348_10.txt;8;4;2;14;617;0.01;0.01;0.0
2289_9.txt;0;0;0;0;131;0.0;0.0;0.0
1987_10.txt;7;0;0;7;159;0.04;0.0;0.0
5527_8.txt;0;0;1;1;385;0.0;0.0;0.0
9351_8.txt;32;4;0;36;595;0.05;0.01;0.0
1647_10.txt;0;1;0;1;65;0.0;0.02;0.0
11903_10.txt;10;0;0;10;221;0.05;0.0;0.0
2948_10.txt;17;0;0;17;216;0.08;0.0;0.0
3593_8.txt;9;0;0;9;84;0.11;0.0;0.0
6956_8.txt;10;0;0;10;223;0.04;0.0;0.0
3188_8.txt;2;2;0;4;303;0.01;0.01;0.0
7181_10.txt;0;3;0;3;140;0.0;0.02;0.0
5418_10.txt;11;1;2;14;103;0.11;0.01;0.02
838_9.txt;18;2;2;22;166;0.11;0.01;0.01
3079_10.txt;2;0;0;2;141;0.01;0.0;0.0
3613_8.txt;14;1;0;15;360;0.04;0.0;0.0
7036_10.txt;2;1;0;3;139;0.01;0.01;0.0
88_9.txt;0;0;0;0;183;0.0;0.0;0.0
4018_7.txt;38;4;0;42;455;0.08;0.01;0.0
9996_9.txt;2;0;0;2;170;0.01;0.0;0.0
10306_8.txt;0;4;0;4;185;0.0;0.02;0.0
1800_8.txt;3;0;0;3;236;0.01;0.0;0.0
2018_9.txt;13;0;0;13;148;0.09;0.0;0.0
4248_10.txt;0;0;0;0;66;0.0;0.0;0.0
5254_9.txt;8;0;0;8;41;0.2;0.0;0.0
12113_8.txt;1;2;0;3;95;0.01;0.02;0.0
6588_9.txt;0;0;2;2;305;0.0;0.0;0.01
10751_10.txt;47;15;10;72;1136;0.04;0.01;0.01
12450_7.txt;13;0;1;14;146;0.09;0.0;0.01
5818_7.txt;6;0;1;7;162;0.04;0.0;0.01
5512_7.txt;4;1;0;5;129;0.03;0.01;0.0
8646_7.txt;25;2;0;27;314;0.08;0.01;0.0
5225_9.txt;2;2;4;8;346;0.01;0.01;0.01
7071_9.txt;23;0;0;23;725;0.03;0.0;0.0
1547_7.txt;0;1;0;1;152;0.0;0.01;0.0
9762_8.txt;11;0;0;11;416;0.03;0.0;0.0
59_7.txt;6;0;0;6;183;0.03;0.0;0.0
9852_7.txt;0;0;0;0;314;0.0;0.0;0.0
1995_9.txt;2;0;0;2;134;0.01;0.0;0.0
6586_10.txt;10;0;0;10;87;0.11;0.0;0.0
11230_10.txt;2;0;3;5;198;0.01;0.0;0.02
2043_7.txt;4;1;4;9;278;0.01;0.0;0.01
5090_10.txt;1;0;0;1;145;0.01;0.0;0.0
11453_9.txt;3;0;0;3;83;0.04;0.0;0.0
5530_8.txt;0;0;0;0;165;0.0;0.0;0.0
4569_7.txt;24;0;0;24;392;0.06;0.0;0.0
10484_8.txt;12;1;0;13;493;0.02;0.0;0.0
3914_10.txt;3;0;0;3;80;0.04;0.0;0.0
9394_10.txt;56;6;0;62;594;0.09;0.01;0.0
10080_10.txt;0;2;0;2;178;0.0;0.01;0.0
12251_9.txt;17;0;0;17;263;0.06;0.0;0.0
9530_9.txt;10;0;0;10;181;0.06;0.0;0.0
4086_7.txt;3;1;2;6;239;0.01;0.0;0.01
7007_8.txt;3;0;0;3;143;0.02;0.0;0.0
2954_10.txt;6;1;0;7;138;0.04;0.01;0.0
2212_10.txt;18;0;3;21;257;0.07;0.0;0.01
4891_10.txt;4;0;0;4;105;0.04;0.0;0.0
10906_10.txt;2;0;0;2;148;0.01;0.0;0.0
6653_8.txt;27;0;0;27;310;0.09;0.0;0.0
1785_9.txt;73;4;1;78;1046;0.07;0.0;0.0
893_8.txt;56;17;1;74;1107;0.05;0.02;0.0
6247_10.txt;1;0;0;1;281;0.0;0.0;0.0
9446_10.txt;5;0;0;5;156;0.03;0.0;0.0
12301_8.txt;16;2;2;20;272;0.06;0.01;0.01
11951_8.txt;30;2;0;32;470;0.06;0.0;0.0
6677_9.txt;7;0;0;7;118;0.06;0.0;0.0
2962_7.txt;17;3;0;20;382;0.04;0.01;0.0
12195_8.txt;14;9;0;23;436;0.03;0.02;0.0
3525_7.txt;28;3;2;33;709;0.04;0.0;0.0
3848_8.txt;20;1;1;22;271;0.07;0.0;0.0
5515_7.txt;4;1;0;5;234;0.02;0.0;0.0
10885_7.txt;2;3;0;5;480;0.0;0.01;0.0
303_10.txt;8;3;2;13;234;0.03;0.01;0.01
5367_9.txt;1;0;0;1;136;0.01;0.0;0.0
7033_7.txt;19;0;0;19;352;0.05;0.0;0.0
8321_7.txt;6;1;0;7;115;0.05;0.01;0.0
195_8.txt;36;5;0;41;309;0.12;0.02;0.0
5328_8.txt;4;2;7;13;223;0.02;0.01;0.03
9509_9.txt;13;0;0;13;190;0.07;0.0;0.0
4199_7.txt;15;1;0;16;290;0.05;0.0;0.0
10221_8.txt;4;0;0;4;205;0.02;0.0;0.0
5377_7.txt;5;1;1;7;281;0.02;0.0;0.0
809_10.txt;13;0;2;15;232;0.06;0.0;0.01
8377_8.txt;3;0;0;3;230;0.01;0.0;0.0
12047_10.txt;0;1;1;2;269;0.0;0.0;0.0
5859_9.txt;6;1;0;7;205;0.03;0.0;0.0
972_9.txt;6;1;0;7;202;0.03;0.0;0.0
10421_7.txt;7;1;4;12;231;0.03;0.0;0.02
2149_10.txt;8;0;0;8;134;0.06;0.0;0.0
7080_10.txt;29;0;0;29;151;0.19;0.0;0.0
4730_10.txt;4;1;0;5;70;0.06;0.01;0.0
5602_10.txt;14;0;6;20;175;0.08;0.0;0.03
8455_10.txt;1;0;0;1;175;0.01;0.0;0.0
4672_10.txt;6;3;3;12;137;0.04;0.02;0.02
9454_10.txt;8;2;0;10;464;0.02;0.0;0.0
9658_7.txt;35;1;0;36;642;0.05;0.0;0.0
4562_9.txt;4;1;2;7;174;0.02;0.01;0.01
2089_10.txt;2;0;0;2;109;0.02;0.0;0.0
9325_10.txt;16;0;1;17;177;0.09;0.0;0.01
4062_10.txt;14;7;1;22;680;0.02;0.01;0.0
3037_7.txt;43;42;16;101;1083;0.04;0.04;0.01
8094_9.txt;0;0;3;3;243;0.0;0.0;0.01
7303_10.txt;6;0;0;6;152;0.04;0.0;0.0
3408_10.txt;11;4;1;16;256;0.04;0.02;0.0
3019_8.txt;0;1;0;1;247;0.0;0.0;0.0
8160_7.txt;10;0;3;13;507;0.02;0.0;0.01
5248_8.txt;7;0;0;7;105;0.07;0.0;0.0
9810_7.txt;6;2;0;8;146;0.04;0.01;0.0
3141_10.txt;39;1;2;42;368;0.11;0.0;0.01
5213_8.txt;2;0;1;3;143;0.01;0.0;0.01
3862_9.txt;0;0;0;0;156;0.0;0.0;0.0
3675_9.txt;75;15;2;92;544;0.14;0.03;0.0
7596_9.txt;1;0;0;1;263;0.0;0.0;0.0
6702_8.txt;14;0;0;14;315;0.04;0.0;0.0
9397_9.txt;11;3;0;14;373;0.03;0.01;0.0
6373_10.txt;0;0;0;0;100;0.0;0.0;0.0
6307_8.txt;7;1;1;9;170;0.04;0.01;0.01
10622_10.txt;5;0;0;5;109;0.05;0.0;0.0
9665_10.txt;5;0;0;5;145;0.03;0.0;0.0
2490_8.txt;0;0;0;0;274;0.0;0.0;0.0
4378_9.txt;54;7;7;68;798;0.07;0.01;0.01
3373_7.txt;34;7;9;50;820;0.04;0.01;0.01
2862_10.txt;13;4;2;19;498;0.03;0.01;0.0
1499_7.txt;5;0;0;5;152;0.03;0.0;0.0
5795_10.txt;4;0;1;5;193;0.02;0.0;0.01
106_10.txt;2;1;0;3;203;0.01;0.0;0.0
6181_9.txt;4;0;4;8;306;0.01;0.0;0.01
5554_8.txt;16;0;0;16;363;0.04;0.0;0.0
9205_7.txt;4;5;0;9;372;0.01;0.01;0.0
719_10.txt;0;0;2;2;206;0.0;0.0;0.01
6050_10.txt;7;1;0;8;253;0.03;0.0;0.0
2122_7.txt;39;3;0;42;395;0.1;0.01;0.0
9594_10.txt;5;1;0;6;151;0.03;0.01;0.0
446_10.txt;0;1;0;1;104;0.0;0.01;0.0
10310_9.txt;31;3;0;34;520;0.06;0.01;0.0
10465_8.txt;1;0;0;1;152;0.01;0.0;0.0
4547_8.txt;8;0;0;8;83;0.1;0.0;0.0
11733_10.txt;12;2;0;14;249;0.05;0.01;0.0
11637_8.txt;24;1;0;25;602;0.04;0.0;0.0
3697_7.txt;31;2;5;38;377;0.08;0.01;0.01
6216_7.txt;28;4;6;38;539;0.05;0.01;0.01
4868_8.txt;2;1;0;3;144;0.01;0.01;0.0
3235_9.txt;1;4;0;5;122;0.01;0.03;0.0
8093_7.txt;6;0;0;6;157;0.04;0.0;0.0
9533_9.txt;44;5;2;51;569;0.08;0.01;0.0
6292_10.txt;35;3;4;42;610;0.06;0.0;0.01
2751_10.txt;6;0;0;6;46;0.13;0.0;0.0
11936_7.txt;2;0;0;2;202;0.01;0.0;0.0
10442_10.txt;2;0;0;2;297;0.01;0.0;0.0
10360_8.txt;4;2;0;6;361;0.01;0.01;0.0
348_7.txt;4;0;0;4;266;0.02;0.0;0.0
1764_10.txt;8;2;0;10;245;0.03;0.01;0.0
4630_9.txt;15;1;0;16;338;0.04;0.0;0.0
8666_7.txt;12;4;0;16;437;0.03;0.01;0.0
2687_10.txt;2;0;0;2;183;0.01;0.0;0.0
4794_8.txt;11;0;0;11;130;0.08;0.0;0.0
11645_8.txt;2;3;3;8;286;0.01;0.01;0.01
11999_10.txt;5;0;0;5;162;0.03;0.0;0.0
10299_9.txt;8;0;0;8;175;0.05;0.0;0.0
5912_7.txt;27;4;1;32;878;0.03;0.0;0.0
8276_10.txt;2;0;0;2;186;0.01;0.0;0.0
5713_10.txt;8;3;3;14;658;0.01;0.0;0.0
5456_10.txt;70;3;0;73;670;0.1;0.0;0.0
8721_10.txt;0;0;1;1;162;0.0;0.0;0.01
1545_10.txt;2;0;2;4;50;0.04;0.0;0.04
4842_10.txt;5;0;2;7;241;0.02;0.0;0.01
9755_7.txt;0;0;0;0;129;0.0;0.0;0.0
3209_8.txt;0;0;0;0;86;0.0;0.0;0.0
1073_9.txt;0;0;0;0;301;0.0;0.0;0.0
10672_9.txt;4;5;0;9;301;0.01;0.02;0.0
1757_8.txt;35;0;2;37;685;0.05;0.0;0.0
4848_7.txt;2;1;1;4;192;0.01;0.01;0.01
8204_8.txt;40;0;0;40;272;0.15;0.0;0.0
8349_10.txt;14;0;0;14;219;0.06;0.0;0.0
11215_10.txt;13;0;0;13;219;0.06;0.0;0.0
3639_9.txt;6;2;3;11;107;0.06;0.02;0.03
1184_7.txt;5;3;0;8;507;0.01;0.01;0.0
4442_9.txt;2;1;1;4;185;0.01;0.01;0.01
11861_10.txt;4;0;0;4;88;0.05;0.0;0.0
11467_10.txt;2;0;0;2;145;0.01;0.0;0.0
12221_8.txt;3;0;2;5;133;0.02;0.0;0.02
1076_8.txt;13;3;0;16;549;0.02;0.01;0.0
8907_8.txt;4;0;0;4;139;0.03;0.0;0.0
974_10.txt;6;0;0;6;450;0.01;0.0;0.0
11232_10.txt;5;0;4;9;389;0.01;0.0;0.01
1412_8.txt;13;1;0;14;293;0.04;0.0;0.0
8505_8.txt;5;0;3;8;1242;0.0;0.0;0.0
10765_10.txt;5;2;2;9;119;0.04;0.02;0.02
7836_8.txt;75;1;4;80;598;0.13;0.0;0.01
4250_8.txt;6;0;0;6;146;0.04;0.0;0.0
11772_10.txt;2;0;0;2;148;0.01;0.0;0.0
5831_8.txt;35;3;6;44;437;0.08;0.01;0.01
6099_8.txt;5;1;0;6;549;0.01;0.0;0.0
1294_7.txt;1;0;0;1;93;0.01;0.0;0.0
2476_10.txt;73;6;4;83;1165;0.06;0.01;0.0
7538_7.txt;6;0;0;6;58;0.1;0.0;0.0
6169_10.txt;2;0;0;2;124;0.02;0.0;0.0
1693_10.txt;1;0;0;1;58;0.02;0.0;0.0
886_8.txt;0;2;0;2;368;0.0;0.01;0.0
9524_9.txt;27;3;0;30;714;0.04;0.0;0.0
3990_8.txt;19;0;0;19;981;0.02;0.0;0.0
3859_8.txt;15;0;0;15;208;0.07;0.0;0.0
10044_9.txt;53;17;3;73;1980;0.03;0.01;0.0
9912_10.txt;1;0;0;1;149;0.01;0.0;0.0
6524_8.txt;3;7;2;12;207;0.01;0.03;0.01
5454_7.txt;11;2;0;13;685;0.02;0.0;0.0
5532_10.txt;1;0;0;1;172;0.01;0.0;0.0
1349_8.txt;32;0;0;32;232;0.14;0.0;0.0
3284_10.txt;18;0;3;21;552;0.03;0.0;0.01
395_10.txt;2;3;2;7;121;0.02;0.02;0.02
8098_7.txt;9;3;6;18;478;0.02;0.01;0.01
3633_10.txt;2;0;0;2;56;0.04;0.0;0.0
2410_9.txt;7;0;0;7;152;0.05;0.0;0.0
6722_9.txt;4;0;1;5;313;0.01;0.0;0.0
8346_9.txt;16;0;0;16;360;0.04;0.0;0.0
8759_8.txt;16;5;2;23;755;0.02;0.01;0.0
7086_10.txt;35;1;0;36;638;0.05;0.0;0.0
7950_9.txt;12;1;0;13;173;0.07;0.01;0.0
3924_7.txt;19;0;1;20;168;0.11;0.0;0.01
7090_10.txt;10;2;0;12;681;0.01;0.0;0.0
8987_9.txt;12;0;0;12;312;0.04;0.0;0.0
8649_9.txt;14;0;1;15;328;0.04;0.0;0.0
7385_10.txt;11;2;0;13;316;0.03;0.01;0.0
10039_10.txt;7;0;0;7;278;0.03;0.0;0.0
7741_9.txt;13;0;0;13;146;0.09;0.0;0.0
8882_10.txt;14;0;0;14;264;0.05;0.0;0.0
5781_10.txt;2;0;0;2;216;0.01;0.0;0.0
4924_7.txt;24;4;2;30;434;0.06;0.01;0.0
9118_10.txt;5;0;0;5;147;0.03;0.0;0.0
7030_10.txt;15;0;0;15;238;0.06;0.0;0.0
6595_9.txt;3;5;3;11;286;0.01;0.02;0.01
1099_10.txt;62;7;0;69;933;0.07;0.01;0.0
11135_9.txt;12;0;0;12;162;0.07;0.0;0.0
3397_10.txt;9;0;4;13;237;0.04;0.0;0.02
921_7.txt;40;0;9;49;888;0.05;0.0;0.01
9193_10.txt;1;1;0;2;142;0.01;0.01;0.0
8424_9.txt;5;4;0;9;125;0.04;0.03;0.0
482_8.txt;0;1;0;1;121;0.0;0.01;0.0
1587_10.txt;1;3;1;5;139;0.01;0.02;0.01
9613_10.txt;0;1;0;1;199;0.0;0.01;0.0
12095_8.txt;16;1;0;17;242;0.07;0.0;0.0
6175_8.txt;4;0;0;4;213;0.02;0.0;0.0
5076_10.txt;11;2;0;13;166;0.07;0.01;0.0
3264_8.txt;21;0;0;21;469;0.04;0.0;0.0
2617_10.txt;0;0;0;0;143;0.0;0.0;0.0
9377_7.txt;7;0;0;7;134;0.05;0.0;0.0
11956_9.txt;13;0;1;14;144;0.09;0.0;0.01
2595_9.txt;17;3;2;22;165;0.1;0.02;0.01
11820_8.txt;15;1;0;16;326;0.05;0.0;0.0
9457_9.txt;20;0;0;20;622;0.03;0.0;0.0
4426_7.txt;1;0;0;1;143;0.01;0.0;0.0
7691_9.txt;17;3;2;22;404;0.04;0.01;0.0
5663_10.txt;0;0;2;2;207;0.0;0.0;0.01
7975_8.txt;5;2;1;8;382;0.01;0.01;0.0
4863_10.txt;8;1;4;13;208;0.04;0.0;0.02
11855_7.txt;1;2;0;3;191;0.01;0.01;0.0
1492_10.txt;35;8;0;43;816;0.04;0.01;0.0
6360_7.txt;1;0;0;1;161;0.01;0.0;0.0
9812_7.txt;12;1;2;15;357;0.03;0.0;0.01
4346_10.txt;8;0;0;8;196;0.04;0.0;0.0
3246_9.txt;8;6;0;14;225;0.04;0.03;0.0
12003_10.txt;2;2;0;4;229;0.01;0.01;0.0
8697_7.txt;6;3;0;9;164;0.04;0.02;0.0
2368_8.txt;18;0;0;18;148;0.12;0.0;0.0
1117_10.txt;35;4;0;39;636;0.06;0.01;0.0
9585_10.txt;0;0;0;0;171;0.0;0.0;0.0
11530_8.txt;2;0;0;2;160;0.01;0.0;0.0
11712_10.txt;3;0;0;3;102;0.03;0.0;0.0
8558_10.txt;15;3;0;18;159;0.09;0.02;0.0
8476_10.txt;0;0;0;0;202;0.0;0.0;0.0
250_7.txt;11;1;5;17;140;0.08;0.01;0.04
11864_8.txt;29;7;0;36;669;0.04;0.01;0.0
1957_7.txt;9;0;0;9;168;0.05;0.0;0.0
10245_10.txt;0;0;0;0;134;0.0;0.0;0.0
1643_10.txt;4;0;0;4;141;0.03;0.0;0.0
7844_10.txt;1;0;0;1;243;0.0;0.0;0.0
11812_10.txt;3;0;0;3;182;0.02;0.0;0.0
6793_10.txt;1;1;0;2;182;0.01;0.01;0.0
9262_8.txt;1;4;0;5;177;0.01;0.02;0.0
9499_7.txt;0;1;0;1;111;0.0;0.01;0.0
10973_8.txt;0;0;0;0;74;0.0;0.0;0.0
1265_10.txt;6;0;0;6;143;0.04;0.0;0.0
1107_10.txt;24;1;2;27;250;0.1;0.0;0.01
3946_7.txt;9;2;0;11;205;0.04;0.01;0.0
10842_7.txt;0;1;0;1;191;0.0;0.01;0.0
262_8.txt;0;2;0;2;879;0.0;0.0;0.0
6523_10.txt;2;3;0;5;150;0.01;0.02;0.0
3371_8.txt;49;9;3;61;1107;0.04;0.01;0.0
7364_7.txt;1;1;0;2;279;0.0;0.0;0.0
2014_7.txt;11;0;0;11;164;0.07;0.0;0.0
7712_10.txt;1;2;1;4;157;0.01;0.01;0.01
8238_8.txt;0;2;0;2;151;0.0;0.01;0.0
1373_10.txt;4;0;0;4;96;0.04;0.0;0.0
7360_10.txt;2;0;0;2;260;0.01;0.0;0.0
2028_10.txt;3;0;0;3;70;0.04;0.0;0.0
4887_10.txt;0;0;0;0;56;0.0;0.0;0.0
1154_10.txt;13;0;0;13;176;0.07;0.0;0.0
7937_10.txt;5;0;1;6;229;0.02;0.0;0.0
3138_9.txt;25;1;0;26;347;0.07;0.0;0.0
11623_8.txt;0;0;0;0;160;0.0;0.0;0.0
7268_9.txt;8;0;0;8;160;0.05;0.0;0.0
12130_7.txt;19;4;0;23;496;0.04;0.01;0.0
11035_8.txt;20;3;0;23;476;0.04;0.01;0.0
11950_8.txt;5;0;0;5;163;0.03;0.0;0.0
4082_10.txt;6;3;2;11;222;0.03;0.01;0.01
5345_9.txt;3;3;0;6;203;0.01;0.01;0.0
5990_7.txt;8;0;3;11;221;0.04;0.0;0.01
5634_8.txt;17;2;0;19;450;0.04;0.0;0.0
5757_8.txt;25;3;0;28;355;0.07;0.01;0.0
10198_8.txt;7;2;1;10;204;0.03;0.01;0.0
3452_8.txt;4;0;0;4;136;0.03;0.0;0.0
5988_7.txt;8;3;0;11;176;0.05;0.02;0.0
8191_8.txt;9;0;0;9;142;0.06;0.0;0.0
10526_9.txt;65;5;0;70;1035;0.06;0.0;0.0
720_7.txt;2;0;1;3;230;0.01;0.0;0.0
11902_9.txt;2;0;0;2;220;0.01;0.0;0.0
10816_10.txt;0;0;0;0;192;0.0;0.0;0.0
5886_10.txt;13;0;0;13;90;0.14;0.0;0.0
3662_9.txt;3;2;0;5;217;0.01;0.01;0.0
1998_9.txt;12;2;0;14;134;0.09;0.01;0.0
7118_10.txt;14;1;0;15;155;0.09;0.01;0.0
1127_10.txt;5;0;0;5;300;0.02;0.0;0.0
452_10.txt;3;3;0;6;334;0.01;0.01;0.0
64_7.txt;42;0;0;42;786;0.05;0.0;0.0
439_9.txt;8;0;0;8;155;0.05;0.0;0.0
9213_7.txt;6;0;0;6;175;0.03;0.0;0.0
7902_10.txt;0;0;0;0;93;0.0;0.0;0.0
4601_7.txt;4;2;0;6;211;0.02;0.01;0.0
6035_10.txt;0;0;0;0;340;0.0;0.0;0.0
10801_8.txt;6;0;0;6;202;0.03;0.0;0.0
6967_7.txt;28;3;2;33;356;0.08;0.01;0.01
6681_10.txt;8;0;1;9;203;0.04;0.0;0.0
7673_7.txt;33;8;0;41;1043;0.03;0.01;0.0
4960_9.txt;8;3;0;11;202;0.04;0.01;0.0
9691_10.txt;1;0;0;1;56;0.02;0.0;0.0
6484_10.txt;9;2;1;12;191;0.05;0.01;0.01
4374_10.txt;50;1;1;52;696;0.07;0.0;0.0
4410_10.txt;8;3;0;11;486;0.02;0.01;0.0
10915_9.txt;38;2;2;42;298;0.13;0.01;0.01
9189_10.txt;17;0;0;17;524;0.03;0.0;0.0
3367_9.txt;2;0;0;2;157;0.01;0.0;0.0
12149_10.txt;2;0;0;2;74;0.03;0.0;0.0
4196_9.txt;2;0;0;2;271;0.01;0.0;0.0
259_8.txt;0;0;0;0;85;0.0;0.0;0.0
10797_8.txt;36;1;2;39;321;0.11;0.0;0.01
11065_8.txt;9;0;1;10;204;0.04;0.0;0.0
12302_7.txt;16;3;0;19;688;0.02;0.0;0.0
2915_7.txt;16;5;5;26;264;0.06;0.02;0.02
12425_7.txt;0;1;2;3;63;0.0;0.02;0.03
9934_8.txt;19;1;1;21;510;0.04;0.0;0.0
1841_7.txt;28;0;1;29;423;0.07;0.0;0.0
12212_10.txt;0;0;0;0;128;0.0;0.0;0.0
1317_8.txt;0;0;0;0;151;0.0;0.0;0.0
7961_10.txt;29;2;0;31;520;0.06;0.0;0.0
4831_8.txt;1;2;0;3;146;0.01;0.01;0.0
8342_7.txt;2;0;0;2;84;0.02;0.0;0.0
2580_10.txt;0;0;0;0;139;0.0;0.0;0.0
1900_8.txt;33;0;0;33;278;0.12;0.0;0.0
9825_10.txt;0;0;0;0;152;0.0;0.0;0.0
9775_8.txt;0;2;1;3;175;0.0;0.01;0.01
545_10.txt;4;2;0;6;151;0.03;0.01;0.0
11088_7.txt;0;0;0;0;156;0.0;0.0;0.0
3459_8.txt;22;0;0;22;246;0.09;0.0;0.0
4777_10.txt;19;2;0;21;301;0.06;0.01;0.0
135_7.txt;0;0;0;0;145;0.0;0.0;0.0
2322_10.txt;19;1;2;22;600;0.03;0.0;0.0
8566_10.txt;0;0;0;0;113;0.0;0.0;0.0
1996_10.txt;15;2;5;22;312;0.05;0.01;0.02
8107_8.txt;15;0;1;16;164;0.09;0.0;0.01
11221_10.txt;0;0;0;0;37;0.0;0.0;0.0
1777_10.txt;14;0;0;14;374;0.04;0.0;0.0
10370_9.txt;4;0;0;4;206;0.02;0.0;0.0
5172_9.txt;4;0;0;4;48;0.08;0.0;0.0
4671_10.txt;0;0;0;0;140;0.0;0.0;0.0
10712_8.txt;2;0;0;2;146;0.01;0.0;0.0
7293_10.txt;5;1;2;8;354;0.01;0.0;0.01
11548_10.txt;36;0;2;38;273;0.13;0.0;0.01
2995_7.txt;8;0;0;8;57;0.14;0.0;0.0
8855_10.txt;4;0;0;4;205;0.02;0.0;0.0
10689_8.txt;1;1;0;2;65;0.02;0.02;0.0
12147_10.txt;10;2;4;16;222;0.05;0.01;0.02
5799_10.txt;22;1;4;27;142;0.15;0.01;0.03
12016_7.txt;2;1;0;3;119;0.02;0.01;0.0
7510_8.txt;36;4;8;48;661;0.05;0.01;0.01
7601_10.txt;0;0;0;0;129;0.0;0.0;0.0
10771_10.txt;12;2;0;14;183;0.07;0.01;0.0
12490_8.txt;2;0;0;2;167;0.01;0.0;0.0
7094_10.txt;51;2;2;55;911;0.06;0.0;0.0
12477_10.txt;5;0;0;5;140;0.04;0.0;0.0
3347_7.txt;8;0;0;8;240;0.03;0.0;0.0
2559_9.txt;48;4;0;52;470;0.1;0.01;0.0
9534_10.txt;16;2;1;19;424;0.04;0.0;0.0
362_10.txt;19;1;0;20;286;0.07;0.0;0.0
4784_10.txt;6;0;0;6;89;0.07;0.0;0.0
11398_7.txt;6;0;1;7;165;0.04;0.0;0.01
5972_8.txt;0;0;0;0;65;0.0;0.0;0.0
4039_10.txt;2;0;0;2;302;0.01;0.0;0.0
3693_8.txt;22;16;2;40;999;0.02;0.02;0.0
6873_10.txt;0;0;0;0;68;0.0;0.0;0.0
12175_7.txt;21;1;0;22;376;0.06;0.0;0.0
5676_9.txt;8;1;0;9;212;0.04;0.0;0.0
2354_10.txt;2;0;1;3;153;0.01;0.0;0.01
3365_9.txt;19;2;0;21;502;0.04;0.0;0.0
2081_7.txt;8;1;1;10;245;0.03;0.0;0.0
8137_10.txt;0;0;0;0;131;0.0;0.0;0.0
7310_9.txt;3;0;0;3;161;0.02;0.0;0.0
9736_8.txt;8;1;0;9;209;0.04;0.0;0.0
12073_9.txt;2;0;0;2;64;0.03;0.0;0.0
11126_10.txt;9;1;5;15;290;0.03;0.0;0.02
9406_8.txt;2;0;0;2;286;0.01;0.0;0.0
10107_8.txt;16;7;5;28;398;0.04;0.02;0.01
2880_8.txt;9;0;3;12;398;0.02;0.0;0.01
11782_8.txt;2;4;6;12;476;0.0;0.01;0.01
2187_10.txt;0;0;0;0;50;0.0;0.0;0.0
7518_9.txt;7;0;0;7;191;0.04;0.0;0.0
2364_10.txt;2;0;5;7;137;0.01;0.0;0.04
6160_10.txt;2;0;0;2;136;0.01;0.0;0.0
11831_7.txt;4;0;0;4;184;0.02;0.0;0.0
7100_8.txt;1;3;0;4;193;0.01;0.02;0.0
3843_7.txt;5;0;0;5;231;0.02;0.0;0.0
3228_7.txt;8;0;0;8;283;0.03;0.0;0.0
3698_10.txt;1;1;2;4;160;0.01;0.01;0.01
8255_9.txt;3;0;0;3;168;0.02;0.0;0.0
969_7.txt;12;0;1;13;368;0.03;0.0;0.0
2625_8.txt;0;0;2;2;196;0.0;0.0;0.01
10722_10.txt;0;0;0;0;151;0.0;0.0;0.0
2515_10.txt;14;1;0;15;286;0.05;0.0;0.0
11061_8.txt;0;0;0;0;78;0.0;0.0;0.0
1805_10.txt;3;0;0;3;145;0.02;0.0;0.0
6601_9.txt;0;1;0;1;318;0.0;0.0;0.0
3473_9.txt;4;0;0;4;114;0.04;0.0;0.0
2764_10.txt;19;0;0;19;568;0.03;0.0;0.0
3143_10.txt;2;0;0;2;165;0.01;0.0;0.0
12238_8.txt;31;2;3;36;515;0.06;0.0;0.01
5847_10.txt;4;0;0;4;168;0.02;0.0;0.0
9891_10.txt;6;1;0;7;498;0.01;0.0;0.0
8763_9.txt;0;0;0;0;137;0.0;0.0;0.0
7842_10.txt;0;0;0;0;203;0.0;0.0;0.0
4148_7.txt;16;0;0;16;232;0.07;0.0;0.0
1218_8.txt;2;0;0;2;185;0.01;0.0;0.0
5810_9.txt;8;0;1;9;505;0.02;0.0;0.0
12009_10.txt;1;0;0;1;173;0.01;0.0;0.0
1865_8.txt;42;2;6;50;578;0.07;0.0;0.01
6023_8.txt;2;2;0;4;681;0.0;0.0;0.0
952_10.txt;12;1;0;13;324;0.04;0.0;0.0
5812_9.txt;6;0;0;6;137;0.04;0.0;0.0
5819_10.txt;2;0;0;2;162;0.01;0.0;0.0
10629_10.txt;5;2;0;7;167;0.03;0.01;0.0
10327_7.txt;56;0;4;60;784;0.07;0.0;0.01
9526_10.txt;39;0;0;39;555;0.07;0.0;0.0
2842_8.txt;21;9;0;30;121;0.17;0.07;0.0
6337_7.txt;6;6;1;13;430;0.01;0.01;0.0
8265_10.txt;0;2;0;2;169;0.0;0.01;0.0
5999_7.txt;6;0;0;6;275;0.02;0.0;0.0
10537_10.txt;12;0;0;12;166;0.07;0.0;0.0
4519_9.txt;4;0;0;4;62;0.06;0.0;0.0
321_10.txt;5;1;0;6;548;0.01;0.0;0.0
10711_10.txt;1;1;0;2;530;0.0;0.0;0.0
4013_7.txt;47;4;0;51;570;0.08;0.01;0.0
4632_10.txt;14;5;0;19;306;0.05;0.02;0.0
11006_7.txt;11;0;3;14;414;0.03;0.0;0.01
7778_10.txt;50;7;4;61;1327;0.04;0.01;0.0
8203_7.txt;29;2;2;33;708;0.04;0.0;0.0
4867_9.txt;11;0;3;14;215;0.05;0.0;0.01
6383_10.txt;0;0;1;1;163;0.0;0.0;0.01
2801_9.txt;14;0;0;14;424;0.03;0.0;0.0
855_9.txt;5;0;2;7;139;0.04;0.0;0.01
7547_10.txt;4;0;0;4;163;0.02;0.0;0.0
1226_10.txt;0;1;0;1;184;0.0;0.01;0.0
2399_7.txt;4;1;2;7;197;0.02;0.01;0.01
3482_10.txt;2;0;0;2;182;0.01;0.0;0.0
8743_7.txt;7;1;0;8;129;0.05;0.01;0.0
3364_10.txt;1;0;3;4;161;0.01;0.0;0.02
12496_8.txt;0;1;0;1;248;0.0;0.0;0.0
7375_7.txt;0;0;0;0;99;0.0;0.0;0.0
8768_8.txt;10;3;0;13;242;0.04;0.01;0.0
4464_10.txt;2;0;0;2;131;0.02;0.0;0.0
8059_10.txt;10;1;0;11;133;0.08;0.01;0.0
6733_10.txt;4;4;1;9;145;0.03;0.03;0.01
5457_8.txt;8;4;2;14;334;0.02;0.01;0.01
5852_7.txt;94;4;11;109;855;0.11;0.0;0.01
10082_10.txt;0;0;0;0;86;0.0;0.0;0.0
1424_10.txt;2;11;0;13;303;0.01;0.04;0.0
6625_7.txt;4;1;0;5;298;0.01;0.0;0.0
8834_9.txt;0;1;0;1;65;0.0;0.02;0.0
8286_7.txt;18;2;0;20;387;0.05;0.01;0.0
11188_10.txt;15;0;0;15;403;0.04;0.0;0.0
3339_7.txt;19;3;7;29;409;0.05;0.01;0.02
619_9.txt;17;1;0;18;272;0.06;0.0;0.0
2117_10.txt;5;0;0;5;129;0.04;0.0;0.0
3532_8.txt;26;5;0;31;418;0.06;0.01;0.0
8436_10.txt;0;0;3;3;106;0.0;0.0;0.03
443_10.txt;0;1;1;2;191;0.0;0.01;0.01
9044_9.txt;1;0;0;1;159;0.01;0.0;0.0
6177_7.txt;12;4;3;19;631;0.02;0.01;0.0
7767_8.txt;2;0;0;2;186;0.01;0.0;0.0
9732_10.txt;27;4;1;32;282;0.1;0.01;0.0
6490_10.txt;37;16;6;59;613;0.06;0.03;0.01
4599_10.txt;19;2;0;21;416;0.05;0.0;0.0
6312_7.txt;8;0;1;9;365;0.02;0.0;0.0
10791_9.txt;10;1;2;13;177;0.06;0.01;0.01
2724_9.txt;9;0;0;9;299;0.03;0.0;0.0
7207_7.txt;19;0;2;21;416;0.05;0.0;0.0
2870_10.txt;1;0;0;1;138;0.01;0.0;0.0
2316_10.txt;5;0;3;8;153;0.03;0.0;0.02
1750_10.txt;0;0;0;0;321;0.0;0.0;0.0
9154_7.txt;0;0;0;0;162;0.0;0.0;0.0
8986_8.txt;4;0;0;4;141;0.03;0.0;0.0
9990_8.txt;8;0;0;8;349;0.02;0.0;0.0
2537_7.txt;2;0;0;2;93;0.02;0.0;0.0
10644_8.txt;5;3;0;8;204;0.02;0.01;0.0
1992_10.txt;3;0;0;3;185;0.02;0.0;0.0
5037_10.txt;2;0;0;2;308;0.01;0.0;0.0
4402_8.txt;10;1;0;11;113;0.09;0.01;0.0
11970_10.txt;2;1;2;5;198;0.01;0.01;0.01
9221_7.txt;3;0;0;3;312;0.01;0.0;0.0
887_10.txt;25;2;0;27;800;0.03;0.0;0.0
5151_8.txt;4;0;0;4;647;0.01;0.0;0.0
7687_8.txt;29;6;11;46;656;0.04;0.01;0.02
1578_8.txt;32;2;0;34;321;0.1;0.01;0.0
9720_8.txt;8;0;0;8;137;0.06;0.0;0.0
1855_9.txt;10;2;1;13;270;0.04;0.01;0.0
10439_8.txt;7;2;0;9;442;0.02;0.0;0.0
1630_8.txt;1;1;0;2;177;0.01;0.01;0.0
1220_9.txt;1;0;0;1;135;0.01;0.0;0.0
7870_10.txt;2;0;0;2;243;0.01;0.0;0.0
6600_9.txt;0;2;0;2;222;0.0;0.01;0.0
10025_9.txt;2;0;0;2;167;0.01;0.0;0.0
2930_10.txt;3;0;0;3;125;0.02;0.0;0.0
10485_8.txt;0;0;0;0;160;0.0;0.0;0.0
4454_9.txt;3;1;0;4;147;0.02;0.01;0.0
4590_10.txt;3;0;0;3;130;0.02;0.0;0.0
11214_7.txt;5;4;0;9;225;0.02;0.02;0.0
1253_10.txt;0;8;7;15;376;0.0;0.02;0.02
6342_10.txt;8;1;0;9;193;0.04;0.01;0.0
6749_9.txt;19;0;0;19;507;0.04;0.0;0.0
8259_9.txt;34;2;0;36;438;0.08;0.0;0.0
9358_8.txt;33;3;2;38;562;0.06;0.01;0.0
8047_9.txt;11;0;0;11;92;0.12;0.0;0.0
7205_10.txt;10;0;0;10;175;0.06;0.0;0.0
8308_7.txt;8;0;0;8;119;0.07;0.0;0.0
2044_8.txt;4;1;0;5;465;0.01;0.0;0.0
85_10.txt;0;0;3;3;236;0.0;0.0;0.01
8927_8.txt;21;7;0;28;381;0.06;0.02;0.0
3995_8.txt;3;0;0;3;149;0.02;0.0;0.0
10671_10.txt;0;1;0;1;61;0.0;0.02;0.0
9341_7.txt;6;0;0;6;148;0.04;0.0;0.0
10521_9.txt;24;3;0;27;471;0.05;0.01;0.0
1546_8.txt;2;0;0;2;137;0.01;0.0;0.0
113_10.txt;0;0;0;0;136;0.0;0.0;0.0
6525_7.txt;85;7;4;96;556;0.15;0.01;0.01
11562_9.txt;19;0;2;21;416;0.05;0.0;0.0
1026_9.txt;26;1;3;30;605;0.04;0.0;0.0
5350_9.txt;14;0;1;15;169;0.08;0.0;0.01
6772_10.txt;9;0;0;9;150;0.06;0.0;0.0
5014_9.txt;4;5;1;10;486;0.01;0.01;0.0
2990_10.txt;12;3;0;15;577;0.02;0.01;0.0
5448_10.txt;5;0;2;7;80;0.06;0.0;0.03
2401_8.txt;5;0;0;5;136;0.04;0.0;0.0
1254_7.txt;8;0;0;8;160;0.05;0.0;0.0
11408_7.txt;34;0;2;36;377;0.09;0.0;0.01
558_10.txt;0;0;0;0;127;0.0;0.0;0.0
1275_8.txt;4;0;0;4;279;0.01;0.0;0.0
10960_8.txt;4;0;3;7;184;0.02;0.0;0.02
2244_9.txt;0;0;0;0;145;0.0;0.0;0.0
3363_10.txt;9;0;0;9;300;0.03;0.0;0.0
3799_8.txt;7;2;0;9;835;0.01;0.0;0.0
6637_8.txt;6;6;0;12;512;0.01;0.01;0.0
1667_7.txt;10;3;0;13;634;0.02;0.0;0.0
8540_9.txt;7;0;0;7;162;0.04;0.0;0.0
6528_9.txt;0;0;12;12;257;0.0;0.0;0.05
2736_9.txt;19;1;2;22;573;0.03;0.0;0.0
7327_10.txt;23;0;5;28;1095;0.02;0.0;0.0
4756_10.txt;3;0;0;3;163;0.02;0.0;0.0
5257_10.txt;0;0;0;0;160;0.0;0.0;0.0
10848_10.txt;13;2;0;15;323;0.04;0.01;0.0
10740_8.txt;8;2;0;10;151;0.05;0.01;0.0
7154_10.txt;6;0;1;7;174;0.03;0.0;0.01
6221_7.txt;23;0;3;26;307;0.07;0.0;0.01
12108_9.txt;5;2;0;7;256;0.02;0.01;0.0
9740_7.txt;53;9;0;62;535;0.1;0.02;0.0
10199_7.txt;9;0;0;9;403;0.02;0.0;0.0
10534_7.txt;4;1;0;5;136;0.03;0.01;0.0
4685_7.txt;14;1;0;15;298;0.05;0.0;0.0
7598_10.txt;0;0;0;0;155;0.0;0.0;0.0
2919_10.txt;4;3;0;7;134;0.03;0.02;0.0
5061_8.txt;4;0;1;5;177;0.02;0.0;0.01
9112_9.txt;0;1;0;1;177;0.0;0.01;0.0
11460_10.txt;10;0;0;10;596;0.02;0.0;0.0
3323_9.txt;9;0;4;13;190;0.05;0.0;0.02
6325_7.txt;1;2;0;3;122;0.01;0.02;0.0
4986_8.txt;0;0;1;1;91;0.0;0.0;0.01
12067_9.txt;30;4;0;34;647;0.05;0.01;0.0
274_7.txt;10;0;0;10;234;0.04;0.0;0.0
220_10.txt;57;1;0;58;796;0.07;0.0;0.0
9105_9.txt;10;1;0;11;265;0.04;0.0;0.0
1885_10.txt;12;0;0;12;344;0.03;0.0;0.0
12417_10.txt;51;12;6;69;831;0.06;0.01;0.01
5786_10.txt;0;0;0;0;153;0.0;0.0;0.0
738_8.txt;14;0;4;18;291;0.05;0.0;0.01
605_8.txt;29;7;9;45;827;0.04;0.01;0.01
7591_8.txt;4;0;0;4;397;0.01;0.0;0.0
3411_9.txt;3;1;0;4;127;0.02;0.01;0.0
1213_10.txt;2;0;0;2;405;0.0;0.0;0.0
5408_7.txt;2;0;3;5;242;0.01;0.0;0.01
4538_7.txt;1;0;0;1;180;0.01;0.0;0.0
7068_8.txt;46;1;0;47;662;0.07;0.0;0.0
8924_10.txt;2;0;0;2;143;0.01;0.0;0.0
12355_10.txt;2;0;0;2;152;0.01;0.0;0.0
8745_7.txt;14;6;0;20;275;0.05;0.02;0.0
5564_10.txt;2;1;3;6;146;0.01;0.01;0.02
5372_7.txt;12;0;4;16;344;0.03;0.0;0.01
5551_7.txt;8;2;0;10;452;0.02;0.0;0.0
8391_8.txt;16;2;0;18;392;0.04;0.01;0.0
1461_10.txt;0;2;1;3;229;0.0;0.01;0.0
6136_10.txt;0;0;0;0;141;0.0;0.0;0.0
11525_8.txt;4;0;0;4;237;0.02;0.0;0.0
9227_9.txt;8;0;0;8;334;0.02;0.0;0.0
5479_10.txt;26;6;0;32;281;0.09;0.02;0.0
3867_10.txt;0;1;0;1;48;0.0;0.02;0.0
1116_9.txt;1;0;0;1;41;0.02;0.0;0.0
876_7.txt;15;0;0;15;212;0.07;0.0;0.0
6353_10.txt;2;0;0;2;65;0.03;0.0;0.0
12349_10.txt;3;0;0;3;77;0.04;0.0;0.0
6752_7.txt;16;2;2;20;200;0.08;0.01;0.01
2282_10.txt;4;1;0;5;251;0.02;0.0;0.0
11653_10.txt;12;0;0;12;178;0.07;0.0;0.0
10594_8.txt;7;10;4;21;547;0.01;0.02;0.01
7652_8.txt;7;0;1;8;271;0.03;0.0;0.0
4394_9.txt;8;11;7;26;761;0.01;0.01;0.01
1858_10.txt;12;4;1;17;517;0.02;0.01;0.0
6572_8.txt;6;0;2;8;331;0.02;0.0;0.01
475_10.txt;12;0;0;12;143;0.08;0.0;0.0
8241_7.txt;13;0;1;14;372;0.03;0.0;0.0
5905_9.txt;36;5;0;41;741;0.05;0.01;0.0
7483_10.txt;25;0;0;25;209;0.12;0.0;0.0
5281_10.txt;4;6;0;10;275;0.01;0.02;0.0
9929_7.txt;9;1;1;11;252;0.04;0.0;0.0
11888_9.txt;3;0;0;3;145;0.02;0.0;0.0
11345_7.txt;2;0;0;2;127;0.02;0.0;0.0
5303_10.txt;7;4;0;11;160;0.04;0.03;0.0
7418_8.txt;4;2;0;6;191;0.02;0.01;0.0
2095_9.txt;10;0;0;10;241;0.04;0.0;0.0
1786_7.txt;26;0;0;26;542;0.05;0.0;0.0
12494_8.txt;2;0;0;2;236;0.01;0.0;0.0
6952_7.txt;38;3;0;41;262;0.15;0.01;0.0
5489_10.txt;1;1;0;2;119;0.01;0.01;0.0
9178_10.txt;0;0;0;0;84;0.0;0.0;0.0
6678_7.txt;7;0;0;7;236;0.03;0.0;0.0
11017_9.txt;6;0;0;6;299;0.02;0.0;0.0
8993_7.txt;3;0;0;3;192;0.02;0.0;0.0
4833_10.txt;10;2;0;12;739;0.01;0.0;0.0
6990_8.txt;7;0;4;11;182;0.04;0.0;0.02
7044_10.txt;20;2;2;24;496;0.04;0.0;0.0
9805_10.txt;29;0;4;33;381;0.08;0.0;0.01
1269_8.txt;43;5;4;52;454;0.09;0.01;0.01
2025_10.txt;3;0;0;3;129;0.02;0.0;0.0
8887_9.txt;0;0;0;0;82;0.0;0.0;0.0
2618_7.txt;19;2;0;21;432;0.04;0.0;0.0
11883_8.txt;5;0;0;5;239;0.02;0.0;0.0
11300_8.txt;5;1;0;6;184;0.03;0.01;0.0
8809_10.txt;0;3;0;3;119;0.0;0.03;0.0
577_8.txt;0;0;0;0;143;0.0;0.0;0.0
2879_9.txt;3;0;3;6;274;0.01;0.0;0.01
11468_9.txt;6;0;2;8;347;0.02;0.0;0.01
9999_8.txt;5;0;0;5;64;0.08;0.0;0.0
8287_9.txt;36;1;1;38;888;0.04;0.0;0.0
5688_8.txt;4;0;0;4;176;0.02;0.0;0.0
6244_8.txt;1;5;0;6;362;0.0;0.01;0.0
12488_8.txt;0;0;1;1;403;0.0;0.0;0.0
10596_8.txt;0;0;3;3;133;0.0;0.0;0.02
5524_8.txt;22;12;1;35;1012;0.02;0.01;0.0
8874_8.txt;0;0;0;0;140;0.0;0.0;0.0
10304_7.txt;14;2;0;16;273;0.05;0.01;0.0
1106_8.txt;20;6;0;26;231;0.09;0.03;0.0
2046_8.txt;10;6;5;21;333;0.03;0.02;0.02
10470_9.txt;4;1;1;6;545;0.01;0.0;0.0
3553_8.txt;13;4;0;17;288;0.05;0.01;0.0
3266_7.txt;16;0;1;17;207;0.08;0.0;0.0
10316_8.txt;0;0;0;0;218;0.0;0.0;0.0
7957_10.txt;1;0;0;1;147;0.01;0.0;0.0
6917_9.txt;50;7;8;65;629;0.08;0.01;0.01
1493_9.txt;7;1;0;8;284;0.02;0.0;0.0
962_8.txt;4;3;0;7;299;0.01;0.01;0.0
8373_9.txt;0;0;1;1;173;0.0;0.0;0.01
5574_10.txt;15;0;0;15;195;0.08;0.0;0.0
504_8.txt;3;0;3;6;429;0.01;0.0;0.01
9870_9.txt;12;1;6;19;280;0.04;0.0;0.02
12272_7.txt;17;4;9;30;1060;0.02;0.0;0.01
10392_10.txt;0;0;0;0;53;0.0;0.0;0.0
7040_10.txt;3;0;0;3;143;0.02;0.0;0.0
8185_8.txt;0;0;0;0;57;0.0;0.0;0.0
5864_7.txt;6;2;0;8;265;0.02;0.01;0.0
11797_8.txt;2;0;2;4;59;0.03;0.0;0.03
1615_8.txt;8;2;0;10;114;0.07;0.02;0.0
7781_8.txt;31;6;3;40;713;0.04;0.01;0.0
6249_7.txt;2;2;0;4;571;0.0;0.0;0.0
2386_8.txt;16;1;5;22;548;0.03;0.0;0.01
2242_7.txt;2;0;2;4;109;0.02;0.0;0.02
1665_7.txt;1;0;0;1;100;0.01;0.0;0.0
3854_10.txt;10;0;0;10;133;0.08;0.0;0.0
12177_7.txt;7;0;0;7;206;0.03;0.0;0.0
3950_7.txt;0;0;6;6;156;0.0;0.0;0.04
294_10.txt;41;0;0;41;252;0.16;0.0;0.0
4555_9.txt;5;0;0;5;83;0.06;0.0;0.0
3757_7.txt;2;0;0;2;156;0.01;0.0;0.0
6200_7.txt;17;0;0;17;221;0.08;0.0;0.0
10632_10.txt;0;2;0;2;292;0.0;0.01;0.0
288_10.txt;2;2;0;4;163;0.01;0.01;0.0
3974_8.txt;2;1;0;3;525;0.0;0.0;0.0
8411_7.txt;4;3;0;7;161;0.02;0.02;0.0
296_10.txt;4;0;4;8;283;0.01;0.0;0.01
8509_7.txt;4;1;0;5;295;0.01;0.0;0.0
5141_9.txt;0;0;0;0;132;0.0;0.0;0.0
11484_9.txt;4;3;6;13;415;0.01;0.01;0.01
8174_9.txt;9;0;0;9;180;0.05;0.0;0.0
11795_10.txt;3;2;0;5;173;0.02;0.01;0.0
3451_8.txt;18;0;5;23;233;0.08;0.0;0.02
5203_7.txt;19;3;0;22;524;0.04;0.01;0.0
9553_9.txt;2;0;0;2;40;0.05;0.0;0.0
1277_10.txt;20;0;2;22;127;0.16;0.0;0.02
9100_7.txt;0;2;0;2;147;0.0;0.01;0.0
10211_7.txt;19;2;0;21;629;0.03;0.0;0.0
841_10.txt;3;0;0;3;159;0.02;0.0;0.0
2828_9.txt;2;0;0;2;155;0.01;0.0;0.0
4155_10.txt;6;1;0;7;197;0.03;0.01;0.0
10362_8.txt;12;1;1;14;384;0.03;0.0;0.0
2904_9.txt;3;4;3;10;213;0.01;0.02;0.01
8454_8.txt;6;1;4;11;465;0.01;0.0;0.01
5836_8.txt;4;0;2;6;329;0.01;0.0;0.01
4944_7.txt;0;0;0;0;185;0.0;0.0;0.0
3787_10.txt;1;0;6;7;76;0.01;0.0;0.08
5712_8.txt;6;0;0;6;405;0.01;0.0;0.0
4961_10.txt;8;0;0;8;194;0.04;0.0;0.0
2139_9.txt;0;1;0;1;226;0.0;0.0;0.0
14_10.txt;6;0;0;6;116;0.05;0.0;0.0
5789_9.txt;5;3;0;8;215;0.02;0.01;0.0
6409_7.txt;3;1;2;6;267;0.01;0.0;0.01
7164_10.txt;30;1;3;34;835;0.04;0.0;0.0
5984_10.txt;8;0;3;11;319;0.03;0.0;0.01
9861_10.txt;76;1;6;83;755;0.1;0.0;0.01
10953_10.txt;5;1;0;6;150;0.03;0.01;0.0
2078_9.txt;11;3;0;14;203;0.05;0.01;0.0
8532_7.txt;5;1;2;8;240;0.02;0.0;0.01
3742_9.txt;1;0;0;1;132;0.01;0.0;0.0
3512_7.txt;0;0;0;0;47;0.0;0.0;0.0
9875_7.txt;13;0;3;16;239;0.05;0.0;0.01
3760_7.txt;7;0;0;7;155;0.05;0.0;0.0
4436_7.txt;2;2;2;6;159;0.01;0.01;0.01
9445_10.txt;8;0;0;8;234;0.03;0.0;0.0
5764_7.txt;6;1;0;7;210;0.03;0.0;0.0
8189_10.txt;0;0;1;1;174;0.0;0.0;0.01
3682_8.txt;53;14;2;69;1091;0.05;0.01;0.0
8473_8.txt;18;2;0;20;325;0.06;0.01;0.0
6590_9.txt;7;0;0;7;238;0.03;0.0;0.0
97_9.txt;3;0;0;3;110;0.03;0.0;0.0
3938_9.txt;14;0;0;14;218;0.06;0.0;0.0
6738_7.txt;13;2;0;15;183;0.07;0.01;0.0
4438_8.txt;18;9;0;27;237;0.08;0.04;0.0
9800_9.txt;51;5;3;59;629;0.08;0.01;0.0
2056_9.txt;2;0;1;3;224;0.01;0.0;0.0
5686_9.txt;68;7;1;76;411;0.17;0.02;0.0
997_7.txt;6;4;0;10;140;0.04;0.03;0.0
6701_9.txt;11;1;0;12;391;0.03;0.0;0.0
999_10.txt;38;4;1;43;468;0.08;0.01;0.0
11974_10.txt;16;3;0;19;808;0.02;0.0;0.0
12385_7.txt;25;2;0;27;324;0.08;0.01;0.0
4036_7.txt;20;1;3;24;319;0.06;0.0;0.01
635_9.txt;0;0;0;0;213;0.0;0.0;0.0
12224_9.txt;0;0;0;0;89;0.0;0.0;0.0
5282_10.txt;8;6;1;15;382;0.02;0.02;0.0
11183_7.txt;17;1;1;19;582;0.03;0.0;0.0
10838_10.txt;13;0;0;13;176;0.07;0.0;0.0
5267_7.txt;7;0;0;7;137;0.05;0.0;0.0
7533_10.txt;6;1;1;8;207;0.03;0.0;0.0
9232_8.txt;20;0;5;25;334;0.06;0.0;0.01
2707_10.txt;5;0;0;5;178;0.03;0.0;0.0
3670_10.txt;9;1;0;10;151;0.06;0.01;0.0
7867_7.txt;22;0;3;25;224;0.1;0.0;0.01
3168_7.txt;4;3;0;7;164;0.02;0.02;0.0
11426_10.txt;0;1;0;1;185;0.0;0.01;0.0
6110_8.txt;17;0;0;17;342;0.05;0.0;0.0
822_9.txt;7;0;0;7;282;0.02;0.0;0.0
2685_10.txt;0;0;0;0;37;0.0;0.0;0.0
6115_10.txt;5;0;0;5;153;0.03;0.0;0.0
4736_10.txt;0;0;0;0;54;0.0;0.0;0.0
11943_7.txt;24;0;0;24;489;0.05;0.0;0.0
10287_8.txt;6;0;0;6;107;0.06;0.0;0.0
4249_10.txt;2;0;2;4;111;0.02;0.0;0.02
7500_8.txt;4;0;0;4;134;0.03;0.0;0.0
2174_8.txt;20;4;0;24;358;0.06;0.01;0.0
5552_8.txt;64;4;1;69;879;0.07;0.0;0.0
12254_10.txt;7;0;0;7;119;0.06;0.0;0.0
5749_10.txt;0;0;0;0;213;0.0;0.0;0.0
9529_9.txt;39;0;0;39;362;0.11;0.0;0.0
8463_9.txt;1;4;8;13;688;0.0;0.01;0.01
5702_10.txt;6;2;0;8;171;0.04;0.01;0.0
587_10.txt;2;2;0;4;389;0.01;0.01;0.0
1539_10.txt;3;1;0;4;133;0.02;0.01;0.0
9788_9.txt;2;0;0;2;159;0.01;0.0;0.0
3654_10.txt;2;0;0;2;47;0.04;0.0;0.0
9654_10.txt;9;1;0;10;194;0.05;0.01;0.0
4370_10.txt;4;0;0;4;48;0.08;0.0;0.0
8761_10.txt;6;1;0;7;152;0.04;0.01;0.0
240_10.txt;22;1;3;26;200;0.11;0.01;0.01
11512_10.txt;27;3;2;32;597;0.05;0.01;0.0
7213_10.txt;26;1;5;32;903;0.03;0.0;0.01
12143_8.txt;4;4;0;8;134;0.03;0.03;0.0
2222_10.txt;0;0;0;0;72;0.0;0.0;0.0
2192_9.txt;5;2;0;7;154;0.03;0.01;0.0
4026_9.txt;4;1;0;5;177;0.02;0.01;0.0
5693_7.txt;4;1;0;5;275;0.01;0.0;0.0
6094_10.txt;3;0;0;3;175;0.02;0.0;0.0
7288_7.txt;1;1;0;2;304;0.0;0.0;0.0
10835_10.txt;4;1;0;5;154;0.03;0.01;0.0
3554_10.txt;15;0;0;15;134;0.11;0.0;0.0
12063_10.txt;2;0;0;2;281;0.01;0.0;0.0
6539_9.txt;59;4;2;65;756;0.08;0.01;0.0
7184_7.txt;0;0;0;0;134;0.0;0.0;0.0
11588_10.txt;0;0;0;0;202;0.0;0.0;0.0
6116_8.txt;4;0;0;4;230;0.02;0.0;0.0
12182_8.txt;10;4;0;14;404;0.02;0.01;0.0
10432_10.txt;0;2;0;2;222;0.0;0.01;0.0
4628_9.txt;2;2;5;9;262;0.01;0.01;0.02
12069_10.txt;3;1;0;4;142;0.02;0.01;0.0
4141_10.txt;1;0;0;1;52;0.02;0.0;0.0
3810_9.txt;0;0;0;0;328;0.0;0.0;0.0
2729_10.txt;6;0;0;6;170;0.04;0.0;0.0
8402_10.txt;2;0;1;3;84;0.02;0.0;0.01
8886_10.txt;6;1;0;7;146;0.04;0.01;0.0
4268_10.txt;0;0;0;0;62;0.0;0.0;0.0
10423_9.txt;9;2;1;12;148;0.06;0.01;0.01
9803_7.txt;25;0;0;25;184;0.14;0.0;0.0
8482_7.txt;7;0;2;9;378;0.02;0.0;0.01
7614_10.txt;1;0;0;1;154;0.01;0.0;0.0
4362_7.txt;39;6;5;50;803;0.05;0.01;0.01
6052_9.txt;2;2;0;4;128;0.02;0.02;0.0
9139_8.txt;2;2;1;5;179;0.01;0.01;0.01
8310_10.txt;3;0;0;3;56;0.05;0.0;0.0
7456_10.txt;34;1;9;44;842;0.04;0.0;0.01
4446_10.txt;10;4;0;14;362;0.03;0.01;0.0
4424_7.txt;10;2;0;12;319;0.03;0.01;0.0
10268_9.txt;21;0;0;21;182;0.12;0.0;0.0
5610_7.txt;2;4;3;9;305;0.01;0.01;0.01
10761_10.txt;0;10;8;18;860;0.0;0.01;0.01
10912_7.txt;18;0;0;18;225;0.08;0.0;0.0
8817_8.txt;23;20;0;43;636;0.04;0.03;0.0
971_8.txt;4;2;1;7;481;0.01;0.0;0.0
1316_9.txt;2;0;4;6;252;0.01;0.0;0.02
11491_8.txt;5;0;0;5;166;0.03;0.0;0.0
11769_7.txt;8;1;2;11;146;0.05;0.01;0.01
1573_9.txt;10;0;0;10;136;0.07;0.0;0.0
5395_10.txt;0;0;0;0;223;0.0;0.0;0.0
2882_9.txt;5;0;0;5;262;0.02;0.0;0.0
6811_10.txt;6;0;0;6;186;0.03;0.0;0.0
8669_7.txt;4;0;0;4;208;0.02;0.0;0.0
11433_8.txt;14;0;0;14;199;0.07;0.0;0.0
9431_10.txt;8;5;0;13;172;0.05;0.03;0.0
11096_10.txt;8;0;2;10;193;0.04;0.0;0.01
10138_8.txt;4;0;5;9;322;0.01;0.0;0.02
8202_10.txt;7;0;0;7;191;0.04;0.0;0.0
7965_10.txt;0;0;0;0;173;0.0;0.0;0.0
996_9.txt;8;0;0;8;90;0.09;0.0;0.0
9376_10.txt;2;0;0;2;35;0.06;0.0;0.0
315_10.txt;2;0;0;2;148;0.01;0.0;0.0
8859_10.txt;46;0;0;46;531;0.09;0.0;0.0
2622_8.txt;4;2;2;8;231;0.02;0.01;0.01
5081_8.txt;10;0;0;10;268;0.04;0.0;0.0
7625_10.txt;6;0;0;6;131;0.05;0.0;0.0
5265_9.txt;0;0;0;0;144;0.0;0.0;0.0
8091_9.txt;43;6;10;59;1096;0.04;0.01;0.01
5302_9.txt;3;0;0;3;109;0.03;0.0;0.0
8994_8.txt;8;2;0;10;477;0.02;0.0;0.0
11518_8.txt;8;0;0;8;99;0.08;0.0;0.0
6592_10.txt;5;1;0;6;111;0.05;0.01;0.0
11597_10.txt;0;0;1;1;351;0.0;0.0;0.0
448_10.txt;7;0;0;7;143;0.05;0.0;0.0
139_10.txt;11;1;1;13;356;0.03;0.0;0.0
9447_8.txt;32;0;0;32;325;0.1;0.0;0.0
11735_10.txt;14;4;0;18;360;0.04;0.01;0.0
9753_10.txt;4;1;0;5;225;0.02;0.0;0.0
9306_9.txt;5;0;0;5;134;0.04;0.0;0.0
5371_8.txt;6;1;0;7;307;0.02;0.0;0.0
4747_8.txt;9;1;0;10;244;0.04;0.0;0.0
8450_7.txt;34;1;11;46;692;0.05;0.0;0.02
9992_10.txt;3;0;2;5;139;0.02;0.0;0.01
10014_8.txt;18;3;0;21;223;0.08;0.01;0.0
1342_10.txt;4;0;0;4;72;0.06;0.0;0.0
10964_7.txt;10;0;0;10;494;0.02;0.0;0.0
4070_10.txt;5;0;0;5;228;0.02;0.0;0.0
520_8.txt;18;0;1;19;258;0.07;0.0;0.0
8456_10.txt;0;1;0;1;182;0.0;0.01;0.0
4481_8.txt;18;0;4;22;219;0.08;0.0;0.02
1262_8.txt;15;0;0;15;137;0.11;0.0;0.0
5801_10.txt;3;0;0;3;156;0.02;0.0;0.0
1403_7.txt;5;0;0;5;151;0.03;0.0;0.0
8967_8.txt;46;2;5;53;466;0.1;0.0;0.01
6339_7.txt;9;0;0;9;128;0.07;0.0;0.0
4664_8.txt;37;0;0;37;446;0.08;0.0;0.0
10297_8.txt;2;0;0;2;125;0.02;0.0;0.0
1460_10.txt;2;5;0;7;136;0.01;0.04;0.0
1001_8.txt;15;2;3;20;190;0.08;0.01;0.02
10875_8.txt;21;4;4;29;356;0.06;0.01;0.01
12134_8.txt;63;3;11;77;879;0.07;0.0;0.01
11286_10.txt;20;0;2;22;297;0.07;0.0;0.01
2393_8.txt;0;0;0;0;64;0.0;0.0;0.0
4681_7.txt;16;0;0;16;148;0.11;0.0;0.0
5160_8.txt;19;1;1;21;228;0.08;0.0;0.0
10609_10.txt;7;1;0;8;183;0.04;0.01;0.0
10356_9.txt;57;9;4;70;942;0.06;0.01;0.0
1446_10.txt;5;1;0;6;190;0.03;0.01;0.0
11131_9.txt;6;0;0;6;190;0.03;0.0;0.0
6969_10.txt;9;2;2;13;422;0.02;0.0;0.0
9343_8.txt;26;3;0;29;439;0.06;0.01;0.0
2894_10.txt;6;2;9;17;470;0.01;0.0;0.02
7931_8.txt;2;0;0;2;302;0.01;0.0;0.0
3161_10.txt;3;0;0;3;204;0.01;0.0;0.0
9823_7.txt;4;0;0;4;203;0.02;0.0;0.0
4798_8.txt;0;0;0;0;154;0.0;0.0;0.0
4923_7.txt;38;2;3;43;634;0.06;0.0;0.0
9257_7.txt;6;0;0;6;171;0.04;0.0;0.0
7389_10.txt;8;11;3;22;383;0.02;0.03;0.01
3712_7.txt;19;1;0;20;435;0.04;0.0;0.0
6336_7.txt;0;3;0;3;210;0.0;0.01;0.0
10227_10.txt;2;1;1;4;468;0.0;0.0;0.0
7917_8.txt;2;0;0;2;475;0.0;0.0;0.0
2093_7.txt;7;0;0;7;172;0.04;0.0;0.0
4351_10.txt;4;2;0;6;153;0.03;0.01;0.0
5928_8.txt;2;0;0;2;231;0.01;0.0;0.0
1697_10.txt;0;0;0;0;158;0.0;0.0;0.0
9177_10.txt;5;1;0;6;130;0.04;0.01;0.0
8776_10.txt;14;0;0;14;166;0.08;0.0;0.0
9948_8.txt;3;0;0;3;167;0.02;0.0;0.0
11566_10.txt;2;0;0;2;186;0.01;0.0;0.0
11202_10.txt;1;0;1;2;125;0.01;0.0;0.01
260_7.txt;0;0;2;2;141;0.0;0.0;0.01
7551_10.txt;1;0;0;1;210;0.0;0.0;0.0
2281_9.txt;19;3;4;26;347;0.05;0.01;0.01
7970_10.txt;7;0;0;7;94;0.07;0.0;0.0
5338_10.txt;13;0;0;13;285;0.05;0.0;0.0
12090_9.txt;9;0;0;9;247;0.04;0.0;0.0
10509_7.txt;1;1;0;2;283;0.0;0.0;0.0
7888_8.txt;19;0;1;20;263;0.07;0.0;0.0
8096_10.txt;9;1;2;12;216;0.04;0.0;0.01
6095_7.txt;10;1;0;11;487;0.02;0.0;0.0
9039_10.txt;2;9;0;11;187;0.01;0.05;0.0
2298_7.txt;19;0;3;22;339;0.06;0.0;0.01
9703_9.txt;8;3;0;11;176;0.05;0.02;0.0
10979_9.txt;13;3;0;16;406;0.03;0.01;0.0
3492_7.txt;4;1;0;5;75;0.05;0.01;0.0
1458_9.txt;0;3;3;6;372;0.0;0.01;0.01
7335_7.txt;6;0;3;9;312;0.02;0.0;0.01
5249_9.txt;2;0;0;2;168;0.01;0.0;0.0
7693_9.txt;0;0;1;1;136;0.0;0.0;0.01
9685_10.txt;0;0;0;0;52;0.0;0.0;0.0
5186_10.txt;0;0;0;0;159;0.0;0.0;0.0
5036_9.txt;21;0;4;25;364;0.06;0.0;0.01
7411_10.txt;0;0;1;1;335;0.0;0.0;0.0
10916_7.txt;13;0;1;14;164;0.08;0.0;0.01
3181_10.txt;8;0;0;8;130;0.06;0.0;0.0
505_9.txt;5;0;0;5;167;0.03;0.0;0.0
4293_8.txt;7;0;0;7;234;0.03;0.0;0.0
4330_10.txt;9;0;0;9;101;0.09;0.0;0.0
4921_8.txt;19;2;0;21;167;0.11;0.01;0.0
3094_10.txt;0;0;7;7;284;0.0;0.0;0.02
12111_7.txt;0;0;0;0;182;0.0;0.0;0.0
4622_8.txt;16;0;0;16;252;0.06;0.0;0.0
413_10.txt;5;1;0;6;136;0.04;0.01;0.0
2385_9.txt;12;0;2;14;420;0.03;0.0;0.0
10721_9.txt;0;0;0;0;148;0.0;0.0;0.0
8496_7.txt;4;0;0;4;237;0.02;0.0;0.0
10055_7.txt;9;0;0;9;207;0.04;0.0;0.0
7725_10.txt;1;2;0;3;466;0.0;0.0;0.0
1633_9.txt;2;0;0;2;146;0.01;0.0;0.0
2718_9.txt;6;2;0;8;125;0.05;0.02;0.0
4879_10.txt;2;1;0;3;147;0.01;0.01;0.0
9806_8.txt;13;11;0;24;282;0.05;0.04;0.0
7664_10.txt;2;1;0;3;45;0.04;0.02;0.0
4502_7.txt;5;0;0;5;77;0.06;0.0;0.0
5237_10.txt;10;0;1;11;263;0.04;0.0;0.0
979_8.txt;11;1;0;12;154;0.07;0.01;0.0
5656_10.txt;2;2;0;4;163;0.01;0.01;0.0
1027_8.txt;11;0;0;11;351;0.03;0.0;0.0
8863_8.txt;11;6;0;17;343;0.03;0.02;0.0
10639_7.txt;19;0;1;20;695;0.03;0.0;0.0
6652_10.txt;10;2;0;12;191;0.05;0.01;0.0
12279_9.txt;0;0;0;0;61;0.0;0.0;0.0
2524_10.txt;1;1;0;2;156;0.01;0.01;0.0
2344_9.txt;10;0;0;10;307;0.03;0.0;0.0
484_8.txt;22;0;0;22;334;0.07;0.0;0.0
4295_9.txt;10;2;0;12;180;0.06;0.01;0.0
5145_10.txt;2;0;0;2;340;0.01;0.0;0.0
5650_10.txt;4;0;0;4;182;0.02;0.0;0.0
10472_7.txt;1;1;4;6;172;0.01;0.01;0.02
347_10.txt;10;0;0;10;141;0.07;0.0;0.0
2573_10.txt;10;0;0;10;284;0.04;0.0;0.0
5468_7.txt;18;3;8;29;310;0.06;0.01;0.03
4431_10.txt;15;6;2;23;541;0.03;0.01;0.0
9312_10.txt;0;0;0;0;160;0.0;0.0;0.0
620_10.txt;4;0;0;4;267;0.01;0.0;0.0
1136_8.txt;0;0;0;0;247;0.0;0.0;0.0
1988_9.txt;13;0;3;16;364;0.04;0.0;0.01
3104_10.txt;15;0;0;15;251;0.06;0.0;0.0
428_7.txt;0;1;0;1;58;0.0;0.02;0.0
7208_7.txt;12;0;0;12;166;0.07;0.0;0.0
8549_8.txt;4;0;0;4;170;0.02;0.0;0.0
12186_9.txt;90;17;7;114;1140;0.08;0.01;0.01
10952_10.txt;7;2;0;9;220;0.03;0.01;0.0
3496_8.txt;0;0;0;0;114;0.0;0.0;0.0
3265_10.txt;6;0;0;6;116;0.05;0.0;0.0
11859_10.txt;6;1;1;8;166;0.04;0.01;0.01
425_10.txt;4;3;0;7;191;0.02;0.02;0.0
1653_10.txt;7;1;1;9;148;0.05;0.01;0.01
6455_7.txt;3;1;0;4;354;0.01;0.0;0.0
4990_8.txt;12;3;2;17;257;0.05;0.01;0.01
5996_7.txt;2;0;0;2;445;0.0;0.0;0.0
6617_8.txt;5;5;4;14;404;0.01;0.01;0.01
3316_10.txt;5;0;0;5;145;0.03;0.0;0.0
3328_7.txt;1;0;0;1;182;0.01;0.0;0.0
12455_9.txt;0;0;0;0;176;0.0;0.0;0.0
8195_10.txt;2;0;0;2;63;0.03;0.0;0.0
7791_10.txt;2;2;0;4;131;0.02;0.02;0.0
12039_10.txt;5;2;0;7;233;0.02;0.01;0.0
8448_10.txt;4;0;0;4;101;0.04;0.0;0.0
158_10.txt;3;1;0;4;261;0.01;0.0;0.0
9856_8.txt;0;0;0;0;132;0.0;0.0;0.0
7879_7.txt;10;1;2;13;203;0.05;0.0;0.01
2972_7.txt;7;2;0;9;142;0.05;0.01;0.0
10090_8.txt;7;0;1;8;190;0.04;0.0;0.01
11302_8.txt;5;0;0;5;328;0.02;0.0;0.0
10530_10.txt;19;2;0;21;297;0.06;0.01;0.0
11004_8.txt;17;2;0;19;243;0.07;0.01;0.0
2977_10.txt;7;0;0;7;207;0.03;0.0;0.0
2840_9.txt;9;0;0;9;196;0.05;0.0;0.0
185_9.txt;6;0;0;6;161;0.04;0.0;0.0
9756_10.txt;0;0;0;0;53;0.0;0.0;0.0
10891_7.txt;17;1;2;20;179;0.09;0.01;0.01
9184_10.txt;23;7;1;31;643;0.04;0.01;0.0
2833_7.txt;2;5;0;7;176;0.01;0.03;0.0
5195_7.txt;7;0;0;7;247;0.03;0.0;0.0
4821_10.txt;11;2;2;15;266;0.04;0.01;0.01
10854_10.txt;2;4;2;8;441;0.0;0.01;0.0
11384_7.txt;51;7;0;58;629;0.08;0.01;0.0
3666_9.txt;27;0;2;29;570;0.05;0.0;0.0
11629_10.txt;17;0;0;17;227;0.07;0.0;0.0
7304_8.txt;18;0;0;18;1056;0.02;0.0;0.0
4952_7.txt;35;0;0;35;537;0.07;0.0;0.0
9318_9.txt;4;1;0;5;127;0.03;0.01;0.0
12222_10.txt;0;0;0;0;210;0.0;0.0;0.0
9532_10.txt;0;1;0;1;307;0.0;0.0;0.0
352_10.txt;2;0;0;2;187;0.01;0.0;0.0
141_9.txt;5;1;0;6;48;0.1;0.02;0.0
9483_10.txt;2;0;0;2;123;0.02;0.0;0.0
4068_10.txt;0;0;0;0;160;0.0;0.0;0.0
10902_10.txt;0;0;0;0;194;0.0;0.0;0.0
3635_9.txt;5;0;0;5;139;0.04;0.0;0.0
390_10.txt;0;0;1;1;252;0.0;0.0;0.0
8734_9.txt;3;0;0;3;157;0.02;0.0;0.0
4668_10.txt;10;0;0;10;201;0.05;0.0;0.0
4580_8.txt;11;3;0;14;268;0.04;0.01;0.0
12092_7.txt;7;0;0;7;332;0.02;0.0;0.0
9095_10.txt;6;0;0;6;181;0.03;0.0;0.0
9951_7.txt;1;0;0;1;160;0.01;0.0;0.0
4319_9.txt;0;0;0;0;166;0.0;0.0;0.0
8665_8.txt;10;2;0;12;230;0.04;0.01;0.0
5162_9.txt;33;1;2;36;606;0.05;0.0;0.0
11292_10.txt;0;0;0;0;132;0.0;0.0;0.0
105_7.txt;15;0;0;15;414;0.04;0.0;0.0
2971_8.txt;0;2;0;2;186;0.0;0.01;0.0
10365_8.txt;5;2;0;7;214;0.02;0.01;0.0
12110_8.txt;0;1;0;1;184;0.0;0.01;0.0
5117_10.txt;11;1;6;18;264;0.04;0.0;0.02
11564_9.txt;2;1;0;3;167;0.01;0.01;0.0
5275_10.txt;0;4;0;4;136;0.0;0.03;0.0
7501_8.txt;0;0;1;1;63;0.0;0.0;0.02
9024_10.txt;11;4;0;15;227;0.05;0.02;0.0
8783_9.txt;19;0;0;19;194;0.1;0.0;0.0
2102_10.txt;13;2;4;19;223;0.06;0.01;0.02
576_10.txt;5;0;0;5;246;0.02;0.0;0.0
2456_8.txt;2;0;0;2;163;0.01;0.0;0.0
6708_10.txt;0;0;0;0;143;0.0;0.0;0.0
12116_9.txt;17;0;0;17;279;0.06;0.0;0.0
5626_8.txt;17;0;0;17;235;0.07;0.0;0.0
3312_8.txt;9;4;1;14;292;0.03;0.01;0.0
10332_8.txt;33;0;0;33;227;0.15;0.0;0.0
6355_8.txt;18;3;0;21;359;0.05;0.01;0.0
4072_10.txt;12;4;0;16;374;0.03;0.01;0.0
7199_8.txt;20;0;2;22;285;0.07;0.0;0.01
7452_10.txt;1;0;2;3;168;0.01;0.0;0.01
8831_8.txt;2;0;0;2;422;0.0;0.0;0.0
9214_7.txt;32;0;0;32;867;0.04;0.0;0.0
4763_8.txt;0;0;0;0;237;0.0;0.0;0.0
12265_10.txt;2;1;0;3;169;0.01;0.01;0.0
2782_10.txt;2;3;0;5;149;0.01;0.02;0.0
11599_8.txt;3;0;0;3;57;0.05;0.0;0.0
10667_8.txt;0;2;0;2;310;0.0;0.01;0.0
4946_10.txt;13;0;0;13;467;0.03;0.0;0.0
1861_10.txt;4;0;0;4;110;0.04;0.0;0.0
4954_10.txt;5;0;0;5;136;0.04;0.0;0.0
9578_10.txt;0;0;0;0;94;0.0;0.0;0.0
2475_10.txt;2;0;0;2;59;0.03;0.0;0.0
4476_9.txt;44;2;0;46;411;0.11;0.0;0.0
7594_8.txt;0;6;0;6;191;0.0;0.03;0.0
11830_9.txt;25;0;0;25;315;0.08;0.0;0.0
775_7.txt;5;0;0;5;404;0.01;0.0;0.0
9772_10.txt;17;2;0;19;217;0.08;0.01;0.0
4322_10.txt;1;0;0;1;370;0.0;0.0;0.0
11317_9.txt;26;1;4;31;562;0.05;0.0;0.01
11240_7.txt;1;0;0;1;101;0.01;0.0;0.0
4259_9.txt;2;1;0;3;183;0.01;0.01;0.0
386_7.txt;20;2;2;24;272;0.07;0.01;0.01
5807_8.txt;7;0;0;7;220;0.03;0.0;0.0
7194_7.txt;3;1;0;4;65;0.05;0.02;0.0
7654_10.txt;16;1;0;17;1151;0.01;0.0;0.0
4140_10.txt;16;0;0;16;204;0.08;0.0;0.0
9531_7.txt;17;0;1;18;612;0.03;0.0;0.0
9611_8.txt;9;1;0;10;370;0.02;0.0;0.0
7629_10.txt;17;0;0;17;165;0.1;0.0;0.0
5782_10.txt;11;0;1;12;411;0.03;0.0;0.0
7609_10.txt;0;0;0;0;143;0.0;0.0;0.0
7306_10.txt;37;2;2;41;766;0.05;0.0;0.0
1447_8.txt;6;1;4;11;465;0.01;0.0;0.01
183_8.txt;10;1;1;12;134;0.07;0.01;0.01
9226_8.txt;9;1;0;10;714;0.01;0.0;0.0
8179_7.txt;2;0;1;3;372;0.01;0.0;0.0
806_10.txt;4;0;0;4;139;0.03;0.0;0.0
2350_9.txt;11;1;0;12;174;0.06;0.01;0.0
2777_7.txt;47;4;1;52;739;0.06;0.01;0.0
3655_7.txt;2;1;0;3;170;0.01;0.01;0.0
7497_10.txt;0;0;0;0;145;0.0;0.0;0.0
835_8.txt;6;0;2;8;139;0.04;0.0;0.01
6849_7.txt;17;0;0;17;560;0.03;0.0;0.0
6408_10.txt;8;1;0;9;175;0.05;0.01;0.0
9008_10.txt;2;1;0;3;84;0.02;0.01;0.0
1606_7.txt;5;3;0;8;204;0.02;0.01;0.0
7008_8.txt;4;0;0;4;218;0.02;0.0;0.0
9131_9.txt;2;0;2;4;156;0.01;0.0;0.01
7122_8.txt;9;2;0;11;356;0.03;0.01;0.0
11550_7.txt;2;0;0;2;124;0.02;0.0;0.0
7665_7.txt;2;0;0;2;50;0.04;0.0;0.0
7437_10.txt;13;1;0;14;604;0.02;0.0;0.0
6596_8.txt;1;0;2;3;199;0.01;0.0;0.01
6393_8.txt;2;0;0;2;156;0.01;0.0;0.0
284_10.txt;10;1;0;11;202;0.05;0.0;0.0
7734_10.txt;1;0;0;1;164;0.01;0.0;0.0
6263_7.txt;1;1;3;5;86;0.01;0.01;0.03
12356_8.txt;0;0;0;0;166;0.0;0.0;0.0
6317_10.txt;0;0;0;0;54;0.0;0.0;0.0
10792_9.txt;8;0;2;10;67;0.12;0.0;0.03
9025_9.txt;6;0;0;6;92;0.07;0.0;0.0
821_10.txt;6;0;0;6;622;0.01;0.0;0.0
11355_8.txt;1;1;0;2;92;0.01;0.01;0.0
8123_8.txt;21;0;1;22;924;0.02;0.0;0.0
4019_7.txt;20;0;0;20;329;0.06;0.0;0.0
4532_7.txt;5;1;1;7;363;0.01;0.0;0.0
10406_10.txt;31;8;7;46;550;0.06;0.01;0.01
12487_10.txt;4;0;0;4;153;0.03;0.0;0.0
2324_8.txt;0;1;0;1;92;0.0;0.01;0.0
2171_10.txt;6;0;0;6;133;0.05;0.0;0.0
1255_10.txt;0;0;0;0;143;0.0;0.0;0.0
10703_7.txt;4;0;7;11;139;0.03;0.0;0.05
10951_8.txt;11;0;0;11;196;0.06;0.0;0.0
11081_10.txt;12;0;2;14;612;0.02;0.0;0.0
8762_8.txt;8;2;0;10;140;0.06;0.01;0.0
2449_7.txt;2;0;2;4;154;0.01;0.0;0.01
10117_8.txt;7;3;0;10;178;0.04;0.02;0.0
12180_10.txt;8;0;0;8;165;0.05;0.0;0.0
5355_8.txt;7;0;0;7;126;0.06;0.0;0.0
327_8.txt;0;2;0;2;334;0.0;0.01;0.0
9479_10.txt;15;8;4;27;150;0.1;0.05;0.03
3955_9.txt;0;0;0;0;52;0.0;0.0;0.0
11029_7.txt;6;0;0;6;375;0.02;0.0;0.0
6212_9.txt;17;0;3;20;463;0.04;0.0;0.01
6697_10.txt;8;4;0;12;161;0.05;0.02;0.0
8139_10.txt;0;0;0;0;56;0.0;0.0;0.0
3154_10.txt;14;0;0;14;187;0.07;0.0;0.0
6205_8.txt;9;0;0;9;147;0.06;0.0;0.0
5815_10.txt;7;0;0;7;196;0.04;0.0;0.0
2789_7.txt;3;0;0;3;145;0.02;0.0;0.0
6689_8.txt;11;0;3;14;314;0.04;0.0;0.01
6611_7.txt;0;1;0;1;464;0.0;0.0;0.0
12096_8.txt;7;0;0;7;148;0.05;0.0;0.0
4612_10.txt;24;0;0;24;119;0.2;0.0;0.0
10766_7.txt;7;0;0;7;124;0.06;0.0;0.0
11125_10.txt;2;0;1;3;242;0.01;0.0;0.0
5949_10.txt;5;1;0;6;61;0.08;0.02;0.0
1597_8.txt;3;2;0;5;96;0.03;0.02;0.0
12187_9.txt;8;8;1;17;428;0.02;0.02;0.0
6775_8.txt;2;0;0;2;51;0.04;0.0;0.0
5366_10.txt;0;1;4;5;363;0.0;0.0;0.01
3817_8.txt;0;0;0;0;212;0.0;0.0;0.0
4760_7.txt;0;0;0;0;74;0.0;0.0;0.0
570_10.txt;4;1;0;5;153;0.03;0.01;0.0
532_9.txt;3;0;0;3;192;0.02;0.0;0.0
1387_8.txt;0;1;0;1;158;0.0;0.01;0.0
12065_7.txt;19;0;0;19;277;0.07;0.0;0.0
3791_10.txt;13;3;3;19;366;0.04;0.01;0.01
10773_9.txt;7;1;1;9;186;0.04;0.01;0.01
7189_10.txt;5;0;0;5;141;0.04;0.0;0.0
7708_10.txt;21;1;1;23;145;0.14;0.01;0.01
12340_8.txt;10;1;2;13;264;0.04;0.0;0.01
8836_10.txt;5;0;0;5;145;0.03;0.0;0.0
5684_10.txt;17;1;0;18;174;0.1;0.01;0.0
1585_9.txt;67;17;6;90;1345;0.05;0.01;0.0
1085_7.txt;4;0;0;4;100;0.04;0.0;0.0
6912_10.txt;26;3;1;30;214;0.12;0.01;0.0
4286_10.txt;0;0;0;0;91;0.0;0.0;0.0
6605_7.txt;10;6;3;19;298;0.03;0.02;0.01
5185_10.txt;0;0;0;0;110;0.0;0.0;0.0
8512_7.txt;0;0;0;0;180;0.0;0.0;0.0
8292_8.txt;4;0;0;4;50;0.08;0.0;0.0
2804_8.txt;1;0;2;3;163;0.01;0.0;0.01
11379_7.txt;39;0;2;41;988;0.04;0.0;0.0
1926_10.txt;2;6;3;11;131;0.02;0.05;0.02
8458_10.txt;0;5;5;10;451;0.0;0.01;0.01
3595_10.txt;2;0;0;2;54;0.04;0.0;0.0
12060_9.txt;14;0;0;14;180;0.08;0.0;0.0
2340_10.txt;2;0;0;2;144;0.01;0.0;0.0
9591_10.txt;0;1;0;1;130;0.0;0.01;0.0
4737_7.txt;8;0;0;8;358;0.02;0.0;0.0
4583_7.txt;0;0;0;0;78;0.0;0.0;0.0
11874_10.txt;32;2;3;37;328;0.1;0.01;0.01
11159_8.txt;0;0;0;0;147;0.0;0.0;0.0
8519_10.txt;5;0;0;5;163;0.03;0.0;0.0
1962_10.txt;17;5;0;22;179;0.09;0.03;0.0
7884_7.txt;15;4;0;19;348;0.04;0.01;0.0
8658_8.txt;27;5;2;34;522;0.05;0.01;0.0
1064_10.txt;0;1;0;1;76;0.0;0.01;0.0
8637_10.txt;33;5;4;42;399;0.08;0.01;0.01
6937_8.txt;21;2;0;23;154;0.14;0.01;0.0
10329_8.txt;0;0;0;0;138;0.0;0.0;0.0
5015_7.txt;5;1;0;6;272;0.02;0.0;0.0
5360_10.txt;4;0;0;4;163;0.02;0.0;0.0
2883_9.txt;17;2;0;19;392;0.04;0.01;0.0
5120_10.txt;1;1;0;2;169;0.01;0.01;0.0
1335_10.txt;13;0;2;15;403;0.03;0.0;0.0
10640_8.txt;47;0;0;47;600;0.08;0.0;0.0
4214_10.txt;19;2;0;21;299;0.06;0.01;0.0
4387_9.txt;1;0;0;1;94;0.01;0.0;0.0
12299_7.txt;30;0;1;31;402;0.07;0.0;0.0
7144_10.txt;7;0;0;7;228;0.03;0.0;0.0
6715_10.txt;8;1;2;11;145;0.06;0.01;0.01
11321_8.txt;0;1;0;1;203;0.0;0.0;0.0
11852_10.txt;4;0;0;4;163;0.02;0.0;0.0
11092_8.txt;7;0;0;7;102;0.07;0.0;0.0
3280_10.txt;4;0;0;4;204;0.02;0.0;0.0
5183_9.txt;0;0;0;0;87;0.0;0.0;0.0
9385_8.txt;11;11;0;22;355;0.03;0.03;0.0
7893_7.txt;12;0;1;13;447;0.03;0.0;0.0
10957_10.txt;18;0;6;24;217;0.08;0.0;0.03
589_10.txt;20;1;1;22;862;0.02;0.0;0.0
6861_8.txt;18;0;0;18;206;0.09;0.0;0.0
12015_10.txt;16;0;0;16;169;0.09;0.0;0.0
6439_10.txt;6;0;0;6;182;0.03;0.0;0.0
2863_8.txt;5;16;2;23;408;0.01;0.04;0.0
917_10.txt;11;0;0;11;221;0.05;0.0;0.0
12423_10.txt;2;0;2;4;63;0.03;0.0;0.03
10826_10.txt;9;0;0;9;134;0.07;0.0;0.0
5569_7.txt;9;0;9;18;231;0.04;0.0;0.04
3410_9.txt;23;5;4;32;956;0.02;0.01;0.0
10536_10.txt;2;0;0;2;192;0.01;0.0;0.0
12332_8.txt;0;0;0;0;148;0.0;0.0;0.0
9417_10.txt;15;0;1;16;348;0.04;0.0;0.0
11583_10.txt;64;2;6;72;406;0.16;0.0;0.01
10749_8.txt;0;0;0;0;147;0.0;0.0;0.0
6581_7.txt;7;0;0;7;170;0.04;0.0;0.0
4542_9.txt;7;7;0;14;253;0.03;0.03;0.0
6189_10.txt;10;7;0;17;272;0.04;0.03;0.0
8087_8.txt;3;0;0;3;185;0.02;0.0;0.0
1880_10.txt;9;0;0;9;146;0.06;0.0;0.0
11896_9.txt;2;0;0;2;75;0.03;0.0;0.0
9451_8.txt;10;1;0;11;171;0.06;0.01;0.0
100_7.txt;8;1;7;16;400;0.02;0.0;0.02
1486_7.txt;8;2;2;12;238;0.03;0.01;0.01
1147_8.txt;3;0;0;3;85;0.04;0.0;0.0
848_8.txt;30;6;0;36;371;0.08;0.02;0.0
7155_8.txt;19;0;0;19;140;0.14;0.0;0.0
6374_10.txt;0;0;0;0;100;0.0;0.0;0.0
5696_8.txt;12;2;2;16;355;0.03;0.01;0.01
7821_8.txt;11;2;0;13;193;0.06;0.01;0.0
8990_10.txt;20;0;0;20;722;0.03;0.0;0.0
11787_9.txt;2;0;0;2;200;0.01;0.0;0.0
10212_8.txt;0;0;0;0;92;0.0;0.0;0.0
5576_9.txt;0;0;0;0;168;0.0;0.0;0.0
8613_7.txt;41;2;0;43;421;0.1;0.0;0.0
7744_10.txt;0;0;0;0;69;0.0;0.0;0.0
4994_9.txt;5;0;0;5;223;0.02;0.0;0.0
4733_9.txt;10;3;0;13;287;0.03;0.01;0.0
851_7.txt;28;4;2;34;379;0.07;0.01;0.01
2379_8.txt;2;1;1;4;181;0.01;0.01;0.01
5353_7.txt;23;0;1;24;549;0.04;0.0;0.0
5706_9.txt;0;0;0;0;157;0.0;0.0;0.0
11213_7.txt;5;2;9;16;384;0.01;0.01;0.02
10628_7.txt;0;0;0;0;99;0.0;0.0;0.0
2332_10.txt;1;0;4;5;339;0.0;0.0;0.01
1177_9.txt;40;1;1;42;794;0.05;0.0;0.0
11447_7.txt;2;0;0;2;163;0.01;0.0;0.0
12322_10.txt;0;1;0;1;135;0.0;0.01;0.0
5017_8.txt;0;1;0;1;82;0.0;0.01;0.0
3159_9.txt;13;1;0;14;346;0.04;0.0;0.0
7521_7.txt;13;4;4;21;451;0.03;0.01;0.01
2965_9.txt;4;0;0;4;80;0.05;0.0;0.0
7408_8.txt;0;2;0;2;198;0.0;0.01;0.0
3625_8.txt;16;0;0;16;275;0.06;0.0;0.0
11963_10.txt;8;0;0;8;122;0.07;0.0;0.0
2665_10.txt;51;2;1;54;778;0.07;0.0;0.0
6179_8.txt;34;0;0;34;288;0.12;0.0;0.0
1089_10.txt;4;0;0;4;148;0.03;0.0;0.0
383_10.txt;21;0;0;21;255;0.08;0.0;0.0
4846_7.txt;18;0;2;20;362;0.05;0.0;0.01
9869_10.txt;6;0;0;6;234;0.03;0.0;0.0
575_10.txt;3;1;0;4;105;0.03;0.01;0.0
11593_10.txt;0;0;1;1;151;0.0;0.0;0.01
1030_10.txt;4;0;0;4;333;0.01;0.0;0.0
1423_10.txt;6;1;0;7;145;0.04;0.01;0.0
2672_7.txt;0;1;0;1;139;0.0;0.01;0.0
588_9.txt;28;3;0;31;337;0.08;0.01;0.0
537_10.txt;0;1;3;4;166;0.0;0.01;0.02
8555_9.txt;0;0;0;0;250;0.0;0.0;0.0
3521_9.txt;13;0;0;13;179;0.07;0.0;0.0
5472_7.txt;5;3;0;8;231;0.02;0.01;0.0
3247_10.txt;0;0;0;0;21;0.0;0.0;0.0
7247_10.txt;19;0;2;21;320;0.06;0.0;0.01
2200_9.txt;22;0;4;26;437;0.05;0.0;0.01
9352_10.txt;9;0;0;9;131;0.07;0.0;0.0
6431_8.txt;0;0;0;0;78;0.0;0.0;0.0
6239_8.txt;0;1;0;1;278;0.0;0.0;0.0
648_7.txt;30;0;0;30;420;0.07;0.0;0.0
2274_9.txt;10;1;0;11;270;0.04;0.0;0.0
4858_8.txt;27;3;6;36;487;0.06;0.01;0.01
385_10.txt;20;1;0;21;567;0.04;0.0;0.0
6044_10.txt;7;0;0;7;145;0.05;0.0;0.0
7627_10.txt;9;6;0;15;253;0.04;0.02;0.0
2695_10.txt;3;0;0;3;227;0.01;0.0;0.0
1081_10.txt;2;0;0;2;69;0.03;0.0;0.0
8089_10.txt;28;4;2;34;663;0.04;0.01;0.0
8245_9.txt;11;1;2;14;122;0.09;0.01;0.02
4397_7.txt;6;0;0;6;100;0.06;0.0;0.0
2796_10.txt;4;0;0;4;136;0.03;0.0;0.0
245_9.txt;7;2;2;11;222;0.03;0.01;0.01
9881_8.txt;17;2;1;20;385;0.04;0.01;0.0
11128_10.txt;15;5;0;20;240;0.06;0.02;0.0
1719_7.txt;20;0;2;22;665;0.03;0.0;0.0
11299_8.txt;17;3;0;20;477;0.04;0.01;0.0
400_10.txt;6;0;0;6;181;0.03;0.0;0.0
10743_9.txt;1;0;0;1;425;0.0;0.0;0.0
10515_9.txt;3;2;0;5;82;0.04;0.02;0.0
6402_8.txt;0;0;0;0;81;0.0;0.0;0.0
4003_9.txt;2;0;0;2;149;0.01;0.0;0.0
11032_7.txt;12;0;2;14;204;0.06;0.0;0.01
6829_8.txt;3;3;0;6;154;0.02;0.02;0.0
1577_9.txt;7;0;0;7;258;0.03;0.0;0.0
189_9.txt;31;1;7;39;456;0.07;0.0;0.02
331_10.txt;0;0;0;0;140;0.0;0.0;0.0
12489_10.txt;7;0;0;7;392;0.02;0.0;0.0
9156_10.txt;0;0;0;0;182;0.0;0.0;0.0
669_7.txt;6;0;0;6;464;0.01;0.0;0.0
518_10.txt;12;2;0;14;255;0.05;0.01;0.0
377_7.txt;35;0;0;35;401;0.09;0.0;0.0
11556_7.txt;15;0;2;17;196;0.08;0.0;0.01
419_7.txt;25;2;0;27;432;0.06;0.0;0.0
5933_7.txt;53;0;1;54;747;0.07;0.0;0.0
907_8.txt;4;1;0;5;121;0.03;0.01;0.0
11527_7.txt;32;1;3;36;372;0.09;0.0;0.01
624_9.txt;2;0;3;5;752;0.0;0.0;0.0
9142_10.txt;2;0;1;3;154;0.01;0.0;0.01
10562_9.txt;2;0;2;4;52;0.04;0.0;0.04
12262_7.txt;9;2;0;11;207;0.04;0.01;0.0
7269_7.txt;2;0;0;2;65;0.03;0.0;0.0
3842_7.txt;13;0;0;13;344;0.04;0.0;0.0
6975_8.txt;4;0;1;5;220;0.02;0.0;0.0
7823_7.txt;6;2;0;8;122;0.05;0.02;0.0
8116_9.txt;15;2;11;28;703;0.02;0.0;0.02
4255_9.txt;0;0;0;0;45;0.0;0.0;0.0
6049_8.txt;9;3;0;12;186;0.05;0.02;0.0
11865_10.txt;2;0;1;3;151;0.01;0.0;0.01
4274_10.txt;4;10;0;14;120;0.03;0.08;0.0
3171_9.txt;3;0;0;3;113;0.03;0.0;0.0
8758_10.txt;20;13;2;35;448;0.04;0.03;0.0
10279_8.txt;8;0;0;8;177;0.05;0.0;0.0
7928_10.txt;3;3;0;6;208;0.01;0.01;0.0
11589_10.txt;1;1;0;2;141;0.01;0.01;0.0
935_9.txt;6;0;0;6;58;0.1;0.0;0.0
3958_7.txt;10;1;0;11;289;0.03;0.0;0.0
4024_9.txt;2;0;0;2;153;0.01;0.0;0.0
11578_10.txt;2;0;0;2;50;0.04;0.0;0.0
2407_10.txt;5;1;0;6;134;0.04;0.01;0.0
5953_9.txt;33;5;2;40;286;0.12;0.02;0.01
8822_10.txt;2;2;2;6;130;0.02;0.02;0.02
1477_7.txt;0;0;0;0;138;0.0;0.0;0.0
5488_10.txt;3;3;0;6;191;0.02;0.02;0.0
8952_7.txt;26;0;0;26;283;0.09;0.0;0.0
10351_8.txt;11;4;0;15;256;0.04;0.02;0.0
10933_10.txt;0;0;0;0;339;0.0;0.0;0.0
7615_10.txt;10;0;0;10;182;0.05;0.0;0.0
2396_7.txt;9;0;0;9;119;0.08;0.0;0.0
5403_10.txt;5;0;0;5;80;0.06;0.0;0.0
412_8.txt;2;0;0;2;57;0.04;0.0;0.0
6198_7.txt;49;0;4;53;527;0.09;0.0;0.01
2321_9.txt;8;0;0;8;355;0.02;0.0;0.0
4746_8.txt;8;2;0;10;376;0.02;0.01;0.0
10764_9.txt;0;0;0;0;63;0.0;0.0;0.0
5638_10.txt;5;0;0;5;136;0.04;0.0;0.0
8113_8.txt;5;0;0;5;181;0.03;0.0;0.0
1791_8.txt;7;0;0;7;238;0.03;0.0;0.0
5469_7.txt;30;1;0;31;484;0.06;0.0;0.0
6311_10.txt;6;2;0;8;156;0.04;0.01;0.0
11817_10.txt;41;0;3;44;256;0.16;0.0;0.01
4165_8.txt;19;1;1;21;354;0.05;0.0;0.0
3885_10.txt;8;0;0;8;122;0.07;0.0;0.0
7782_7.txt;0;0;0;0;127;0.0;0.0;0.0
8051_7.txt;21;4;0;25;329;0.06;0.01;0.0
2800_10.txt;8;2;4;14;318;0.03;0.01;0.01
9329_8.txt;4;0;0;4;179;0.02;0.0;0.0
5622_10.txt;3;0;0;3;48;0.06;0.0;0.0
3884_8.txt;1;0;0;1;40;0.03;0.0;0.0
1417_8.txt;0;0;0;0;153;0.0;0.0;0.0
2878_8.txt;1;0;4;5;373;0.0;0.0;0.01
251_10.txt;18;11;3;32;320;0.06;0.03;0.01
11042_7.txt;14;1;0;15;253;0.06;0.0;0.0
7105_9.txt;31;6;3;40;736;0.04;0.01;0.0
1013_9.txt;15;7;8;30;390;0.04;0.02;0.02
7874_8.txt;28;0;1;29;528;0.05;0.0;0.0
8913_9.txt;0;5;2;7;116;0.0;0.04;0.02
391_8.txt;8;2;0;10;320;0.03;0.01;0.0
2278_10.txt;13;0;4;17;270;0.05;0.0;0.01
2522_8.txt;2;0;0;2;168;0.01;0.0;0.0
4458_7.txt;26;0;0;26;282;0.09;0.0;0.0
3573_7.txt;2;0;0;2;109;0.02;0.0;0.0
699_8.txt;5;0;0;5;177;0.03;0.0;0.0
6766_8.txt;21;2;0;23;409;0.05;0.0;0.0
8659_7.txt;14;0;0;14;186;0.08;0.0;0.0
9668_9.txt;4;2;0;6;88;0.05;0.02;0.0
4855_7.txt;6;0;0;6;169;0.04;0.0;0.0
11397_10.txt;4;0;0;4;101;0.04;0.0;0.0
11651_10.txt;6;0;0;6;173;0.03;0.0;0.0
11036_8.txt;4;1;2;7;181;0.02;0.01;0.01
7690_9.txt;41;4;6;51;717;0.06;0.01;0.01
37_9.txt;4;0;1;5;147;0.03;0.0;0.01
1895_10.txt;11;0;0;11;174;0.06;0.0;0.0
9716_10.txt;4;0;0;4;183;0.02;0.0;0.0
3028_7.txt;52;3;4;59;533;0.1;0.01;0.01
3608_9.txt;7;0;0;7;256;0.03;0.0;0.0
6377_9.txt;0;0;0;0;91;0.0;0.0;0.0
4980_8.txt;1;0;0;1;149;0.01;0.0;0.0
8564_7.txt;4;5;0;9;276;0.01;0.02;0.0
11514_7.txt;5;0;0;5;83;0.06;0.0;0.0
1355_8.txt;15;0;4;19;1108;0.01;0.0;0.0
4023_9.txt;1;2;0;3;410;0.0;0.0;0.0
3638_10.txt;32;7;4;43;616;0.05;0.01;0.01
10050_10.txt;2;0;5;7;214;0.01;0.0;0.02
11816_8.txt;0;0;0;0;152;0.0;0.0;0.0
2748_8.txt;2;0;0;2;64;0.03;0.0;0.0
10668_7.txt;6;0;0;6;318;0.02;0.0;0.0
11167_9.txt;15;3;0;18;253;0.06;0.01;0.0
11572_8.txt;18;15;35;68;534;0.03;0.03;0.07
9681_9.txt;11;0;0;11;97;0.11;0.0;0.0
8141_10.txt;2;0;0;2;71;0.03;0.0;0.0
11675_10.txt;15;8;3;26;503;0.03;0.02;0.01
659_10.txt;3;0;0;3;196;0.02;0.0;0.0
10243_10.txt;0;0;0;0;171;0.0;0.0;0.0
9542_10.txt;4;0;0;4;218;0.02;0.0;0.0
10624_7.txt;2;0;2;4;198;0.01;0.0;0.01
8307_10.txt;5;0;0;5;183;0.03;0.0;0.0
6548_10.txt;13;0;0;13;145;0.09;0.0;0.0
501_10.txt;2;0;2;4;131;0.02;0.0;0.02
583_8.txt;12;2;1;15;250;0.05;0.01;0.0
2939_10.txt;2;0;0;2;159;0.01;0.0;0.0
778_10.txt;1;0;0;1;160;0.01;0.0;0.0
2679_8.txt;7;1;0;8;129;0.05;0.01;0.0
6159_7.txt;13;2;4;19;325;0.04;0.01;0.01
7372_9.txt;9;0;0;9;295;0.03;0.0;0.0
7541_10.txt;15;1;1;17;493;0.03;0.0;0.0
2000_10.txt;10;0;0;10;165;0.06;0.0;0.0
1813_8.txt;6;0;0;6;205;0.03;0.0;0.0
1838_10.txt;52;1;4;57;1074;0.05;0.0;0.0
7296_10.txt;5;0;0;5;154;0.03;0.0;0.0
10659_8.txt;9;1;0;10;156;0.06;0.01;0.0
10859_7.txt;2;2;0;4;186;0.01;0.01;0.0
12384_8.txt;44;2;2;48;952;0.05;0.0;0.0
4423_8.txt;0;0;1;1;129;0.0;0.0;0.01
6626_7.txt;11;7;1;19;793;0.01;0.01;0.0
8898_8.txt;5;7;3;15;307;0.02;0.02;0.01
6196_8.txt;17;1;0;18;128;0.13;0.01;0.0
2633_8.txt;3;1;0;4;145;0.02;0.01;0.0
4053_8.txt;4;6;0;10;210;0.02;0.03;0.0
3562_8.txt;25;6;0;31;340;0.07;0.02;0.0
5419_10.txt;4;0;0;4;83;0.05;0.0;0.0
7410_7.txt;0;1;0;1;223;0.0;0.0;0.0
8380_9.txt;6;0;0;6;160;0.04;0.0;0.0
11823_9.txt;6;0;0;6;168;0.04;0.0;0.0
8467_7.txt;0;0;0;0;174;0.0;0.0;0.0
3222_7.txt;4;0;0;4;122;0.03;0.0;0.0
9485_10.txt;0;0;0;0;80;0.0;0.0;0.0
595_9.txt;55;15;0;70;608;0.09;0.02;0.0
6530_8.txt;40;3;6;49;678;0.06;0.0;0.01
827_7.txt;50;2;8;60;1121;0.04;0.0;0.01
8995_9.txt;6;0;2;8;313;0.02;0.0;0.01
2406_10.txt;0;0;0;0;212;0.0;0.0;0.0
11436_9.txt;2;0;3;5;127;0.02;0.0;0.02
3586_10.txt;14;0;0;14;211;0.07;0.0;0.0
5001_7.txt;0;0;5;5;178;0.0;0.0;0.03
5128_9.txt;33;2;2;37;751;0.04;0.0;0.0
3157_10.txt;5;1;0;6;256;0.02;0.0;0.0
9997_7.txt;13;0;0;13;205;0.06;0.0;0.0
9945_8.txt;0;0;0;0;146;0.0;0.0;0.0
9859_10.txt;0;0;2;2;175;0.0;0.0;0.01
6394_10.txt;14;4;4;22;274;0.05;0.01;0.01
150_8.txt;8;1;0;9;249;0.03;0.0;0.0
5229_10.txt;1;0;0;1;213;0.0;0.0;0.0
4755_7.txt;4;0;0;4;211;0.02;0.0;0.0
5140_10.txt;0;0;2;2;50;0.0;0.0;0.04
9307_10.txt;26;1;0;27;191;0.14;0.01;0.0
2860_9.txt;2;0;0;2;143;0.01;0.0;0.0
9743_8.txt;46;3;0;49;690;0.07;0.0;0.0
10961_9.txt;4;0;0;4;105;0.04;0.0;0.0
8465_8.txt;0;0;0;0;252;0.0;0.0;0.0
11580_10.txt;11;0;0;11;204;0.05;0.0;0.0
8239_10.txt;23;5;1;29;512;0.04;0.01;0.0
7915_8.txt;0;0;0;0;210;0.0;0.0;0.0
11086_7.txt;0;0;1;1;164;0.0;0.0;0.01
3809_9.txt;2;0;1;3;384;0.01;0.0;0.0
6754_8.txt;24;0;0;24;290;0.08;0.0;0.0
5404_10.txt;5;0;2;7;151;0.03;0.0;0.01
4825_8.txt;27;4;3;34;485;0.06;0.01;0.01
357_10.txt;6;0;0;6;141;0.04;0.0;0.0
2829_10.txt;10;0;1;11;311;0.03;0.0;0.0
5967_10.txt;17;1;4;22;380;0.04;0.0;0.01
3248_10.txt;0;0;0;0;64;0.0;0.0;0.0
175_7.txt;6;0;0;6;131;0.05;0.0;0.0
3004_10.txt;14;1;0;15;181;0.08;0.01;0.0
4888_8.txt;0;0;1;1;102;0.0;0.0;0.01
6950_8.txt;27;9;0;36;325;0.08;0.03;0.0
2_9.txt;3;0;8;11;136;0.02;0.0;0.06
7982_10.txt;3;7;0;10;161;0.02;0.04;0.0
3102_9.txt;5;0;2;7;193;0.03;0.0;0.01
6273_9.txt;4;0;0;4;126;0.03;0.0;0.0
6334_8.txt;0;3;0;3;234;0.0;0.01;0.0
785_9.txt;0;0;0;0;197;0.0;0.0;0.0
11612_10.txt;1;2;0;3;207;0.0;0.01;0.0
1439_7.txt;6;4;4;14;276;0.02;0.01;0.01
2810_10.txt;0;0;0;0;65;0.0;0.0;0.0
7416_9.txt;0;0;0;0;125;0.0;0.0;0.0
3632_7.txt;4;0;0;4;84;0.05;0.0;0.0
10901_10.txt;4;0;0;4;138;0.03;0.0;0.0
8950_7.txt;9;3;0;12;279;0.03;0.01;0.0
1765_8.txt;36;2;0;38;849;0.04;0.0;0.0
10010_7.txt;25;1;0;26;317;0.08;0.0;0.0
2869_10.txt;1;0;3;4;190;0.01;0.0;0.02
11459_10.txt;5;0;0;5;274;0.02;0.0;0.0
6073_9.txt;9;0;0;9;228;0.04;0.0;0.0
7359_10.txt;15;4;2;21;448;0.03;0.01;0.0
967_7.txt;25;3;2;30;995;0.03;0.0;0.0
5082_7.txt;13;1;0;14;165;0.08;0.01;0.0
4067_8.txt;37;0;0;37;598;0.06;0.0;0.0
6984_8.txt;3;9;4;16;359;0.01;0.03;0.01
3160_7.txt;2;0;0;2;206;0.01;0.0;0.0
4873_8.txt;4;0;0;4;293;0.01;0.0;0.0
3942_9.txt;58;8;13;79;758;0.08;0.01;0.02
5813_8.txt;5;0;1;6;405;0.01;0.0;0.0
374_10.txt;3;0;0;3;87;0.03;0.0;0.0
1129_10.txt;30;6;4;40;1165;0.03;0.01;0.0
1794_7.txt;41;1;1;43;546;0.08;0.0;0.0
11377_9.txt;10;1;0;11;294;0.03;0.0;0.0
11438_10.txt;2;0;1;3;158;0.01;0.0;0.01
12453_7.txt;14;2;0;16;300;0.05;0.01;0.0
5943_10.txt;2;0;0;2;148;0.01;0.0;0.0
4287_10.txt;6;0;2;8;228;0.03;0.0;0.01
4025_9.txt;6;1;0;7;245;0.02;0.0;0.0
9280_9.txt;2;9;1;12;171;0.01;0.05;0.01
10167_7.txt;0;0;0;0;238;0.0;0.0;0.0
8423_8.txt;13;8;0;21;608;0.02;0.01;0.0
7202_8.txt;2;0;0;2;138;0.01;0.0;0.0
11685_8.txt;2;0;0;2;92;0.02;0.0;0.0
2881_8.txt;34;1;0;35;915;0.04;0.0;0.0
12236_10.txt;0;0;0;0;241;0.0;0.0;0.0
4042_7.txt;0;1;0;1;474;0.0;0.0;0.0
6068_9.txt;4;1;0;5;127;0.03;0.01;0.0
1204_10.txt;11;7;0;18;135;0.08;0.05;0.0
1784_10.txt;2;2;0;4;164;0.01;0.01;0.0
249_10.txt;6;0;0;6;113;0.05;0.0;0.0
11461_10.txt;8;0;0;8;142;0.06;0.0;0.0
10079_8.txt;0;1;0;1;140;0.0;0.01;0.0
6301_10.txt;0;0;0;0;80;0.0;0.0;0.0
9547_9.txt;8;2;0;10;151;0.05;0.01;0.0
5463_9.txt;4;0;0;4;121;0.03;0.0;0.0
9722_7.txt;36;2;7;45;752;0.05;0.0;0.01
6054_9.txt;10;0;0;10;290;0.03;0.0;0.0
2113_10.txt;25;6;0;31;418;0.06;0.01;0.0
10425_9.txt;13;4;9;26;293;0.04;0.01;0.03
7514_8.txt;42;0;9;51;774;0.05;0.0;0.01
7877_7.txt;47;0;1;48;680;0.07;0.0;0.0
8870_8.txt;27;3;4;34;650;0.04;0.0;0.01
4186_7.txt;1;0;0;1;128;0.01;0.0;0.0
12064_10.txt;0;0;0;0;124;0.0;0.0;0.0
4520_7.txt;4;0;0;4;77;0.05;0.0;0.0
1740_8.txt;0;1;0;1;135;0.0;0.01;0.0
6890_8.txt;9;0;0;9;163;0.06;0.0;0.0
4575_8.txt;0;0;0;0;59;0.0;0.0;0.0
8200_8.txt;5;0;0;5;272;0.02;0.0;0.0
197_9.txt;52;5;6;63;854;0.06;0.01;0.01
3107_8.txt;12;5;0;17;199;0.06;0.03;0.0
430_7.txt;4;0;0;4;61;0.07;0.0;0.0
10300_10.txt;6;0;0;6;61;0.1;0.0;0.0
6164_7.txt;1;3;0;4;122;0.01;0.02;0.0
9971_10.txt;4;0;3;7;70;0.06;0.0;0.04
8262_10.txt;4;0;3;7;162;0.02;0.0;0.02
933_10.txt;26;0;0;26;343;0.08;0.0;0.0
7631_10.txt;6;0;0;6;128;0.05;0.0;0.0
4776_8.txt;1;0;0;1;163;0.01;0.0;0.0
742_9.txt;14;0;0;14;262;0.05;0.0;0.0
4306_10.txt;0;2;0;2;150;0.0;0.01;0.0
2851_10.txt;1;0;0;1;161;0.01;0.0;0.0
4676_9.txt;6;0;0;6;167;0.04;0.0;0.0
4015_7.txt;35;4;1;40;1017;0.03;0.0;0.0
12153_10.txt;0;0;0;0;56;0.0;0.0;0.0
11441_10.txt;6;4;0;10;185;0.03;0.02;0.0
2172_7.txt;29;2;3;34;407;0.07;0.0;0.01
5013_10.txt;1;0;0;1;186;0.01;0.0;0.0
396_8.txt;26;5;2;33;664;0.04;0.01;0.0
873_8.txt;1;0;0;1;212;0.0;0.0;0.0
1426_8.txt;2;0;1;3;149;0.01;0.0;0.01
8046_9.txt;11;0;0;11;189;0.06;0.0;0.0
9411_8.txt;9;1;0;10;175;0.05;0.01;0.0
8972_10.txt;5;0;0;5;306;0.02;0.0;0.0
3717_8.txt;3;0;0;3;144;0.02;0.0;0.0
4342_10.txt;9;1;0;10;226;0.04;0.0;0.0
10313_7.txt;17;2;0;19;205;0.08;0.01;0.0
11567_8.txt;21;0;2;23;665;0.03;0.0;0.0
129_9.txt;0;0;0;0;160;0.0;0.0;0.0
9764_9.txt;0;0;0;0;113;0.0;0.0;0.0
1114_8.txt;6;3;0;9;299;0.02;0.01;0.0
11395_8.txt;16;1;0;17;158;0.1;0.01;0.0
4750_7.txt;13;0;2;15;316;0.04;0.0;0.01
2568_10.txt;20;0;0;20;272;0.07;0.0;0.0
6372_7.txt;0;0;1;1;46;0.0;0.0;0.02
5526_10.txt;7;0;6;13;323;0.02;0.0;0.02
5193_9.txt;1;0;0;1;138;0.01;0.0;0.0
9158_10.txt;33;5;4;42;421;0.08;0.01;0.01
10808_10.txt;0;0;0;0;55;0.0;0.0;0.0
2638_10.txt;0;0;1;1;90;0.0;0.0;0.01
4034_9.txt;2;4;0;6;161;0.01;0.02;0.0
9708_10.txt;4;1;5;10;215;0.02;0.0;0.02
11601_8.txt;40;0;0;40;182;0.22;0.0;0.0
2036_7.txt;3;0;0;3;389;0.01;0.0;0.0
12443_9.txt;5;0;0;5;174;0.03;0.0;0.0
10925_9.txt;0;0;0;0;203;0.0;0.0;0.0
10063_9.txt;0;0;0;0;136;0.0;0.0;0.0
5853_10.txt;29;0;7;36;221;0.13;0.0;0.03
11482_9.txt;2;0;1;3;180;0.01;0.0;0.01
6790_10.txt;0;0;0;0;194;0.0;0.0;0.0
3198_10.txt;14;2;0;16;344;0.04;0.01;0.0
3828_10.txt;2;1;0;3;156;0.01;0.01;0.0
4631_10.txt;13;6;0;19;462;0.03;0.01;0.0
7924_9.txt;14;0;0;14;516;0.03;0.0;0.0
9212_9.txt;0;1;0;1;170;0.0;0.01;0.0
10264_10.txt;2;0;0;2;68;0.03;0.0;0.0
3047_7.txt;0;0;0;0;57;0.0;0.0;0.0
10194_10.txt;7;2;0;9;113;0.06;0.02;0.0
2527_9.txt;6;0;3;9;182;0.03;0.0;0.02
10337_9.txt;13;1;0;14;260;0.05;0.0;0.0
7898_10.txt;3;0;0;3;242;0.01;0.0;0.0
3546_10.txt;0;0;0;0;188;0.0;0.0;0.0
7101_10.txt;3;4;4;11;585;0.01;0.01;0.01
11420_9.txt;0;0;0;0;143;0.0;0.0;0.0
5620_10.txt;14;1;0;15;553;0.03;0.0;0.0
740_7.txt;28;3;4;35;494;0.06;0.01;0.01
9146_9.txt;7;0;0;7;399;0.02;0.0;0.0
7024_8.txt;0;2;0;2;156;0.0;0.01;0.0
8475_10.txt;2;4;0;6;144;0.01;0.03;0.0
5575_8.txt;4;0;0;4;139;0.03;0.0;0.0
11524_7.txt;3;2;0;5;139;0.02;0.01;0.0
7635_10.txt;3;0;0;3;199;0.02;0.0;0.0
9438_10.txt;10;1;0;11;485;0.02;0.0;0.0
8111_8.txt;6;1;1;8;294;0.02;0.0;0.0
12103_7.txt;8;1;0;9;292;0.03;0.0;0.0
9314_10.txt;0;2;0;2;127;0.0;0.02;0.0
11328_10.txt;0;0;0;0;69;0.0;0.0;0.0
1592_9.txt;15;0;0;15;234;0.06;0.0;0.0
616_7.txt;8;2;1;11;431;0.02;0.0;0.0
726_7.txt;16;0;6;22;362;0.04;0.0;0.02
8833_9.txt;0;4;0;4;232;0.0;0.02;0.0
401_10.txt;4;2;0;6;89;0.04;0.02;0.0
10971_9.txt;0;2;0;2;66;0.0;0.03;0.0
387_8.txt;4;0;0;4;234;0.02;0.0;0.0
9283_8.txt;10;11;0;21;504;0.02;0.02;0.0
1905_10.txt;19;0;2;21;239;0.08;0.0;0.01
8237_8.txt;2;1;0;3;389;0.01;0.0;0.0
4557_8.txt;7;0;0;7;78;0.09;0.0;0.0
6449_10.txt;0;0;0;0;138;0.0;0.0;0.0
8737_9.txt;19;0;1;20;160;0.12;0.0;0.01
11162_10.txt;12;1;2;15;196;0.06;0.01;0.01
5491_10.txt;20;4;3;27;778;0.03;0.01;0.0
4579_9.txt;1;0;0;1;80;0.01;0.0;0.0
11120_10.txt;9;0;0;9;301;0.03;0.0;0.0
8171_8.txt;3;0;0;3;132;0.02;0.0;0.0
3893_10.txt;4;1;1;6;166;0.02;0.01;0.01
7839_10.txt;20;2;0;22;227;0.09;0.01;0.0
4296_9.txt;15;2;0;17;166;0.09;0.01;0.0
9637_8.txt;0;0;0;0;124;0.0;0.0;0.0
4761_10.txt;6;3;0;9;101;0.06;0.03;0.0
7667_7.txt;24;4;0;28;440;0.05;0.01;0.0
6266_8.txt;0;0;0;0;124;0.0;0.0;0.0
1907_7.txt;24;0;3;27;184;0.13;0.0;0.02
11535_7.txt;47;2;3;52;974;0.05;0.0;0.0
12058_9.txt;0;0;0;0;166;0.0;0.0;0.0
10676_9.txt;28;11;1;40;328;0.09;0.03;0.0
10883_7.txt;13;0;0;13;406;0.03;0.0;0.0
3133_9.txt;0;0;0;0;54;0.0;0.0;0.0
1583_8.txt;3;3;0;6;620;0.0;0.0;0.0
7004_10.txt;4;0;0;4;164;0.02;0.0;0.0
7876_8.txt;7;0;0;7;200;0.04;0.0;0.0
1246_8.txt;6;0;0;6;93;0.06;0.0;0.0
6904_8.txt;5;0;0;5;78;0.06;0.0;0.0
5026_8.txt;6;0;1;7;235;0.03;0.0;0.0
3184_8.txt;11;2;0;13;125;0.09;0.02;0.0
7445_7.txt;0;0;0;0;48;0.0;0.0;0.0
9102_8.txt;5;1;0;6;385;0.01;0.0;0.0
3931_7.txt;14;2;2;18;308;0.05;0.01;0.01
3245_10.txt;31;6;2;39;553;0.06;0.01;0.0
10975_10.txt;0;0;0;0;205;0.0;0.0;0.0
3556_10.txt;16;1;0;17;147;0.11;0.01;0.0
8648_9.txt;6;3;0;9;307;0.02;0.01;0.0
11130_9.txt;16;5;0;21;312;0.05;0.02;0.0
6053_10.txt;0;0;0;0;199;0.0;0.0;0.0
1173_8.txt;14;15;3;32;527;0.03;0.03;0.01
10469_10.txt;6;1;4;11;291;0.02;0.0;0.01
5714_7.txt;0;3;0;3;283;0.0;0.01;0.0
5904_8.txt;5;0;0;5;194;0.03;0.0;0.0
12497_10.txt;6;0;0;6;150;0.04;0.0;0.0
6783_7.txt;13;0;0;13;104;0.13;0.0;0.0
5422_9.txt;48;1;0;49;540;0.09;0.0;0.0
3412_8.txt;3;3;0;6;105;0.03;0.03;0.0
912_8.txt;11;0;1;12;347;0.03;0.0;0.0
10799_7.txt;14;1;2;17;331;0.04;0.0;0.01
833_8.txt;4;0;0;4;191;0.02;0.0;0.0
11953_8.txt;64;4;2;70;1003;0.06;0.0;0.0
6015_7.txt;2;0;0;2;123;0.02;0.0;0.0
5058_10.txt;4;5;2;11;155;0.03;0.03;0.01
10945_9.txt;0;0;0;0;148;0.0;0.0;0.0
4061_10.txt;10;1;4;15;328;0.03;0.0;0.01
11506_8.txt;7;2;3;12;259;0.03;0.01;0.01
3433_9.txt;0;3;0;3;178;0.0;0.02;0.0
5383_10.txt;9;0;0;9;154;0.06;0.0;0.0
4190_10.txt;12;9;0;21;298;0.04;0.03;0.0
3774_8.txt;14;0;4;18;330;0.04;0.0;0.01
10904_10.txt;2;0;0;2;168;0.01;0.0;0.0
10124_8.txt;20;3;6;29;745;0.03;0.0;0.01
5369_9.txt;9;0;4;13;337;0.03;0.0;0.01
3564_10.txt;43;11;2;56;861;0.05;0.01;0.0
6075_10.txt;19;1;2;22;511;0.04;0.0;0.0
5659_9.txt;4;0;1;5;183;0.02;0.0;0.01
5861_8.txt;4;0;0;4;79;0.05;0.0;0.0
2292_8.txt;14;0;2;16;225;0.06;0.0;0.01
2548_7.txt;36;1;0;37;596;0.06;0.0;0.0
394_8.txt;10;0;0;10;273;0.04;0.0;0.0
7637_7.txt;5;0;2;7;176;0.03;0.0;0.01
1549_10.txt;7;0;2;9;242;0.03;0.0;0.01
10636_8.txt;5;1;0;6;135;0.04;0.01;0.0
10978_10.txt;13;2;0;15;203;0.06;0.01;0.0
9831_8.txt;12;1;8;21;190;0.06;0.01;0.04
2429_8.txt;6;0;0;6;191;0.03;0.0;0.0
1709_8.txt;0;1;2;3;185;0.0;0.01;0.01
7489_7.txt;11;1;0;12;194;0.06;0.01;0.0
5877_8.txt;6;0;0;6;166;0.04;0.0;0.0
11610_10.txt;0;0;0;0;61;0.0;0.0;0.0
4973_9.txt;0;0;2;2;89;0.0;0.0;0.02
5304_10.txt;8;2;0;10;187;0.04;0.01;0.0
6019_8.txt;3;0;0;3;355;0.01;0.0;0.0
10253_10.txt;0;0;0;0;146;0.0;0.0;0.0
3727_10.txt;2;0;0;2;80;0.03;0.0;0.0
4783_10.txt;4;0;0;4;138;0.03;0.0;0.0
7001_10.txt;3;0;0;3;170;0.02;0.0;0.0
4609_8.txt;8;4;0;12;264;0.03;0.02;0.0
2133_10.txt;28;1;0;29;297;0.09;0.0;0.0
8151_10.txt;0;0;0;0;183;0.0;0.0;0.0
6871_8.txt;2;0;4;6;73;0.03;0.0;0.05
7370_7.txt;4;0;0;4;143;0.03;0.0;0.0
8426_7.txt;15;0;2;17;467;0.03;0.0;0.0
9980_8.txt;0;2;1;3;224;0.0;0.01;0.0
7608_10.txt;0;0;0;0;163;0.0;0.0;0.0
8614_9.txt;7;0;0;7;142;0.05;0.0;0.0
3888_10.txt;1;0;0;1;103;0.01;0.0;0.0
11624_8.txt;8;0;0;8;288;0.03;0.0;0.0
5155_9.txt;32;0;0;32;539;0.06;0.0;0.0
5939_7.txt;19;1;1;21;670;0.03;0.0;0.0
451_10.txt;16;2;0;18;197;0.08;0.01;0.0
12428_8.txt;0;0;0;0;66;0.0;0.0;0.0
9187_10.txt;16;0;2;18;463;0.03;0.0;0.0
10987_8.txt;5;5;0;10;338;0.01;0.01;0.0
2469_10.txt;1;0;0;1;20;0.05;0.0;0.0
6974_10.txt;10;5;1;16;254;0.04;0.02;0.0
11638_7.txt;7;0;0;7;137;0.05;0.0;0.0
9799_7.txt;3;0;0;3;84;0.04;0.0;0.0
11421_10.txt;0;0;0;0;140;0.0;0.0;0.0
11186_7.txt;20;0;2;22;475;0.04;0.0;0.0
3561_9.txt;24;1;3;28;306;0.08;0.0;0.01
7003_10.txt;4;0;0;4;165;0.02;0.0;0.0
6147_7.txt;0;0;0;0;168;0.0;0.0;0.0
1375_8.txt;34;2;1;37;667;0.05;0.0;0.0
212_9.txt;32;2;1;35;712;0.04;0.0;0.0
690_9.txt;3;0;0;3;172;0.02;0.0;0.0
9439_8.txt;18;2;0;20;283;0.06;0.01;0.0
4324_7.txt;50;4;4;58;1072;0.05;0.0;0.0
7139_10.txt;44;5;0;49;434;0.1;0.01;0.0
1516_7.txt;57;3;0;60;1052;0.05;0.0;0.0
1725_8.txt;0;1;0;1;143;0.0;0.01;0.0
6672_10.txt;9;0;0;9;183;0.05;0.0;0.0
8154_10.txt;6;0;7;13;836;0.01;0.0;0.01
11038_10.txt;0;0;0;0;313;0.0;0.0;0.0
8969_7.txt;20;2;7;29;263;0.08;0.01;0.03
46_9.txt;19;6;1;26;359;0.05;0.02;0.0
10396_8.txt;33;3;0;36;577;0.06;0.01;0.0
1056_10.txt;5;0;0;5;135;0.04;0.0;0.0
1298_7.txt;11;2;0;13;301;0.04;0.01;0.0
6556_9.txt;18;0;0;18;319;0.06;0.0;0.0
2112_9.txt;24;1;2;27;170;0.14;0.01;0.01
7786_8.txt;12;7;2;21;345;0.03;0.02;0.01
9768_10.txt;4;1;2;7;152;0.03;0.01;0.01
1530_10.txt;0;0;2;2;139;0.0;0.0;0.01
6970_8.txt;10;0;3;13;361;0.03;0.0;0.01
2516_9.txt;10;2;2;14;514;0.02;0.0;0.0
7198_9.txt;16;1;2;19;158;0.1;0.01;0.01
9510_8.txt;44;2;0;46;274;0.16;0.01;0.0
623_10.txt;5;0;0;5;128;0.04;0.0;0.0
11041_7.txt;27;0;0;27;702;0.04;0.0;0.0
10836_10.txt;4;0;0;4;134;0.03;0.0;0.0
11308_9.txt;14;0;1;15;191;0.07;0.0;0.01
1846_8.txt;5;0;1;6;236;0.02;0.0;0.0
5803_10.txt;6;0;0;6;146;0.04;0.0;0.0
6304_8.txt;0;0;0;0;58;0.0;0.0;0.0
9310_10.txt;1;2;0;3;142;0.01;0.01;0.0
11373_8.txt;7;1;0;8;271;0.03;0.0;0.0
6874_8.txt;0;1;0;1;98;0.0;0.01;0.0
1428_7.txt;0;0;0;0;130;0.0;0.0;0.0
5116_10.txt;0;0;3;3;67;0.0;0.0;0.04
5613_9.txt;5;0;4;9;790;0.01;0.0;0.01
5779_10.txt;2;0;0;2;326;0.01;0.0;0.0
783_10.txt;3;0;2;5;200;0.01;0.0;0.01
6954_8.txt;5;0;0;5;200;0.03;0.0;0.0
7752_8.txt;0;1;0;1;413;0.0;0.0;0.0
11667_9.txt;5;3;2;10;289;0.02;0.01;0.01
4757_8.txt;14;0;0;14;146;0.1;0.0;0.0
7104_7.txt;4;3;2;9;302;0.01;0.01;0.01
4412_9.txt;0;1;0;1;430;0.0;0.0;0.0
4843_7.txt;3;0;0;3;180;0.02;0.0;0.0
8973_9.txt;7;1;5;13;192;0.04;0.01;0.03
6667_8.txt;12;0;0;12;167;0.07;0.0;0.0
6714_10.txt;4;1;0;5;413;0.01;0.0;0.0
9898_10.txt;2;0;0;2;185;0.01;0.0;0.0
4556_8.txt;3;0;0;3;181;0.02;0.0;0.0
2960_10.txt;10;4;0;14;257;0.04;0.02;0.0
12409_7.txt;6;3;0;9;415;0.01;0.01;0.0
769_8.txt;2;3;0;5;190;0.01;0.02;0.0
1202_9.txt;2;0;0;2;143;0.01;0.0;0.0
11710_10.txt;11;1;0;12;238;0.05;0.0;0.0
551_8.txt;71;12;1;84;648;0.11;0.02;0.0
9911_10.txt;4;0;0;4;52;0.08;0.0;0.0
12211_10.txt;7;2;0;9;114;0.06;0.02;0.0
3485_9.txt;0;0;0;0;89;0.0;0.0;0.0
9759_10.txt;6;0;0;6;150;0.04;0.0;0.0
7988_10.txt;5;0;0;5;153;0.03;0.0;0.0
6347_9.txt;27;0;0;27;450;0.06;0.0;0.0
7150_9.txt;4;0;1;5;239;0.02;0.0;0.0
11425_8.txt;8;4;0;12;220;0.04;0.02;0.0
9136_8.txt;5;0;0;5;324;0.02;0.0;0.0
225_9.txt;77;12;4;93;1144;0.07;0.01;0.0
2098_10.txt;71;3;0;74;756;0.09;0.0;0.0
498_10.txt;3;0;0;3;338;0.01;0.0;0.0
1819_9.txt;12;3;1;16;275;0.04;0.01;0.0
2691_8.txt;14;0;0;14;174;0.08;0.0;0.0
8490_7.txt;0;0;0;0;141;0.0;0.0;0.0
1391_7.txt;15;3;0;18;281;0.05;0.01;0.0
12422_8.txt;0;0;0;0;75;0.0;0.0;0.0
12242_10.txt;3;3;0;6;197;0.02;0.02;0.0
4820_7.txt;33;5;5;43;961;0.03;0.01;0.01
11778_10.txt;0;3;0;3;183;0.0;0.02;0.0
2110_9.txt;12;0;0;12;297;0.04;0.0;0.0
508_9.txt;23;7;5;35;381;0.06;0.02;0.01
2017_10.txt;9;1;0;10;183;0.05;0.01;0.0
4335_9.txt;2;0;0;2;134;0.01;0.0;0.0
9639_10.txt;0;0;0;0;74;0.0;0.0;0.0
6947_10.txt;5;0;1;6;146;0.03;0.0;0.01
4673_9.txt;0;0;0;0;137;0.0;0.0;0.0
10997_10.txt;5;0;0;5;103;0.05;0.0;0.0
831_9.txt;4;2;0;6;179;0.02;0.01;0.0
11047_9.txt;2;2;0;4;235;0.01;0.01;0.0
2832_8.txt;1;4;0;5;172;0.01;0.02;0.0
6100_10.txt;9;1;0;10;173;0.05;0.01;0.0
3444_10.txt;9;0;0;9;648;0.01;0.0;0.0
7808_10.txt;8;4;0;12;285;0.03;0.01;0.0
11365_9.txt;21;2;1;24;512;0.04;0.0;0.0
5971_7.txt;2;0;0;2;197;0.01;0.0;0.0
2165_7.txt;9;0;0;9;136;0.07;0.0;0.0
6119_9.txt;2;0;1;3;124;0.02;0.0;0.01
2631_7.txt;5;6;2;13;261;0.02;0.02;0.01
2793_9.txt;12;0;0;12;153;0.08;0.0;0.0
10114_10.txt;8;1;0;9;191;0.04;0.01;0.0
9496_10.txt;19;3;0;22;556;0.03;0.01;0.0
9370_7.txt;47;4;0;51;377;0.12;0.01;0.0
1815_10.txt;3;0;0;3;187;0.02;0.0;0.0
11205_10.txt;0;0;1;1;69;0.0;0.0;0.01
2670_10.txt;0;2;0;2;56;0.0;0.04;0.0
9597_10.txt;5;2;0;7;165;0.03;0.01;0.0
7743_8.txt;4;0;0;4;160;0.03;0.0;0.0
5028_10.txt;1;0;0;1;48;0.02;0.0;0.0
666_10.txt;4;1;0;5;140;0.03;0.01;0.0
5135_10.txt;0;0;0;0;99;0.0;0.0;0.0
11113_9.txt;4;2;0;6;186;0.02;0.01;0.0
4716_9.txt;2;0;0;2;73;0.03;0.0;0.0
9857_7.txt;0;0;0;0;74;0.0;0.0;0.0
2479_10.txt;1;1;0;2;229;0.0;0.0;0.0
6579_10.txt;5;1;0;6;166;0.03;0.01;0.0
8825_9.txt;0;0;0;0;132;0.0;0.0;0.0
5601_8.txt;3;0;0;3;853;0.0;0.0;0.0
11394_10.txt;2;0;0;2;122;0.02;0.0;0.0
6842_7.txt;3;0;0;3;50;0.06;0.0;0.0
3813_7.txt;9;2;0;11;687;0.01;0.0;0.0
9612_8.txt;0;0;0;0;116;0.0;0.0;0.0
7037_10.txt;6;2;0;8;131;0.05;0.02;0.0
1576_10.txt;2;0;0;2;155;0.01;0.0;0.0
5114_10.txt;7;1;2;10;170;0.04;0.01;0.01
9225_10.txt;13;0;0;13;132;0.1;0.0;0.0
359_8.txt;3;0;1;4;189;0.02;0.0;0.01
5930_7.txt;9;0;0;9;151;0.06;0.0;0.0
10727_7.txt;2;3;0;5;239;0.01;0.01;0.0
12252_10.txt;18;0;0;18;295;0.06;0.0;0.0
12123_8.txt;52;3;2;57;920;0.06;0.0;0.0
3165_10.txt;21;0;0;21;250;0.08;0.0;0.0
5234_10.txt;1;0;0;1;143;0.01;0.0;0.0
12053_9.txt;0;0;0;0;75;0.0;0.0;0.0
7015_8.txt;10;0;5;15;395;0.03;0.0;0.01
11399_8.txt;10;1;0;11;239;0.04;0.0;0.0
995_9.txt;8;0;0;8;90;0.09;0.0;0.0
7908_9.txt;2;0;1;3;92;0.02;0.0;0.01
9954_8.txt;2;0;0;2;93;0.02;0.0;0.0
3455_10.txt;42;0;0;42;412;0.1;0.0;0.0
4615_10.txt;2;0;0;2;174;0.01;0.0;0.0
3699_10.txt;0;0;0;0;145;0.0;0.0;0.0
11539_9.txt;45;1;0;46;311;0.14;0.0;0.0
1529_10.txt;0;0;1;1;200;0.0;0.0;0.01
4275_10.txt;0;1;2;3;189;0.0;0.01;0.01
9884_10.txt;28;0;0;28;347;0.08;0.0;0.0
7028_9.txt;10;0;0;10;163;0.06;0.0;0.0
9493_8.txt;9;0;0;9;129;0.07;0.0;0.0
5719_9.txt;2;0;0;2;189;0.01;0.0;0.0
5866_9.txt;37;3;0;40;1072;0.03;0.0;0.0
4413_8.txt;13;4;6;23;138;0.09;0.03;0.04
2826_10.txt;27;0;4;31;611;0.04;0.0;0.01
1664_10.txt;3;0;0;3;95;0.03;0.0;0.0
9963_10.txt;4;0;0;4;180;0.02;0.0;0.0
23_7.txt;7;0;0;7;194;0.04;0.0;0.0
12471_7.txt;5;0;0;5;271;0.02;0.0;0.0
12295_9.txt;10;0;0;10;200;0.05;0.0;0.0
1902_10.txt;19;6;4;29;241;0.08;0.02;0.02
11715_7.txt;9;0;2;11;155;0.06;0.0;0.01
3566_9.txt;34;0;0;34;259;0.13;0.0;0.0
12436_7.txt;1;0;0;1;206;0.0;0.0;0.0
10890_9.txt;0;0;0;0;143;0.0;0.0;0.0
5382_7.txt;10;0;0;10;174;0.06;0.0;0.0
5191_8.txt;4;0;0;4;198;0.02;0.0;0.0
11174_8.txt;14;1;1;16;345;0.04;0.0;0.0
5305_7.txt;2;0;0;2;54;0.04;0.0;0.0
8405_9.txt;22;0;0;22;296;0.07;0.0;0.0
6748_8.txt;58;2;0;60;683;0.08;0.0;0.0
6191_9.txt;18;0;1;19;200;0.09;0.0;0.01
9309_9.txt;0;0;0;0;143;0.0;0.0;0.0
3085_10.txt;1;0;2;3;203;0.0;0.0;0.01
9972_10.txt;7;4;5;16;225;0.03;0.02;0.02
6781_10.txt;18;0;0;18;234;0.08;0.0;0.0
5112_9.txt;0;1;0;1;178;0.0;0.01;0.0
5104_10.txt;5;2;0;7;71;0.07;0.03;0.0
10145_8.txt;3;0;0;3;153;0.02;0.0;0.0
4984_8.txt;5;0;0;5;101;0.05;0.0;0.0
8750_7.txt;8;3;0;11;287;0.03;0.01;0.0
892_10.txt;0;0;0;0;137;0.0;0.0;0.0
5908_10.txt;13;0;0;13;174;0.07;0.0;0.0
4204_10.txt;9;2;0;11;191;0.05;0.01;0.0
7047_10.txt;11;0;0;11;166;0.07;0.0;0.0
4782_9.txt;3;0;0;3;125;0.02;0.0;0.0
5268_10.txt;0;0;0;0;97;0.0;0.0;0.0
10634_10.txt;14;1;0;15;239;0.06;0.0;0.0
5979_9.txt;27;0;10;37;553;0.05;0.0;0.02
7107_10.txt;0;0;0;0;129;0.0;0.0;0.0
4982_7.txt;0;0;0;0;170;0.0;0.0;0.0
9957_7.txt;0;4;0;4;291;0.0;0.01;0.0
5278_7.txt;0;1;0;1;124;0.0;0.01;0.0
5083_8.txt;9;0;0;9;196;0.05;0.0;0.0
11370_9.txt;12;2;1;15;212;0.06;0.01;0.0
3413_10.txt;2;0;0;2;246;0.01;0.0;0.0
6851_8.txt;43;2;4;49;945;0.05;0.0;0.0
3150_10.txt;86;5;3;94;1137;0.08;0.0;0.0
6633_10.txt;2;0;4;6;323;0.01;0.0;0.01
12034_10.txt;18;1;0;19;118;0.15;0.01;0.0
1300_10.txt;0;1;0;1;137;0.0;0.01;0.0
4411_9.txt;12;2;0;14;603;0.02;0.0;0.0
12347_9.txt;10;0;0;10;165;0.06;0.0;0.0
5423_9.txt;14;1;0;15;151;0.09;0.01;0.0
7227_7.txt;6;0;0;6;174;0.03;0.0;0.0
656_10.txt;6;0;0;6;180;0.03;0.0;0.0
11277_10.txt;16;0;0;16;290;0.06;0.0;0.0
8654_9.txt;2;0;0;2;187;0.01;0.0;0.0
1019_10.txt;61;7;5;73;1114;0.05;0.01;0.0
11415_8.txt;0;0;0;0;75;0.0;0.0;0.0
4745_7.txt;11;1;0;12;186;0.06;0.01;0.0
12481_8.txt;0;1;0;1;313;0.0;0.0;0.0
8354_8.txt;4;1;0;5;157;0.03;0.01;0.0
307_8.txt;11;0;0;11;230;0.05;0.0;0.0
8330_7.txt;20;0;2;22;350;0.06;0.0;0.01
1306_7.txt;12;0;5;17;402;0.03;0.0;0.01
8944_8.txt;19;0;0;19;147;0.13;0.0;0.0
914_8.txt;12;1;2;15;229;0.05;0.0;0.01
11766_8.txt;2;0;0;2;214;0.01;0.0;0.0
10641_7.txt;0;0;0;0;155;0.0;0.0;0.0
539_10.txt;5;0;0;5;149;0.03;0.0;0.0
3195_10.txt;9;4;0;13;247;0.04;0.02;0.0
5966_7.txt;0;0;0;0;237;0.0;0.0;0.0
1743_9.txt;1;0;0;1;413;0.0;0.0;0.0
5589_7.txt;6;0;2;8;253;0.02;0.0;0.01
2223_8.txt;0;0;0;0;68;0.0;0.0;0.0
4146_10.txt;19;0;0;19;147;0.13;0.0;0.0
11541_10.txt;5;0;0;5;138;0.04;0.0;0.0
2593_10.txt;0;0;0;0;210;0.0;0.0;0.0
3948_9.txt;0;1;0;1;150;0.0;0.01;0.0
10110_10.txt;5;0;2;7;217;0.02;0.0;0.01
4304_9.txt;0;0;0;0;210;0.0;0.0;0.0
6615_8.txt;28;8;0;36;665;0.04;0.01;0.0
10736_10.txt;0;3;0;3;56;0.0;0.05;0.0
8481_8.txt;27;0;11;38;422;0.06;0.0;0.03
8560_10.txt;2;1;0;3;126;0.02;0.01;0.0
12388_8.txt;10;0;0;10;175;0.06;0.0;0.0
31_8.txt;28;0;0;28;481;0.06;0.0;0.0
5723_7.txt;0;0;0;0;225;0.0;0.0;0.0
5623_10.txt;4;0;0;4;43;0.09;0.0;0.0
2506_9.txt;3;0;0;3;295;0.01;0.0;0.0
11803_7.txt;31;0;0;31;717;0.04;0.0;0.0
7668_10.txt;2;0;0;2;145;0.01;0.0;0.0
1575_9.txt;0;0;0;0;210;0.0;0.0;0.0
5662_10.txt;0;0;1;1;157;0.0;0.0;0.01
6183_7.txt;18;0;5;23;318;0.06;0.0;0.02
1632_7.txt;8;0;2;10;180;0.04;0.0;0.01
291_10.txt;2;0;0;2;149;0.01;0.0;0.0
2888_10.txt;0;0;1;1;78;0.0;0.0;0.01
7228_9.txt;5;0;0;5;112;0.04;0.0;0.0
1921_9.txt;12;0;2;14;129;0.09;0.0;0.02
9436_10.txt;21;8;2;31;793;0.03;0.01;0.0
5868_8.txt;0;3;0;3;216;0.0;0.01;0.0
1466_10.txt;26;0;2;28;421;0.06;0.0;0.0
11899_7.txt;33;6;0;39;728;0.05;0.01;0.0
7689_10.txt;0;2;0;2;149;0.0;0.01;0.0
2612_10.txt;4;0;0;4;146;0.03;0.0;0.0
192_9.txt;6;0;0;6;182;0.03;0.0;0.0
2768_8.txt;16;0;3;19;162;0.1;0.0;0.02
6077_9.txt;4;0;0;4;198;0.02;0.0;0.0
4262_10.txt;8;0;0;8;156;0.05;0.0;0.0
11075_10.txt;7;0;0;7;297;0.02;0.0;0.0
3486_10.txt;7;0;0;7;79;0.09;0.0;0.0
4263_8.txt;10;1;0;11;214;0.05;0.0;0.0
5340_8.txt;10;1;0;11;172;0.06;0.01;0.0
6064_7.txt;0;3;0;3;165;0.0;0.02;0.0
8848_7.txt;15;0;1;16;461;0.03;0.0;0.0
7522_8.txt;27;4;1;32;710;0.04;0.01;0.0
467_7.txt;7;0;1;8;145;0.05;0.0;0.01
7620_10.txt;2;0;0;2;137;0.01;0.0;0.0
12387_10.txt;6;0;0;6;197;0.03;0.0;0.0
11023_9.txt;5;3;0;8;212;0.02;0.01;0.0
1237_8.txt;2;0;0;2;83;0.02;0.0;0.0
9403_8.txt;4;0;2;6;170;0.02;0.0;0.01
1824_8.txt;7;0;1;8;412;0.02;0.0;0.0
6949_10.txt;32;4;0;36;819;0.04;0.0;0.0
9260_7.txt;12;3;0;15;286;0.04;0.01;0.0
722_7.txt;23;3;27;53;478;0.05;0.01;0.06
4874_10.txt;2;0;0;2;138;0.01;0.0;0.0
782_9.txt;0;0;0;0;147;0.0;0.0;0.0
3934_8.txt;8;0;1;9;151;0.05;0.0;0.01
6501_10.txt;2;0;0;2;142;0.01;0.0;0.0
3227_7.txt;27;0;0;27;258;0.1;0.0;0.0
2674_7.txt;0;1;0;1;140;0.0;0.01;0.0
1943_10.txt;8;2;0;10;430;0.02;0.0;0.0
5219_7.txt;11;0;0;11;285;0.04;0.0;0.0
1043_10.txt;9;0;0;9;263;0.03;0.0;0.0
2667_8.txt;11;0;1;12;318;0.03;0.0;0.0
7236_8.txt;31;4;1;36;607;0.05;0.01;0.0
2087_10.txt;22;1;0;23;333;0.07;0.0;0.0
3148_9.txt;12;0;2;14;296;0.04;0.0;0.01
1656_9.txt;0;0;0;0;139;0.0;0.0;0.0
12115_10.txt;1;0;0;1;158;0.01;0.0;0.0
6029_7.txt;30;12;2;44;909;0.03;0.01;0.0
11393_7.txt;0;3;0;3;295;0.0;0.01;0.0
4273_10.txt;0;0;0;0;37;0.0;0.0;0.0
4209_7.txt;38;7;2;47;834;0.05;0.01;0.0
5535_8.txt;2;3;0;5;252;0.01;0.01;0.0
3135_9.txt;12;0;0;12;156;0.08;0.0;0.0
5919_9.txt;0;1;0;1;180;0.0;0.01;0.0
6682_10.txt;16;2;0;18;206;0.08;0.01;0.0
11995_10.txt;5;0;3;8;174;0.03;0.0;0.02
7258_10.txt;3;2;0;5;230;0.01;0.01;0.0
7455_8.txt;1;0;0;1;350;0.0;0.0;0.0
5893_9.txt;11;4;1;16;315;0.03;0.01;0.0
9761_10.txt;0;0;0;0;129;0.0;0.0;0.0
8163_8.txt;51;3;4;58;318;0.16;0.01;0.01
2305_10.txt;0;0;0;0;252;0.0;0.0;0.0
983_7.txt;3;0;0;3;72;0.04;0.0;0.0
2999_7.txt;17;0;2;19;310;0.05;0.0;0.01
35_8.txt;3;0;0;3;145;0.02;0.0;0.0
5986_10.txt;4;0;0;4;129;0.03;0.0;0.0
4853_10.txt;5;0;0;5;485;0.01;0.0;0.0
4955_9.txt;10;0;0;10;168;0.06;0.0;0.0
3982_7.txt;14;0;4;18;226;0.06;0.0;0.02
255_10.txt;10;0;0;10;465;0.02;0.0;0.0
7632_10.txt;17;7;0;24;541;0.03;0.01;0.0
5144_10.txt;1;0;0;1;70;0.01;0.0;0.0
10517_8.txt;3;2;0;5;132;0.02;0.02;0.0
7857_10.txt;12;0;5;17;745;0.02;0.0;0.01
5271_7.txt;20;2;0;22;501;0.04;0.0;0.0
2239_7.txt;7;3;1;11;163;0.04;0.02;0.01
6036_10.txt;0;0;0;0;340;0.0;0.0;0.0
1286_8.txt;10;2;1;13;254;0.04;0.01;0.0
11258_8.txt;3;0;0;3;172;0.02;0.0;0.0
7738_8.txt;22;2;1;25;638;0.03;0.0;0.0
2053_10.txt;3;0;0;3;205;0.01;0.0;0.0
10049_8.txt;6;0;0;6;221;0.03;0.0;0.0
4872_8.txt;34;7;1;42;627;0.05;0.01;0.0
7584_7.txt;11;0;1;12;198;0.06;0.0;0.01
4871_8.txt;5;1;0;6;293;0.02;0.0;0.0
6162_8.txt;11;0;0;11;146;0.08;0.0;0.0
9489_9.txt;7;0;0;7;156;0.04;0.0;0.0
4742_9.txt;4;6;0;10;123;0.03;0.05;0.0
12462_7.txt;11;2;0;13;124;0.09;0.02;0.0
8652_8.txt;17;3;2;22;519;0.03;0.01;0.0
3850_8.txt;9;3;2;14;325;0.03;0.01;0.01
11182_10.txt;5;0;0;5;95;0.05;0.0;0.0
4864_7.txt;74;5;2;81;994;0.07;0.01;0.0
11889_7.txt;9;0;1;10;186;0.05;0.0;0.01
7963_9.txt;0;0;0;0;62;0.0;0.0;0.0
1874_10.txt;2;0;0;2;155;0.01;0.0;0.0
10928_7.txt;0;0;0;0;452;0.0;0.0;0.0
6173_8.txt;2;0;0;2;140;0.01;0.0;0.0
1101_8.txt;11;3;0;14;254;0.04;0.01;0.0
7013_9.txt;11;0;0;11;325;0.03;0.0;0.0
9976_7.txt;4;3;0;7;148;0.03;0.02;0.0
4554_8.txt;39;1;0;40;709;0.06;0.0;0.0
6296_7.txt;20;3;0;23;336;0.06;0.01;0.0
9269_7.txt;0;1;0;1;331;0.0;0.0;0.0
3581_9.txt;10;0;0;10;168;0.06;0.0;0.0
12167_10.txt;7;4;0;11;300;0.02;0.01;0.0
6197_10.txt;20;2;2;24;350;0.06;0.01;0.01
7191_9.txt;8;2;0;10;147;0.05;0.01;0.0
2024_9.txt;8;1;0;9;93;0.09;0.01;0.0
4963_10.txt;1;5;0;6;172;0.01;0.03;0.0
6622_10.txt;2;3;0;5;302;0.01;0.01;0.0
10128_9.txt;49;0;0;49;406;0.12;0.0;0.0
7946_10.txt;0;2;0;2;300;0.0;0.01;0.0
7746_10.txt;2;3;0;5;334;0.01;0.01;0.0
8832_7.txt;9;2;0;11;317;0.03;0.01;0.0
3552_10.txt;12;6;0;18;184;0.07;0.03;0.0
8063_10.txt;10;3;1;14;254;0.04;0.01;0.0
10152_9.txt;3;0;0;3;164;0.02;0.0;0.0
11327_10.txt;0;0;0;0;216;0.0;0.0;0.0
2560_7.txt;3;0;0;3;130;0.02;0.0;0.0
4059_8.txt;11;7;1;19;601;0.02;0.01;0.0
7994_9.txt;0;0;0;0;179;0.0;0.0;0.0
3721_8.txt;0;0;0;0;76;0.0;0.0;0.0
10568_10.txt;2;0;0;2;122;0.02;0.0;0.0
938_9.txt;14;0;0;14;238;0.06;0.0;0.0
8876_10.txt;3;0;0;3;49;0.06;0.0;0.0
10056_8.txt;0;0;0;0;144;0.0;0.0;0.0
10293_8.txt;18;2;0;20;271;0.07;0.01;0.0
10554_7.txt;0;0;0;0;291;0.0;0.0;0.0
12126_8.txt;11;0;0;11;173;0.06;0.0;0.0
5381_7.txt;16;0;0;16;251;0.06;0.0;0.0
6981_9.txt;5;2;3;10;189;0.03;0.01;0.02
11262_7.txt;2;0;0;2;307;0.01;0.0;0.0
6314_9.txt;9;0;0;9;170;0.05;0.0;0.0
11851_10.txt;0;0;1;1;96;0.0;0.0;0.01
1796_8.txt;23;1;0;24;653;0.04;0.0;0.0
7832_7.txt;25;3;0;28;492;0.05;0.01;0.0
2176_8.txt;10;0;0;10;434;0.02;0.0;0.0
2916_9.txt;0;2;7;9;134;0.0;0.01;0.05
2348_10.txt;4;2;0;6;327;0.01;0.01;0.0
8080_8.txt;5;0;1;6;232;0.02;0.0;0.0
2201_10.txt;2;0;5;7;176;0.01;0.0;0.03
5375_8.txt;3;1;0;4;462;0.01;0.0;0.0
10626_7.txt;5;1;0;6;213;0.02;0.0;0.0
4456_7.txt;2;0;0;2;48;0.04;0.0;0.0
2737_9.txt;18;2;0;20;314;0.06;0.01;0.0
3526_8.txt;35;5;2;42;751;0.05;0.01;0.0
6510_7.txt;6;0;2;8;395;0.02;0.0;0.01
366_9.txt;6;0;0;6;82;0.07;0.0;0.0
1908_9.txt;5;0;0;5;224;0.02;0.0;0.0
12155_7.txt;22;1;2;25;436;0.05;0.0;0.0
8271_10.txt;35;1;2;38;267;0.13;0.0;0.01
2218_7.txt;16;2;0;18;287;0.06;0.01;0.0
660_9.txt;7;2;3;12;189;0.04;0.01;0.02
8663_7.txt;0;1;0;1;107;0.0;0.01;0.0
9034_10.txt;10;0;0;10;145;0.07;0.0;0.0
7271_7.txt;4;1;1;6;205;0.02;0.0;0.0
10525_10.txt;28;4;0;32;318;0.09;0.01;0.0
8104_7.txt;0;1;0;1;277;0.0;0.0;0.0
3353_8.txt;4;2;0;6;143;0.03;0.01;0.0
7845_10.txt;3;1;0;4;173;0.02;0.01;0.0
7822_8.txt;3;1;10;14;240;0.01;0.0;0.04
5173_9.txt;0;0;0;0;152;0.0;0.0;0.0
11901_9.txt;6;0;3;9;145;0.04;0.0;0.02
2211_8.txt;5;0;3;8;299;0.02;0.0;0.01
6641_8.txt;2;3;0;5;247;0.01;0.01;0.0
3833_8.txt;0;0;0;0;88;0.0;0.0;0.0
3487_9.txt;28;4;27;59;893;0.03;0.0;0.03
2352_9.txt;24;1;2;27;506;0.05;0.0;0.0
9182_10.txt;19;4;1;24;409;0.05;0.01;0.0
10909_10.txt;29;5;2;36;1180;0.02;0.0;0.0
1821_8.txt;2;2;0;4;182;0.01;0.01;0.0
269_8.txt;3;0;0;3;131;0.02;0.0;0.0
5753_8.txt;0;0;1;1;206;0.0;0.0;0.0
9104_10.txt;3;0;0;3;153;0.02;0.0;0.0
4272_10.txt;0;1;0;1;120;0.0;0.01;0.0
5624_7.txt;2;0;0;2;164;0.01;0.0;0.0
9222_7.txt;49;3;1;53;769;0.06;0.0;0.0
6918_10.txt;1;0;1;2;76;0.01;0.0;0.01
3476_10.txt;4;0;1;5;197;0.02;0.0;0.01
2091_9.txt;30;10;2;42;534;0.06;0.02;0.0
3604_10.txt;4;0;0;4;173;0.02;0.0;0.0
3391_7.txt;11;10;0;21;415;0.03;0.02;0.0
7435_9.txt;6;0;0;6;254;0.02;0.0;0.0
6734_10.txt;12;1;0;13;169;0.07;0.01;0.0
3383_8.txt;5;3;2;10;253;0.02;0.01;0.01
12010_10.txt;27;7;3;37;631;0.04;0.01;0.0
2285_10.txt;8;0;0;8;221;0.04;0.0;0.0
2216_9.txt;4;2;0;6;142;0.03;0.01;0.0
11996_10.txt;22;0;12;34;570;0.04;0.0;0.02
3490_8.txt;3;0;0;3;68;0.04;0.0;0.0
1311_10.txt;4;0;0;4;146;0.03;0.0;0.0
5889_7.txt;17;0;1;18;309;0.06;0.0;0.0
1219_10.txt;0;0;0;0;89;0.0;0.0;0.0
82_8.txt;30;0;1;31;385;0.08;0.0;0.0
1881_7.txt;15;0;0;15;191;0.08;0.0;0.0
7173_10.txt;4;3;4;11;122;0.03;0.02;0.03
2655_10.txt;46;4;7;57;872;0.05;0.0;0.01
6864_7.txt;0;5;3;8;166;0.0;0.03;0.02
10556_10.txt;1;0;0;1;98;0.01;0.0;0.0
47_8.txt;8;0;0;8;167;0.05;0.0;0.0
102_10.txt;2;0;4;6;339;0.01;0.0;0.01
11670_7.txt;3;1;0;4;142;0.02;0.01;0.0
2300_10.txt;7;0;0;7;139;0.05;0.0;0.0
7705_7.txt;2;1;1;4;228;0.01;0.0;0.0
4512_9.txt;3;0;0;3;335;0.01;0.0;0.0
4297_9.txt;9;2;0;11;176;0.05;0.01;0.0
6690_10.txt;2;0;0;2;97;0.02;0.0;0.0
6518_10.txt;5;4;0;9;233;0.02;0.02;0.0
4227_10.txt;6;0;0;6;56;0.11;0.0;0.0
3129_10.txt;11;2;0;13;148;0.07;0.01;0.0
11528_7.txt;7;0;0;7;150;0.05;0.0;0.0
5262_7.txt;32;0;0;32;870;0.04;0.0;0.0
544_8.txt;5;0;0;5;188;0.03;0.0;0.0
12285_10.txt;23;2;0;25;390;0.06;0.01;0.0
140_8.txt;0;0;0;0;89;0.0;0.0;0.0
4162_10.txt;0;0;0;0;117;0.0;0.0;0.0
3015_9.txt;11;0;0;11;137;0.08;0.0;0.0
6905_7.txt;4;1;0;5;172;0.02;0.01;0.0
8217_8.txt;12;2;4;18;245;0.05;0.01;0.02
12070_7.txt;24;0;0;24;514;0.05;0.0;0.0
9076_8.txt;3;2;0;5;224;0.01;0.01;0.0
5483_10.txt;0;3;2;5;190;0.0;0.02;0.01
12022_10.txt;2;0;0;2;200;0.01;0.0;0.0
1916_8.txt;6;0;0;6;153;0.04;0.0;0.0
7680_8.txt;7;0;0;7;154;0.05;0.0;0.0
11270_10.txt;4;0;0;4;265;0.02;0.0;0.0
5504_10.txt;2;0;2;4;260;0.01;0.0;0.01
10540_10.txt;0;0;0;0;157;0.0;0.0;0.0
8159_10.txt;0;0;0;0;90;0.0;0.0;0.0
10936_8.txt;3;0;0;3;286;0.01;0.0;0.0
11228_10.txt;0;0;0;0;184;0.0;0.0;0.0
4408_8.txt;26;3;0;29;404;0.06;0.01;0.0
11536_7.txt;40;4;2;46;769;0.05;0.01;0.0
888_8.txt;7;1;2;10;285;0.02;0.0;0.01
8552_9.txt;3;0;0;3;190;0.02;0.0;0.0
3447_9.txt;16;5;0;21;1031;0.02;0.0;0.0
7716_9.txt;26;2;5;33;464;0.06;0.0;0.01
455_10.txt;4;0;0;4;109;0.04;0.0;0.0
6379_9.txt;15;2;9;26;864;0.02;0.0;0.01
10674_8.txt;21;3;0;24;463;0.05;0.01;0.0
11411_8.txt;34;2;6;42;270;0.13;0.01;0.02
6012_9.txt;9;2;0;11;242;0.04;0.01;0.0
8212_7.txt;16;0;0;16;582;0.03;0.0;0.0
6224_7.txt;49;3;2;54;728;0.07;0.0;0.0
2276_7.txt;6;1;0;7;294;0.02;0.0;0.0
10614_7.txt;4;0;0;4;212;0.02;0.0;0.0
10217_9.txt;2;3;0;5;145;0.01;0.02;0.0
1542_10.txt;1;1;0;2;103;0.01;0.01;0.0
9423_8.txt;11;0;2;13;172;0.06;0.0;0.01
8708_8.txt;3;1;0;4;125;0.02;0.01;0.0
3513_10.txt;2;6;3;11;139;0.01;0.04;0.02
7758_7.txt;14;3;0;17;266;0.05;0.01;0.0
12277_10.txt;2;1;0;3;112;0.02;0.01;0.0
5770_10.txt;0;0;0;0;54;0.0;0.0;0.0
3359_10.txt;12;0;0;12;234;0.05;0.0;0.0
12444_10.txt;8;0;0;8;157;0.05;0.0;0.0
6763_8.txt;19;1;1;21;814;0.02;0.0;0.0
3878_10.txt;25;10;2;37;567;0.04;0.02;0.0
5131_10.txt;7;0;1;8;158;0.04;0.0;0.01
10664_8.txt;4;0;0;4;164;0.02;0.0;0.0
713_10.txt;0;0;0;0;158;0.0;0.0;0.0
8044_10.txt;3;0;0;3;140;0.02;0.0;0.0
9083_8.txt;2;6;2;10;256;0.01;0.02;0.01
2238_9.txt;0;1;1;2;147;0.0;0.01;0.01
1500_9.txt;0;1;0;1;166;0.0;0.01;0.0
10086_7.txt;3;1;1;5;63;0.05;0.02;0.02
11730_10.txt;12;2;0;14;228;0.05;0.01;0.0
7233_7.txt;13;4;0;17;355;0.04;0.01;0.0
2574_7.txt;9;0;0;9;214;0.04;0.0;0.0
8244_9.txt;10;0;0;10;265;0.04;0.0;0.0
3530_7.txt;14;5;0;19;538;0.03;0.01;0.0
3985_8.txt;10;0;0;10;366;0.03;0.0;0.0
7056_7.txt;2;0;0;2;104;0.02;0.0;0.0
1538_10.txt;2;3;0;5;116;0.02;0.03;0.0
2109_9.txt;0;0;0;0;128;0.0;0.0;0.0
8045_8.txt;12;0;0;12;219;0.05;0.0;0.0
863_10.txt;0;1;0;1;213;0.0;0.0;0.0
8088_7.txt;30;15;9;54;1113;0.03;0.01;0.01
10312_10.txt;0;0;0;0;59;0.0;0.0;0.0
5840_7.txt;8;1;1;10;359;0.02;0.0;0.0
4725_9.txt;3;0;0;3;93;0.03;0.0;0.0
10989_9.txt;18;2;3;23;559;0.03;0.0;0.01
9399_7.txt;2;0;0;2;147;0.01;0.0;0.0
5767_8.txt;9;0;0;9;466;0.02;0.0;0.0
10533_10.txt;4;0;0;4;138;0.03;0.0;0.0
4743_8.txt;0;0;0;0;183;0.0;0.0;0.0
2185_9.txt;13;2;7;22;232;0.06;0.01;0.03
1797_9.txt;15;0;0;15;653;0.02;0.0;0.0
10612_7.txt;9;0;0;9;215;0.04;0.0;0.0
10649_7.txt;3;1;2;6;112;0.03;0.01;0.02
2371_8.txt;0;0;0;0;157;0.0;0.0;0.0
2940_10.txt;5;1;2;8;144;0.03;0.01;0.01
1325_9.txt;12;1;0;13;470;0.03;0.0;0.0
7354_7.txt;10;5;2;17;195;0.05;0.03;0.01
1133_10.txt;16;0;0;16;201;0.08;0.0;0.0
1845_7.txt;27;0;1;28;943;0.03;0.0;0.0
6444_8.txt;8;6;0;14;380;0.02;0.02;0.0
8170_7.txt;2;0;0;2;192;0.01;0.0;0.0
7920_7.txt;15;1;0;16;204;0.07;0.0;0.0
7748_9.txt;0;1;0;1;172;0.0;0.01;0.0
7000_7.txt;2;0;0;2;376;0.01;0.0;0.0
7481_10.txt;12;1;4;17;430;0.03;0.0;0.01
968_10.txt;6;1;0;7;1033;0.01;0.0;0.0
1201_8.txt;19;0;2;21;349;0.05;0.0;0.01
10172_8.txt;2;1;0;3;161;0.01;0.01;0.0
11470_10.txt;0;0;1;1;271;0.0;0.0;0.0
9904_8.txt;3;0;1;4;455;0.01;0.0;0.0
9486_10.txt;0;0;0;0;108;0.0;0.0;0.0
11517_9.txt;3;2;0;5;121;0.02;0.02;0.0
11305_8.txt;46;2;1;49;1036;0.04;0.0;0.0
10372_7.txt;3;1;0;4;206;0.01;0.0;0.0
6785_8.txt;57;2;3;62;1075;0.05;0.0;0.0
11281_8.txt;32;1;4;37;507;0.06;0.0;0.01
2257_7.txt;6;6;0;12;422;0.01;0.01;0.0
4884_10.txt;11;0;0;11;213;0.05;0.0;0.0
4680_10.txt;4;6;0;10;124;0.03;0.05;0.0
10144_8.txt;0;0;1;1;206;0.0;0.0;0.0
11375_9.txt;0;0;1;1;139;0.0;0.0;0.01
11132_10.txt;14;2;0;16;757;0.02;0.0;0.0
1956_8.txt;5;0;0;5;456;0.01;0.0;0.0
7019_7.txt;35;1;1;37;659;0.05;0.0;0.0
12391_9.txt;32;3;4;39;473;0.07;0.01;0.01
11097_9.txt;28;2;1;31;661;0.04;0.0;0.0
1594_8.txt;3;0;0;3;273;0.01;0.0;0.0
10160_7.txt;1;2;0;3;125;0.01;0.02;0.0
9135_9.txt;2;1;0;3;202;0.01;0.0;0.0
3619_8.txt;3;0;1;4;119;0.03;0.0;0.01
5674_7.txt;7;0;0;7;510;0.01;0.0;0.0
6101_8.txt;7;1;3;11;148;0.05;0.01;0.02
562_8.txt;77;11;0;88;1023;0.08;0.01;0.0
8086_9.txt;15;0;0;15;382;0.04;0.0;0.0
10477_9.txt;0;0;0;0;193;0.0;0.0;0.0
10154_8.txt;3;0;0;3;174;0.02;0.0;0.0
600_10.txt;6;0;0;6;132;0.05;0.0;0.0
9088_8.txt;74;17;24;115;686;0.11;0.02;0.03
9250_8.txt;16;0;0;16;210;0.08;0.0;0.0
7055_8.txt;9;0;0;9;114;0.08;0.0;0.0
9625_8.txt;10;0;0;10;122;0.08;0.0;0.0
3448_7.txt;2;2;0;4;191;0.01;0.01;0.0
7699_10.txt;1;0;2;3;160;0.01;0.0;0.01
2099_10.txt;10;0;0;10;187;0.05;0.0;0.0
10994_8.txt;0;0;0;0;113;0.0;0.0;0.0
11990_10.txt;5;0;9;14;186;0.03;0.0;0.05
4315_9.txt;0;0;0;0;141;0.0;0.0;0.0
7747_10.txt;4;1;0;5;496;0.01;0.0;0.0
6219_7.txt;35;5;2;42;855;0.04;0.01;0.0
1444_7.txt;86;14;12;112;773;0.11;0.02;0.02
6807_10.txt;3;0;0;3;95;0.03;0.0;0.0
8070_8.txt;46;4;8;58;597;0.08;0.01;0.01
11489_10.txt;3;1;0;4;167;0.02;0.01;0.0
2124_10.txt;5;0;0;5;180;0.03;0.0;0.0
789_7.txt;2;1;2;5;277;0.01;0.0;0.01
5700_8.txt;7;0;0;7;265;0.03;0.0;0.0
9150_8.txt;0;0;0;0;60;0.0;0.0;0.0
6401_8.txt;11;1;0;12;305;0.04;0.0;0.0
5459_8.txt;5;0;0;5;211;0.02;0.0;0.0
1044_8.txt;40;2;15;57;601;0.07;0.0;0.02
6889_10.txt;3;0;0;3;156;0.02;0.0;0.0
4786_10.txt;8;0;0;8;146;0.05;0.0;0.0
8518_10.txt;0;0;0;0;222;0.0;0.0;0.0
5596_10.txt;0;1;0;1;89;0.0;0.01;0.0
1401_7.txt;9;0;0;9;276;0.03;0.0;0.0
6371_9.txt;14;4;4;22;587;0.02;0.01;0.01
6545_10.txt;18;0;1;19;220;0.08;0.0;0.0
409_10.txt;2;0;0;2;220;0.01;0.0;0.0
5218_7.txt;3;0;0;3;354;0.01;0.0;0.0
9096_10.txt;4;1;4;9;158;0.03;0.01;0.03
2546_10.txt;5;0;2;7;260;0.02;0.0;0.01
10284_9.txt;21;3;0;24;481;0.04;0.01;0.0
1939_8.txt;0;1;0;1;205;0.0;0.0;0.0
4049_7.txt;14;5;2;21;498;0.03;0.01;0.0
6034_10.txt;2;0;0;2;227;0.01;0.0;0.0
9797_7.txt;3;0;0;3;410;0.01;0.0;0.0
3539_9.txt;2;0;0;2;209;0.01;0.0;0.0
10162_9.txt;4;0;0;4;176;0.02;0.0;0.0
12129_7.txt;16;3;0;19;218;0.07;0.01;0.0
4348_7.txt;32;0;0;32;328;0.1;0.0;0.0
3200_10.txt;7;0;0;7;217;0.03;0.0;0.0
6662_7.txt;14;0;0;14;192;0.07;0.0;0.0
8314_9.txt;0;0;0;0;164;0.0;0.0;0.0
10669_10.txt;0;1;0;1;26;0.0;0.04;0.0
7167_9.txt;0;0;0;0;173;0.0;0.0;0.0
2876_10.txt;5;0;5;10;159;0.03;0.0;0.03
4567_10.txt;25;0;0;25;341;0.07;0.0;0.0
11294_10.txt;0;0;1;1;117;0.0;0.0;0.01
2696_8.txt;35;1;1;37;939;0.04;0.0;0.0
2346_9.txt;23;0;0;23;236;0.1;0.0;0.0
10322_7.txt;23;0;0;23;448;0.05;0.0;0.0
11458_7.txt;1;0;0;1;206;0.0;0.0;0.0
12294_8.txt;12;1;1;14;285;0.04;0.0;0.0
5290_10.txt;12;3;0;15;161;0.07;0.02;0.0
730_7.txt;5;0;1;6;142;0.04;0.0;0.01
5774_8.txt;0;4;0;4;262;0.0;0.02;0.0
7694_10.txt;3;0;3;6;145;0.02;0.0;0.02
7448_8.txt;2;0;0;2;119;0.02;0.0;0.0
3906_10.txt;2;0;0;2;64;0.03;0.0;0.0
11520_8.txt;5;3;0;8;187;0.03;0.02;0.0
3100_10.txt;6;0;0;6;188;0.03;0.0;0.0
8030_9.txt;8;1;0;9;106;0.08;0.01;0.0
8615_10.txt;4;1;0;5;201;0.02;0.0;0.0
6120_9.txt;0;0;0;0;48;0.0;0.0;0.0
2590_7.txt;12;0;0;12;260;0.05;0.0;0.0
393_8.txt;0;0;0;0;47;0.0;0.0;0.0
8903_7.txt;2;0;0;2;287;0.01;0.0;0.0
1046_10.txt;4;0;0;4;145;0.03;0.0;0.0
9514_10.txt;4;0;0;4;105;0.04;0.0;0.0
3389_7.txt;31;4;4;39;556;0.06;0.01;0.01
2953_8.txt;0;0;0;0;42;0.0;0.0;0.0
8048_7.txt;4;0;0;4;72;0.06;0.0;0.0
10680_8.txt;9;1;8;18;196;0.05;0.01;0.04
343_10.txt;26;0;0;26;507;0.05;0.0;0.0
4644_10.txt;2;1;0;3;190;0.01;0.01;0.0
637_10.txt;4;1;0;5;163;0.02;0.01;0.0
8460_7.txt;4;0;4;8;234;0.02;0.0;0.02
9097_10.txt;0;1;0;1;202;0.0;0.0;0.0
2359_10.txt;2;0;0;2;233;0.01;0.0;0.0
4396_10.txt;7;0;0;7;144;0.05;0.0;0.0
4029_10.txt;20;4;0;24;197;0.1;0.02;0.0
5190_8.txt;2;0;0;2;65;0.03;0.0;0.0
6479_10.txt;2;3;0;5;231;0.01;0.01;0.0
10073_10.txt;2;2;1;5;284;0.01;0.01;0.0
8079_8.txt;2;0;3;5;177;0.01;0.0;0.02
1852_9.txt;26;13;3;42;557;0.05;0.02;0.01
3783_10.txt;0;0;0;0;49;0.0;0.0;0.0
2602_10.txt;0;0;0;0;54;0.0;0.0;0.0
147_9.txt;0;0;0;0;205;0.0;0.0;0.0
10505_10.txt;0;0;1;1;99;0.0;0.0;0.01
913_10.txt;0;1;0;1;452;0.0;0.0;0.0
10806_9.txt;4;0;0;4;83;0.05;0.0;0.0
283_8.txt;8;0;1;9;362;0.02;0.0;0.0
980_7.txt;36;6;0;42;436;0.08;0.01;0.0
6398_8.txt;6;0;2;8;124;0.05;0.0;0.02
9901_8.txt;15;0;0;15;690;0.02;0.0;0.0
9188_10.txt;2;0;0;2;244;0.01;0.0;0.0
7740_10.txt;2;0;0;2;202;0.01;0.0;0.0
6315_10.txt;0;3;0;3;279;0.0;0.01;0.0
11591_10.txt;0;1;2;3;151;0.0;0.01;0.01
8263_9.txt;3;1;1;5;365;0.01;0.0;0.0
7487_8.txt;28;8;7;43;512;0.05;0.02;0.01
416_8.txt;24;3;0;27;236;0.1;0.01;0.0
7826_8.txt;10;2;0;12;122;0.08;0.02;0.0
8537_10.txt;0;0;0;0;47;0.0;0.0;0.0
9671_10.txt;15;1;0;16;178;0.08;0.01;0.0
7882_7.txt;17;6;1;24;246;0.07;0.02;0.0
3558_8.txt;4;2;0;6;134;0.03;0.01;0.0
9815_7.txt;7;0;0;7;81;0.09;0.0;0.0
4323_9.txt;37;2;4;43;663;0.06;0.0;0.01
2477_7.txt;44;0;0;44;469;0.09;0.0;0.0
3189_8.txt;10;0;8;18;368;0.03;0.0;0.02
5578_10.txt;9;2;1;12;296;0.03;0.01;0.0
4258_9.txt;9;3;0;12;219;0.04;0.01;0.0
2177_8.txt;21;1;0;22;906;0.02;0.0;0.0
11087_8.txt;1;0;2;3;625;0.0;0.0;0.0
7815_8.txt;12;0;0;12;108;0.11;0.0;0.0
4625_10.txt;1;1;0;2;169;0.01;0.01;0.0
1415_10.txt;0;0;0;0;170;0.0;0.0;0.0
6279_10.txt;0;0;0;0;69;0.0;0.0;0.0
1820_9.txt;1;0;0;1;150;0.01;0.0;0.0
10646_8.txt;6;6;0;12;239;0.03;0.03;0.0
5415_10.txt;0;0;0;0;69;0.0;0.0;0.0
8598_7.txt;30;2;6;38;585;0.05;0.0;0.01
2591_7.txt;2;0;0;2;143;0.01;0.0;0.0
9641_9.txt;0;0;0;0;64;0.0;0.0;0.0
9906_10.txt;0;0;0;0;128;0.0;0.0;0.0
7562_10.txt;3;0;1;4;487;0.01;0.0;0.0
8932_9.txt;3;1;0;4;345;0.01;0.0;0.0
6696_7.txt;15;1;0;16;439;0.03;0.0;0.0
1264_10.txt;3;4;9;16;742;0.0;0.01;0.01
10790_8.txt;5;2;0;7;148;0.03;0.01;0.0
10802_8.txt;2;0;0;2;140;0.01;0.0;0.0
11926_10.txt;40;5;8;53;500;0.08;0.01;0.02
6491_10.txt;0;0;0;0;66;0.0;0.0;0.0
5827_10.txt;5;0;0;5;199;0.03;0.0;0.0
9245_8.txt;6;0;0;6;276;0.02;0.0;0.0
6445_10.txt;0;0;0;0;162;0.0;0.0;0.0
1413_7.txt;9;3;5;17;429;0.02;0.01;0.01
10855_9.txt;0;0;0;0;177;0.0;0.0;0.0
1892_8.txt;28;0;0;28;258;0.11;0.0;0.0
5921_7.txt;9;0;0;9;216;0.04;0.0;0.0
11577_8.txt;5;0;0;5;134;0.04;0.0;0.0
470_10.txt;0;0;0;0;52;0.0;0.0;0.0
9838_7.txt;0;0;0;0;155;0.0;0.0;0.0
111_10.txt;1;0;0;1;44;0.02;0.0;0.0
3873_9.txt;11;1;0;12;127;0.09;0.01;0.0
6105_10.txt;5;0;1;6;188;0.03;0.0;0.01
1280_10.txt;2;0;2;4;166;0.01;0.0;0.01
2430_10.txt;22;0;1;23;409;0.05;0.0;0.0
8339_10.txt;14;0;0;14;143;0.1;0.0;0.0
2780_9.txt;1;0;0;1;133;0.01;0.0;0.0
8489_9.txt;0;0;0;0;146;0.0;0.0;0.0
9876_8.txt;7;0;0;7;70;0.1;0.0;0.0
4830_9.txt;10;1;1;12;232;0.04;0.0;0.0
12404_9.txt;6;1;1;8;158;0.04;0.01;0.01
4704_8.txt;3;0;0;3;72;0.04;0.0;0.0
8427_7.txt;22;4;0;26;625;0.04;0.01;0.0
8862_8.txt;16;3;0;19;548;0.03;0.01;0.0
4221_8.txt;6;0;0;6;126;0.05;0.0;0.0
11933_8.txt;11;0;1;12;103;0.11;0.0;0.01
231_10.txt;0;0;0;0;50;0.0;0.0;0.0
7449_10.txt;0;0;0;0;44;0.0;0.0;0.0
6821_10.txt;18;2;0;20;548;0.03;0.0;0.0
10948_10.txt;2;0;0;2;188;0.01;0.0;0.0
3417_10.txt;8;4;0;12;259;0.03;0.02;0.0
10867_7.txt;19;1;10;30;176;0.11;0.01;0.06
10654_7.txt;5;0;2;7;212;0.02;0.0;0.01
2130_10.txt;4;0;0;4;171;0.02;0.0;0.0
6703_8.txt;3;1;2;6;360;0.01;0.0;0.01
9880_10.txt;11;0;0;11;223;0.05;0.0;0.0
2581_8.txt;4;0;0;4;171;0.02;0.0;0.0
10932_7.txt;45;0;3;48;602;0.07;0.0;0.0
9382_9.txt;44;11;0;55;487;0.09;0.02;0.0
12082_8.txt;8;0;0;8;228;0.04;0.0;0.0
1612_10.txt;35;2;2;39;351;0.1;0.01;0.01
7299_8.txt;0;0;0;0;211;0.0;0.0;0.0
1561_8.txt;4;0;6;10;226;0.02;0.0;0.03
12273_10.txt;0;0;0;0;34;0.0;0.0;0.0
1318_8.txt;1;0;0;1;321;0.0;0.0;0.0
6348_10.txt;8;1;0;9;106;0.08;0.01;0.0
11948_10.txt;21;3;0;24;228;0.09;0.01;0.0
3871_8.txt;17;4;0;21;612;0.03;0.01;0.0
10559_8.txt;0;0;0;0;225;0.0;0.0;0.0
1650_10.txt;14;0;3;17;121;0.12;0.0;0.02
3354_10.txt;4;4;0;8;169;0.02;0.02;0.0
11158_8.txt;10;0;0;10;196;0.05;0.0;0.0
10123_10.txt;5;4;4;13;229;0.02;0.02;0.02
9362_7.txt;37;1;2;40;380;0.1;0.0;0.01
10585_9.txt;21;2;2;25;337;0.06;0.01;0.01
8766_8.txt;9;1;0;10;456;0.02;0.0;0.0
7006_8.txt;22;0;0;22;389;0.06;0.0;0.0
4837_10.txt;4;2;0;6;135;0.03;0.01;0.0
7706_7.txt;27;1;5;33;899;0.03;0.0;0.01
8510_7.txt;9;2;4;15;314;0.03;0.01;0.01
1086_7.txt;8;0;0;8;146;0.05;0.0;0.0
8216_8.txt;16;4;0;20;615;0.03;0.01;0.0
2961_10.txt;4;1;0;5;80;0.05;0.01;0.0
3499_8.txt;6;0;0;6;182;0.03;0.0;0.0
10999_7.txt;19;0;1;20;299;0.06;0.0;0.0
7029_7.txt;27;2;2;31;438;0.06;0.0;0.0
5115_10.txt;11;0;4;15;212;0.05;0.0;0.02
5365_10.txt;26;8;2;36;987;0.03;0.01;0.0
1077_8.txt;6;0;0;6;162;0.04;0.0;0.0
5849_8.txt;0;1;1;2;149;0.0;0.01;0.01
7572_10.txt;0;0;0;0;90;0.0;0.0;0.0
9316_7.txt;23;1;2;26;384;0.06;0.0;0.01
3022_7.txt;25;1;0;26;174;0.14;0.01;0.0
7484_10.txt;66;4;1;71;1207;0.05;0.0;0.0
5797_8.txt;1;0;1;2;229;0.0;0.0;0.0
8270_10.txt;12;0;0;12;197;0.06;0.0;0.0
461_8.txt;0;0;0;0;86;0.0;0.0;0.0
9850_7.txt;0;0;0;0;185;0.0;0.0;0.0
790_9.txt;7;1;2;10;132;0.05;0.01;0.02
2735_10.txt;24;9;4;37;812;0.03;0.01;0.0
6635_10.txt;0;0;0;0;81;0.0;0.0;0.0
1399_9.txt;2;2;0;4;141;0.01;0.01;0.0
12054_10.txt;0;1;0;1;301;0.0;0.0;0.0
9196_10.txt;2;0;0;2;158;0.01;0.0;0.0
9551_10.txt;0;0;0;0;135;0.0;0.0;0.0
10986_10.txt;2;2;0;4;134;0.01;0.01;0.0
2084_8.txt;10;0;0;10;178;0.06;0.0;0.0
7866_10.txt;20;0;0;20;494;0.04;0.0;0.0
8941_10.txt;2;0;0;2;183;0.01;0.0;0.0
10571_8.txt;8;0;2;10;431;0.02;0.0;0.0
11457_10.txt;14;0;0;14;720;0.02;0.0;0.0
7193_10.txt;49;30;9;88;1156;0.04;0.03;0.01
3169_8.txt;0;0;0;0;276;0.0;0.0;0.0
3147_10.txt;0;0;0;0;121;0.0;0.0;0.0
12461_9.txt;14;5;0;19;386;0.04;0.01;0.0
11354_10.txt;58;13;8;79;1254;0.05;0.01;0.01
12013_10.txt;3;0;0;3;160;0.02;0.0;0.0
8507_10.txt;7;0;0;7;189;0.04;0.0;0.0
9295_10.txt;20;0;1;21;282;0.07;0.0;0.0
1361_10.txt;0;0;0;0;52;0.0;0.0;0.0
8595_10.txt;16;0;0;16;145;0.11;0.0;0.0
3676_8.txt;21;7;5;33;740;0.03;0.01;0.01
9511_7.txt;12;0;0;12;168;0.07;0.0;0.0
11456_10.txt;3;0;0;3;197;0.02;0.0;0.0
8854_10.txt;43;3;0;46;712;0.06;0.0;0.0
4314_10.txt;24;8;3;35;536;0.04;0.01;0.01
9754_10.txt;8;0;0;8;82;0.1;0.0;0.0
7158_8.txt;17;3;2;22;231;0.07;0.01;0.01
3628_8.txt;0;0;0;0;148;0.0;0.0;0.0
3908_10.txt;1;0;0;1;55;0.02;0.0;0.0
441_9.txt;0;0;1;1;263;0.0;0.0;0.0
12303_9.txt;2;0;0;2;65;0.03;0.0;0.0
9299_8.txt;70;0;0;70;370;0.19;0.0;0.0
3517_8.txt;27;4;0;31;658;0.04;0.01;0.0
1034_7.txt;10;3;1;14;356;0.03;0.01;0.0
10216_8.txt;2;0;0;2;95;0.02;0.0;0.0
3025_7.txt;21;0;0;21;363;0.06;0.0;0.0
10407_8.txt;90;6;0;96;997;0.09;0.01;0.0
5756_8.txt;40;7;0;47;331;0.12;0.02;0.0
5633_8.txt;16;0;0;16;209;0.08;0.0;0.0
6274_8.txt;4;0;0;4;159;0.03;0.0;0.0
7837_10.txt;7;1;0;8;376;0.02;0.0;0.0
11414_9.txt;14;0;0;14;76;0.18;0.0;0.0
8731_7.txt;20;2;3;25;807;0.02;0.0;0.0
2492_10.txt;0;0;1;1;196;0.0;0.0;0.01
9943_7.txt;0;0;0;0;186;0.0;0.0;0.0
5968_10.txt;9;0;4;13;205;0.04;0.0;0.02
655_10.txt;18;1;1;20;514;0.04;0.0;0.0
1524_7.txt;6;0;0;6;148;0.04;0.0;0.0
6407_10.txt;2;0;2;4;142;0.01;0.0;0.01
8717_9.txt;4;0;1;5;187;0.02;0.0;0.01
6665_10.txt;3;0;0;3;63;0.05;0.0;0.0
3137_8.txt;50;3;1;54;1031;0.05;0.0;0.0
8290_10.txt;6;0;0;6;146;0.04;0.0;0.0
9152_8.txt;1;0;0;1;238;0.0;0.0;0.0
10894_8.txt;4;0;0;4;118;0.03;0.0;0.0
8774_8.txt;51;2;4;57;416;0.12;0.0;0.01
9609_7.txt;2;0;0;2;160;0.01;0.0;0.0
574_7.txt;16;1;0;17;116;0.14;0.01;0.0
3255_10.txt;3;0;0;3;249;0.01;0.0;0.0
5892_8.txt;11;4;0;15;262;0.04;0.02;0.0
8176_8.txt;13;1;0;14;549;0.02;0.0;0.0
3027_8.txt;6;0;0;6;406;0.01;0.0;0.0
9494_10.txt;3;0;0;3;341;0.01;0.0;0.0
11916_7.txt;1;0;0;1;199;0.01;0.0;0.0
6405_7.txt;8;1;0;9;112;0.07;0.01;0.0
2982_8.txt;6;5;0;11;234;0.03;0.02;0.0
4144_10.txt;2;0;0;2;192;0.01;0.0;0.0
12311_9.txt;2;2;0;4;65;0.03;0.03;0.0
622_10.txt;31;1;0;32;280;0.11;0.0;0.0
8173_8.txt;6;0;0;6;165;0.04;0.0;0.0
10054_10.txt;0;0;0;0;108;0.0;0.0;0.0
697_8.txt;0;1;0;1;133;0.0;0.01;0.0
1276_9.txt;8;0;0;8;156;0.05;0.0;0.0
6454_9.txt;6;3;0;9;200;0.03;0.01;0.0
8430_9.txt;19;5;0;24;203;0.09;0.02;0.0
57_10.txt;0;0;0;0;163;0.0;0.0;0.0
3431_10.txt;12;6;2;20;326;0.04;0.02;0.01
10183_7.txt;5;2;0;7;159;0.03;0.01;0.0
3024_9.txt;9;2;0;11;161;0.06;0.01;0.0
4893_10.txt;2;0;0;2;56;0.04;0.0;0.0
8225_8.txt;7;2;0;9;138;0.05;0.01;0.0
5844_8.txt;5;0;0;5;93;0.05;0.0;0.0
10223_10.txt;4;0;0;4;255;0.02;0.0;0.0
77_7.txt;2;0;0;2;365;0.01;0.0;0.0
5286_10.txt;5;2;0;7;188;0.03;0.01;0.0
402_10.txt;10;1;4;15;224;0.04;0.0;0.02
415_7.txt;20;1;0;21;127;0.16;0.01;0.0
7550_9.txt;3;0;0;3;165;0.02;0.0;0.0
12117_7.txt;6;0;0;6;185;0.03;0.0;0.0
3773_7.txt;8;0;0;8;116;0.07;0.0;0.0
5925_7.txt;4;0;0;4;74;0.05;0.0;0.0
7440_7.txt;1;0;0;1;141;0.01;0.0;0.0
5066_8.txt;4;0;0;4;134;0.03;0.0;0.0
7381_8.txt;12;4;0;16;293;0.04;0.01;0.0
1330_9.txt;0;0;1;1;102;0.0;0.0;0.01
4594_10.txt;9;2;0;11;76;0.12;0.03;0.0
5667_10.txt;15;1;1;17;671;0.02;0.0;0.0
11611_9.txt;4;6;0;10;239;0.02;0.03;0.0
994_7.txt;16;3;0;19;155;0.1;0.02;0.0
8500_7.txt;7;0;0;7;206;0.03;0.0;0.0
1091_10.txt;4;0;0;4;93;0.04;0.0;0.0
5978_9.txt;3;0;0;3;199;0.02;0.0;0.0
10850_10.txt;2;0;0;2;166;0.01;0.0;0.0
3518_10.txt;1;0;0;1;34;0.03;0.0;0.0
7429_9.txt;2;0;0;2;158;0.01;0.0;0.0
8896_10.txt;0;0;0;0;154;0.0;0.0;0.0
5133_10.txt;15;0;2;17;278;0.05;0.0;0.01
7899_10.txt;5;0;0;5;182;0.03;0.0;0.0
2366_7.txt;7;0;2;9;164;0.04;0.0;0.01
7284_8.txt;1;0;1;2;291;0.0;0.0;0.0
11985_10.txt;6;0;0;6;279;0.02;0.0;0.0
8521_10.txt;11;0;0;11;147;0.07;0.0;0.0
2921_10.txt;0;0;1;1;86;0.0;0.0;0.01
5987_8.txt;14;0;0;14;354;0.04;0.0;0.0
2705_10.txt;27;1;0;28;283;0.1;0.0;0.0
2651_10.txt;8;0;2;10;154;0.05;0.0;0.01
8325_9.txt;18;0;0;18;251;0.07;0.0;0.0
10618_8.txt;40;5;0;45;864;0.05;0.01;0.0
2787_8.txt;3;0;0;3;235;0.01;0.0;0.0
725_10.txt;27;0;3;30;415;0.07;0.0;0.01
7314_10.txt;5;0;0;5;259;0.02;0.0;0.0
7895_10.txt;20;1;2;23;223;0.09;0.0;0.01
11115_10.txt;25;1;0;26;325;0.08;0.0;0.0
733_9.txt;2;0;0;2;223;0.01;0.0;0.0
6436_10.txt;6;2;0;8;174;0.03;0.01;0.0
3069_9.txt;53;0;1;54;1171;0.05;0.0;0.0
3648_8.txt;11;1;1;13;163;0.07;0.01;0.01
1278_9.txt;8;0;0;8;263;0.03;0.0;0.0
3669_10.txt;7;1;0;8;195;0.04;0.01;0.0
10168_8.txt;7;2;2;11;145;0.05;0.01;0.01
1839_10.txt;5;0;0;5;80;0.06;0.0;0.0
10846_9.txt;23;1;0;24;406;0.06;0.0;0.0
6357_9.txt;9;0;0;9;182;0.05;0.0;0.0
3789_8.txt;5;1;0;6;252;0.02;0.0;0.0
10075_9.txt;0;0;0;0;139;0.0;0.0;0.0
7211_10.txt;3;0;0;3;62;0.05;0.0;0.0
965_10.txt;3;2;0;5;403;0.01;0.0;0.0
2481_8.txt;8;0;3;11;162;0.05;0.0;0.02
9289_7.txt;17;4;2;23;396;0.04;0.01;0.01
4684_8.txt;17;2;0;19;254;0.07;0.01;0.0
7022_7.txt;1;0;0;1;183;0.01;0.0;0.0
11649_10.txt;2;0;0;2;77;0.03;0.0;0.0
11056_10.txt;30;0;0;30;189;0.16;0.0;0.0
7324_10.txt;17;3;0;20;444;0.04;0.01;0.0
89_7.txt;0;0;0;0;213;0.0;0.0;0.0
8633_8.txt;6;0;0;6;137;0.04;0.0;0.0
1622_8.txt;19;4;6;29;246;0.08;0.02;0.02
8673_7.txt;50;3;2;55;1069;0.05;0.0;0.0
10697_8.txt;9;0;0;9;127;0.07;0.0;0.0
5689_10.txt;11;4;0;15;299;0.04;0.01;0.0
1535_9.txt;3;0;1;4;182;0.02;0.0;0.01
513_10.txt;4;1;5;10;164;0.02;0.01;0.03
6994_8.txt;10;0;1;11;296;0.03;0.0;0.0
2745_10.txt;2;0;0;2;148;0.01;0.0;0.0
9448_7.txt;2;1;0;3;202;0.01;0.0;0.0
5894_7.txt;5;0;0;5;154;0.03;0.0;0.0
9241_10.txt;4;1;0;5;159;0.03;0.01;0.0
2788_9.txt;9;3;0;12;288;0.03;0.01;0.0
9702_10.txt;5;0;0;5;187;0.03;0.0;0.0
3673_8.txt;6;1;2;9;667;0.01;0.0;0.0
10940_10.txt;5;0;0;5;672;0.01;0.0;0.0
9501_10.txt;2;0;0;2;183;0.01;0.0;0.0
1025_8.txt;0;1;0;1;343;0.0;0.0;0.0
11442_10.txt;2;0;0;2;144;0.01;0.0;0.0
8487_10.txt;11;0;0;11;202;0.05;0.0;0.0
7178_10.txt;10;0;2;12;734;0.01;0.0;0.0
5737_7.txt;0;0;0;0;155;0.0;0.0;0.0
2815_10.txt;2;3;0;5;431;0.0;0.01;0.0
4238_9.txt;7;2;2;11;238;0.03;0.01;0.01
10024_9.txt;1;3;0;4;363;0.0;0.01;0.0
9981_7.txt;43;6;2;51;682;0.06;0.01;0.0
4085_10.txt;1;1;0;2;335;0.0;0.0;0.0
10325_10.txt;7;1;2;10;195;0.04;0.01;0.01
9821_8.txt;7;1;0;8;319;0.02;0.0;0.0
2131_9.txt;20;0;2;22;344;0.06;0.0;0.01
3119_8.txt;18;0;1;19;351;0.05;0.0;0.0
1854_10.txt;13;0;0;13;341;0.04;0.0;0.0
2389_10.txt;0;0;0;0;140;0.0;0.0;0.0
12145_10.txt;0;0;0;0;46;0.0;0.0;0.0
10296_8.txt;7;0;0;7;84;0.08;0.0;0.0
6644_8.txt;5;0;0;5;198;0.03;0.0;0.0
10410_10.txt;10;3;0;13;183;0.05;0.02;0.0
6180_7.txt;8;1;0;9;276;0.03;0.0;0.0
701_7.txt;6;0;0;6;217;0.03;0.0;0.0
8820_7.txt;2;0;1;3;171;0.01;0.0;0.01
8879_7.txt;11;0;0;11;89;0.12;0.0;0.0
12192_7.txt;12;2;1;15;282;0.04;0.01;0.0
3062_10.txt;10;0;0;10;169;0.06;0.0;0.0
6452_9.txt;35;4;0;39;464;0.08;0.01;0.0
1696_10.txt;0;4;1;5;147;0.0;0.03;0.01
3509_10.txt;0;0;0;0;139;0.0;0.0;0.0
7593_7.txt;11;1;0;12;280;0.04;0.0;0.0
6614_9.txt;3;0;3;6;221;0.01;0.0;0.01
4896_7.txt;42;2;2;46;719;0.06;0.0;0.0
9536_7.txt;0;0;0;0;239;0.0;0.0;0.0
12485_8.txt;0;0;0;0;167;0.0;0.0;0.0
3989_8.txt;1;0;0;1;152;0.01;0.0;0.0
7813_10.txt;0;0;0;0;62;0.0;0.0;0.0
10116_10.txt;6;1;0;7;122;0.05;0.01;0.0
3232_9.txt;7;0;1;8;144;0.05;0.0;0.01
3768_10.txt;4;0;4;8;302;0.01;0.0;0.01
11643_7.txt;0;0;1;1;430;0.0;0.0;0.0
3734_9.txt;7;3;0;10;249;0.03;0.01;0.0
233_7.txt;0;0;0;0;173;0.0;0.0;0.0
7967_9.txt;7;0;0;7;337;0.02;0.0;0.0
11471_7.txt;2;0;1;3;142;0.01;0.0;0.01
3013_8.txt;12;0;0;12;279;0.04;0.0;0.0
9829_7.txt;4;0;0;4;237;0.02;0.0;0.0
9190_7.txt;9;0;0;9;197;0.05;0.0;0.0
3352_9.txt;9;2;0;11;135;0.07;0.01;0.0
751_9.txt;6;0;0;6;70;0.09;0.0;0.0
1340_10.txt;4;0;1;5;123;0.03;0.0;0.01
763_10.txt;0;1;0;1;122;0.0;0.01;0.0
7494_10.txt;15;0;1;16;249;0.06;0.0;0.0
7120_9.txt;2;1;2;5;193;0.01;0.01;0.01
11585_10.txt;2;0;0;2;523;0.0;0.0;0.0
10809_10.txt;1;1;0;2;94;0.01;0.01;0.0
1763_9.txt;8;0;0;8;177;0.05;0.0;0.0
643_10.txt;24;0;0;24;444;0.05;0.0;0.0
826_9.txt;9;0;0;9;359;0.03;0.0;0.0
12_9.txt;0;0;4;4;46;0.0;0.0;0.09
7763_8.txt;21;3;5;29;307;0.07;0.01;0.02
11369_8.txt;6;11;2;19;565;0.01;0.02;0.0
5900_10.txt;0;1;0;1;164;0.0;0.01;0.0
6151_7.txt;4;0;0;4;198;0.02;0.0;0.0
2008_7.txt;10;0;0;10;179;0.06;0.0;0.0
11001_10.txt;31;4;1;36;1017;0.03;0.0;0.0
4772_10.txt;5;0;0;5;241;0.02;0.0;0.0
5435_10.txt;10;0;0;10;135;0.07;0.0;0.0
2380_9.txt;2;1;1;4;134;0.01;0.01;0.01
6403_8.txt;11;2;4;17;214;0.05;0.01;0.02
8603_10.txt;9;2;0;11;377;0.02;0.01;0.0
4988_7.txt;19;4;1;24;392;0.05;0.01;0.0
11178_7.txt;14;0;0;14;214;0.07;0.0;0.0
10607_10.txt;2;0;0;2;108;0.02;0.0;0.0
11911_10.txt;8;0;0;8;53;0.15;0.0;0.0
2875_10.txt;6;0;3;9;174;0.03;0.0;0.02
4048_7.txt;2;0;0;2;110;0.02;0.0;0.0
3250_9.txt;3;1;0;4;312;0.01;0.0;0.0
3394_10.txt;6;0;2;8;244;0.02;0.0;0.01
2693_7.txt;1;0;0;1;135;0.01;0.0;0.0
7439_9.txt;2;0;1;3;285;0.01;0.0;0.0
5772_10.txt;1;0;1;2;140;0.01;0.0;0.01
2997_7.txt;34;0;1;35;268;0.13;0.0;0.0
5703_7.txt;0;0;0;0;68;0.0;0.0;0.0
12121_7.txt;33;0;2;35;337;0.1;0.0;0.01
3903_10.txt;2;0;1;3;62;0.03;0.0;0.02
11466_10.txt;4;2;2;8;363;0.01;0.01;0.01
9729_9.txt;11;1;0;12;372;0.03;0.0;0.0
993_8.txt;12;1;3;16;199;0.06;0.01;0.02
10388_7.txt;15;1;0;16;277;0.05;0.0;0.0
5605_7.txt;2;3;0;5;199;0.01;0.02;0.0
6488_10.txt;3;0;0;3;162;0.02;0.0;0.0
9517_10.txt;6;0;0;6;51;0.12;0.0;0.0
4971_7.txt;11;1;0;12;202;0.05;0.0;0.0
11445_7.txt;6;0;0;6;118;0.05;0.0;0.0
1452_8.txt;28;26;0;54;455;0.06;0.06;0.0
7002_10.txt;19;0;2;21;260;0.07;0.0;0.01
11701_9.txt;0;2;0;2;325;0.0;0.01;0.0
11196_7.txt;28;0;0;28;397;0.07;0.0;0.0
2225_10.txt;2;0;0;2;98;0.02;0.0;0.0
5285_7.txt;8;14;0;22;470;0.02;0.03;0.0
11659_9.txt;3;4;0;7;279;0.01;0.01;0.0
5579_8.txt;0;3;0;3;195;0.0;0.02;0.0
10451_10.txt;0;2;0;2;202;0.0;0.01;0.0
7768_8.txt;10;2;1;13;244;0.04;0.01;0.0
718_10.txt;13;0;12;25;157;0.08;0.0;0.08
4790_10.txt;24;5;1;30;554;0.04;0.01;0.0
2319_8.txt;3;0;0;3;243;0.01;0.0;0.0
5166_10.txt;4;0;0;4;182;0.02;0.0;0.0
6014_8.txt;1;2;2;5;216;0.0;0.01;0.01
8630_9.txt;14;3;0;17;716;0.02;0.0;0.0
1848_8.txt;24;7;9;40;595;0.04;0.01;0.02
285_10.txt;0;0;0;0;141;0.0;0.0;0.0
5259_9.txt;26;2;1;29;632;0.04;0.0;0.0
10088_10.txt;8;0;0;8;114;0.07;0.0;0.0
3861_10.txt;13;1;4;18;202;0.06;0.0;0.02
1208_9.txt;0;0;0;0;109;0.0;0.0;0.0
10642_8.txt;0;0;0;0;227;0.0;0.0;0.0
11481_10.txt;4;0;0;4;301;0.01;0.0;0.0
4834_8.txt;0;0;1;1;177;0.0;0.0;0.01
9715_7.txt;2;0;0;2;142;0.01;0.0;0.0
1100_7.txt;18;3;3;24;375;0.05;0.01;0.01
7201_8.txt;0;0;0;0;82;0.0;0.0;0.0
5570_10.txt;0;0;0;0;110;0.0;0.0;0.0
2011_7.txt;17;0;0;17;132;0.13;0.0;0.0
2500_9.txt;12;0;0;12;302;0.04;0.0;0.0
11451_8.txt;5;1;0;6;203;0.02;0.0;0.0
7331_10.txt;19;0;1;20;414;0.05;0.0;0.0
8243_9.txt;18;1;2;21;464;0.04;0.0;0.0
3044_7.txt;9;0;3;12;162;0.06;0.0;0.02
5071_10.txt;6;0;0;6;186;0.03;0.0;0.0
12243_8.txt;9;4;0;13;97;0.09;0.04;0.0
10069_8.txt;0;1;0;1;114;0.0;0.01;0.0
3238_9.txt;3;1;0;4;176;0.02;0.01;0.0
12424_9.txt;6;0;0;6;190;0.03;0.0;0.0
10164_7.txt;5;0;0;5;155;0.03;0.0;0.0
11043_7.txt;3;1;0;4;369;0.01;0.0;0.0
10156_10.txt;4;0;0;4;180;0.02;0.0;0.0
11833_7.txt;0;1;0;1;169;0.0;0.01;0.0
235_10.txt;0;0;0;0;47;0.0;0.0;0.0
8067_8.txt;5;4;0;9;199;0.03;0.02;0.0
8694_10.txt;5;0;0;5;203;0.02;0.0;0.0
9419_8.txt;4;0;0;4;158;0.03;0.0;0.0
10862_9.txt;15;5;0;20;303;0.05;0.02;0.0
1580_7.txt;29;8;3;40;464;0.06;0.02;0.01
8249_10.txt;8;1;2;11;181;0.04;0.01;0.01
6661_7.txt;26;4;0;30;497;0.05;0.01;0.0
11422_8.txt;5;3;0;8;238;0.02;0.01;0.0
12429_7.txt;11;0;3;14;151;0.07;0.0;0.02
11011_10.txt;15;1;3;19;198;0.08;0.01;0.02
3834_9.txt;8;1;2;11;205;0.04;0.0;0.01
10707_8.txt;10;0;0;10;185;0.05;0.0;0.0
1176_10.txt;7;0;0;7;82;0.09;0.0;0.0
715_10.txt;5;0;1;6;128;0.04;0.0;0.01
6305_10.txt;7;1;0;8;89;0.08;0.01;0.0
3743_10.txt;6;0;0;6;117;0.05;0.0;0.0
3302_10.txt;0;2;0;2;222;0.0;0.01;0.0
8628_10.txt;2;0;1;3;163;0.01;0.0;0.01
5903_8.txt;0;0;0;0;130;0.0;0.0;0.0
976_8.txt;5;0;0;5;188;0.03;0.0;0.0
1705_10.txt;0;0;0;0;204;0.0;0.0;0.0
2418_8.txt;3;3;0;6;174;0.02;0.02;0.0
9460_8.txt;2;0;0;2;239;0.01;0.0;0.0
8329_7.txt;3;0;0;3;64;0.05;0.0;0.0
7179_8.txt;2;0;0;2;331;0.01;0.0;0.0
12464_10.txt;15;8;4;27;186;0.08;0.04;0.02
5825_9.txt;6;0;0;6;231;0.03;0.0;0.0
3064_8.txt;0;0;0;0;76;0.0;0.0;0.0
5991_8.txt;10;0;7;17;153;0.07;0.0;0.05
10995_10.txt;0;0;0;0;124;0.0;0.0;0.0
2681_7.txt;3;0;0;3;282;0.01;0.0;0.0
3962_10.txt;16;1;2;19;194;0.08;0.01;0.01
7064_8.txt;61;7;3;71;563;0.11;0.01;0.01
3392_7.txt;0;0;1;1;222;0.0;0.0;0.0
1489_8.txt;5;1;0;6;173;0.03;0.01;0.0
958_9.txt;0;0;0;0;83;0.0;0.0;0.0
2512_10.txt;4;1;0;5;208;0.02;0.0;0.0
7368_8.txt;1;0;0;1;147;0.01;0.0;0.0
2452_10.txt;3;0;0;3;93;0.03;0.0;0.0
8551_8.txt;0;0;0;0;203;0.0;0.0;0.0
9699_10.txt;9;0;3;12;144;0.06;0.0;0.02
6363_8.txt;1;1;2;4;148;0.01;0.01;0.01
11418_7.txt;0;1;0;1;217;0.0;0.0;0.0
3874_9.txt;11;3;0;14;178;0.06;0.02;0.0
6474_8.txt;2;0;0;2;147;0.01;0.0;0.0
3606_9.txt;2;0;0;2;207;0.01;0.0;0.0
104_10.txt;3;0;0;3;167;0.02;0.0;0.0
6010_8.txt;3;4;0;7;349;0.01;0.01;0.0
196_9.txt;6;0;0;6;139;0.04;0.0;0.0
8785_10.txt;69;5;11;85;978;0.07;0.01;0.01
2020_7.txt;7;2;0;9;246;0.03;0.01;0.0
1137_8.txt;11;0;2;13;396;0.03;0.0;0.01
5176_10.txt;0;0;0;0;84;0.0;0.0;0.0
10566_8.txt;20;0;0;20;148;0.14;0.0;0.0
6897_10.txt;8;1;0;9;110;0.07;0.01;0.0
9650_10.txt;15;4;0;19;458;0.03;0.01;0.0
5004_9.txt;1;0;1;2;181;0.01;0.0;0.01
9921_8.txt;5;6;0;11;166;0.03;0.04;0.0
9181_10.txt;18;3;1;22;219;0.08;0.01;0.0
4754_10.txt;5;6;0;11;149;0.03;0.04;0.0
6283_7.txt;6;0;2;8;714;0.01;0.0;0.0
8811_7.txt;15;13;0;28;386;0.04;0.03;0.0
7292_10.txt;0;4;1;5;386;0.0;0.01;0.0
10724_8.txt;10;0;0;10;186;0.05;0.0;0.0
4073_10.txt;11;2;0;13;938;0.01;0.0;0.0
10020_8.txt;9;1;0;10;208;0.04;0.0;0.0
223_9.txt;25;0;2;27;140;0.18;0.0;0.01
6199_8.txt;33;1;1;35;532;0.06;0.0;0.0
2938_10.txt;2;0;0;2;59;0.03;0.0;0.0
9170_9.txt;33;10;0;43;853;0.04;0.01;0.0
1638_8.txt;2;1;4;7;136;0.01;0.01;0.03
8167_7.txt;7;0;0;7;55;0.13;0.0;0.0
966_7.txt;8;4;0;12;279;0.03;0.01;0.0
7932_8.txt;11;0;0;11;197;0.06;0.0;0.0
10374_8.txt;18;2;0;20;238;0.08;0.01;0.0
4303_10.txt;12;0;0;12;163;0.07;0.0;0.0
11693_7.txt;2;0;0;2;178;0.01;0.0;0.0
4037_7.txt;29;2;2;33;681;0.04;0.0;0.0
2208_7.txt;10;0;1;11;140;0.07;0.0;0.01
1123_10.txt;4;3;1;8;368;0.01;0.01;0.0
4405_8.txt;82;5;0;87;1165;0.07;0.0;0.0
6502_10.txt;0;6;4;10;380;0.0;0.02;0.01
10426_9.txt;0;0;0;0;293;0.0;0.0;0.0
4206_9.txt;17;7;0;24;342;0.05;0.02;0.0
4962_7.txt;1;1;0;2;150;0.01;0.01;0.0
10289_10.txt;4;0;0;4;65;0.06;0.0;0.0
6695_10.txt;3;3;0;6;158;0.02;0.02;0.0
7843_9.txt;0;0;0;0;186;0.0;0.0;0.0
10371_8.txt;3;0;0;3;124;0.02;0.0;0.0
7348_10.txt;3;0;0;3;52;0.06;0.0;0.0
5337_9.txt;5;1;0;6;206;0.02;0.0;0.0
8693_10.txt;9;1;2;12;192;0.05;0.01;0.01
8252_9.txt;19;4;0;23;603;0.03;0.01;0.0
9231_8.txt;6;0;0;6;235;0.03;0.0;0.0
5294_8.txt;7;3;0;10;212;0.03;0.01;0.0
2417_9.txt;2;0;0;2;150;0.01;0.0;0.0
916_10.txt;61;4;17;82;1109;0.06;0.0;0.02
3322_8.txt;1;2;0;3;205;0.0;0.01;0.0
10520_9.txt;5;2;0;7;342;0.01;0.01;0.0
4703_9.txt;3;1;0;4;84;0.04;0.01;0.0
3057_8.txt;6;0;0;6;128;0.05;0.0;0.0
11033_9.txt;19;7;3;29;376;0.05;0.02;0.01
2647_10.txt;1;0;0;1;304;0.0;0.0;0.0
8790_8.txt;2;1;0;3;104;0.02;0.01;0.0
6982_9.txt;0;0;2;2;330;0.0;0.0;0.01
11480_10.txt;0;0;0;0;164;0.0;0.0;0.0
2700_10.txt;22;4;0;26;672;0.03;0.01;0.0
7128_7.txt;8;1;0;9;210;0.04;0.0;0.0
11255_10.txt;17;0;0;17;236;0.07;0.0;0.0
3021_8.txt;10;1;0;11;159;0.06;0.01;0.0
4701_10.txt;7;1;0;8;127;0.06;0.01;0.0
6322_7.txt;3;4;0;7;277;0.01;0.01;0.0
9319_8.txt;10;3;0;13;217;0.05;0.01;0.0
9733_8.txt;5;1;0;6;148;0.03;0.01;0.0
5064_8.txt;2;0;0;2;134;0.01;0.0;0.0
3872_9.txt;18;0;3;21;125;0.14;0.0;0.02
9592_8.txt;17;5;0;22;310;0.05;0.02;0.0
7981_10.txt;27;4;3;34;286;0.09;0.01;0.01
7939_8.txt;6;2;0;8;168;0.04;0.01;0.0
8786_8.txt;67;0;5;72;654;0.1;0.0;0.01
4331_7.txt;18;2;1;21;386;0.05;0.01;0.0
1644_10.txt;2;0;6;8;170;0.01;0.0;0.04
11923_10.txt;2;0;1;3;62;0.03;0.0;0.02
4207_7.txt;19;0;0;19;223;0.09;0.0;0.0
9298_9.txt;0;1;0;1;77;0.0;0.01;0.0
2668_9.txt;2;0;1;3;463;0.0;0.0;0.0
12493_8.txt;3;1;0;4;266;0.01;0.0;0.0
3269_8.txt;12;0;0;12;198;0.06;0.0;0.0
2459_8.txt;10;0;0;10;164;0.06;0.0;0.0
3406_10.txt;4;2;0;6;139;0.03;0.01;0.0
1003_10.txt;4;0;0;4;125;0.03;0.0;0.0
10551_7.txt;6;0;0;6;328;0.02;0.0;0.0
593_9.txt;0;0;0;0;181;0.0;0.0;0.0
12204_8.txt;14;12;0;26;343;0.04;0.03;0.0
1293_8.txt;13;2;2;17;234;0.06;0.01;0.01
7954_7.txt;2;0;1;3;153;0.01;0.0;0.01
3805_8.txt;3;0;0;3;196;0.02;0.0;0.0
4560_10.txt;20;0;1;21;511;0.04;0.0;0.0
7711_10.txt;1;2;0;3;175;0.01;0.01;0.0
5637_10.txt;3;0;0;3;183;0.02;0.0;0.0
8747_7.txt;19;5;0;24;350;0.05;0.01;0.0
11374_9.txt;16;0;0;16;375;0.04;0.0;0.0
1292_8.txt;11;0;1;12;216;0.05;0.0;0.0
10750_8.txt;8;6;3;17;505;0.02;0.01;0.01
9749_9.txt;0;0;0;0;143;0.0;0.0;0.0
2521_10.txt;3;1;0;4;279;0.01;0.0;0.0
5771_8.txt;5;0;0;5;175;0.03;0.0;0.0
2061_9.txt;0;0;0;0;36;0.0;0.0;0.0
6806_7.txt;27;1;4;32;383;0.07;0.0;0.01
7633_8.txt;10;0;0;10;428;0.02;0.0;0.0
6933_9.txt;75;15;3;93;819;0.09;0.02;0.0
6584_8.txt;56;11;2;69;1081;0.05;0.01;0.0
8466_9.txt;2;0;0;2;159;0.01;0.0;0.0
12323_10.txt;0;0;0;0;145;0.0;0.0;0.0
4012_8.txt;9;0;0;9;158;0.06;0.0;0.0
9443_9.txt;0;0;0;0;192;0.0;0.0;0.0
11222_8.txt;2;1;0;3;65;0.03;0.02;0.0
959_7.txt;7;1;0;8;323;0.02;0.0;0.0
9168_7.txt;11;2;0;13;176;0.06;0.01;0.0
6088_10.txt;8;0;0;8;161;0.05;0.0;0.0
5754_9.txt;0;0;0;0;143;0.0;0.0;0.0
4298_10.txt;3;1;2;6;226;0.01;0.0;0.01
1679_9.txt;19;1;0;20;489;0.04;0.0;0.0
5566_9.txt;1;0;2;3;90;0.01;0.0;0.02
865_9.txt;8;0;0;8;192;0.04;0.0;0.0
8586_8.txt;15;0;0;15;203;0.07;0.0;0.0
7108_9.txt;10;0;0;10;165;0.06;0.0;0.0
11790_8.txt;3;0;0;3;82;0.04;0.0;0.0
8066_9.txt;17;1;4;22;342;0.05;0.0;0.01
10666_8.txt;25;2;0;27;759;0.03;0.0;0.0
9285_10.txt;2;1;0;3;165;0.01;0.01;0.0
12040_7.txt;28;3;0;31;654;0.04;0.0;0.0
5560_7.txt;3;0;7;10;186;0.02;0.0;0.04
3035_9.txt;7;2;5;14;247;0.03;0.01;0.02
11570_9.txt;2;0;0;2;252;0.01;0.0;0.0
8268_7.txt;20;2;0;22;391;0.05;0.01;0.0
7941_8.txt;17;0;0;17;479;0.04;0.0;0.0
5002_8.txt;0;2;3;5;180;0.0;0.01;0.02
11684_8.txt;15;0;0;15;432;0.03;0.0;0.0
1160_10.txt;12;0;0;12;145;0.08;0.0;0.0
2864_9.txt;37;10;9;56;609;0.06;0.02;0.01
2336_10.txt;43;2;0;45;615;0.07;0.0;0.0
1465_9.txt;6;0;0;6;145;0.04;0.0;0.0
6113_8.txt;2;0;0;2;146;0.01;0.0;0.0
3702_9.txt;39;3;2;44;657;0.06;0.0;0.0
8581_10.txt;2;1;0;3;119;0.02;0.01;0.0
8068_9.txt;0;0;0;0;359;0.0;0.0;0.0
1773_9.txt;3;0;0;3;247;0.01;0.0;0.0
6155_7.txt;36;3;1;40;549;0.07;0.01;0.0
8376_10.txt;0;0;0;0;160;0.0;0.0;0.0
4829_8.txt;35;5;2;42;832;0.04;0.01;0.0
6896_7.txt;35;3;12;50;857;0.04;0.0;0.01
8396_8.txt;12;1;1;14;199;0.06;0.01;0.01
9908_8.txt;7;0;0;7;494;0.01;0.0;0.0
5118_10.txt;55;5;6;66;645;0.09;0.01;0.01
5583_8.txt;3;4;1;8;202;0.01;0.02;0.0
5577_8.txt;0;1;0;1;138;0.0;0.01;0.0
2493_10.txt;11;1;0;12;192;0.06;0.01;0.0
11931_9.txt;9;0;2;11;141;0.06;0.0;0.01
1494_8.txt;14;0;0;14;141;0.1;0.0;0.0
4670_9.txt;18;0;0;18;324;0.06;0.0;0.0
11728_9.txt;6;2;0;8;192;0.03;0.01;0.0
2584_7.txt;10;0;2;12;253;0.04;0.0;0.01
677_8.txt;55;7;0;62;675;0.08;0.01;0.0
5941_8.txt;4;1;1;6;146;0.03;0.01;0.01
12289_9.txt;12;0;0;12;352;0.03;0.0;0.0
8381_8.txt;5;0;0;5;142;0.04;0.0;0.0
8572_7.txt;13;0;0;13;170;0.08;0.0;0.0
7239_7.txt;5;0;2;7;222;0.02;0.0;0.01
10653_10.txt;4;0;4;8;204;0.02;0.0;0.02
12042_10.txt;2;0;0;2;159;0.01;0.0;0.0
7061_7.txt;2;0;0;2;140;0.01;0.0;0.0
9117_10.txt;0;0;0;0;132;0.0;0.0;0.0
11387_8.txt;15;3;4;22;336;0.04;0.01;0.01
12499_7.txt;9;8;1;18;565;0.02;0.01;0.0
11372_7.txt;1;1;1;3;126;0.01;0.01;0.01
5232_8.txt;1;1;0;2;251;0.0;0.0;0.0
6208_7.txt;27;0;0;27;382;0.07;0.0;0.0
3400_8.txt;12;1;0;13;272;0.04;0.0;0.0
9822_10.txt;0;0;0;0;208;0.0;0.0;0.0
7234_8.txt;33;2;0;35;560;0.06;0.0;0.0
4112_9.txt;2;0;0;2;136;0.01;0.0;0.0
1395_10.txt;20;2;0;22;811;0.02;0.0;0.0
3684_8.txt;54;12;0;66;772;0.07;0.02;0.0
4213_7.txt;8;0;0;8;130;0.06;0.0;0.0
5962_7.txt;7;0;4;11;376;0.02;0.0;0.01
3332_8.txt;11;4;20;35;505;0.02;0.01;0.04
11440_10.txt;10;2;2;14;328;0.03;0.01;0.01
3361_7.txt;15;2;0;17;432;0.03;0.0;0.0
8201_8.txt;8;2;0;10;331;0.02;0.01;0.0
6728_8.txt;0;0;0;0;186;0.0;0.0;0.0
8576_8.txt;0;0;0;0;66;0.0;0.0;0.0
4134_7.txt;33;3;0;36;314;0.11;0.01;0.0
6165_8.txt;11;0;0;11;182;0.06;0.0;0.0
6988_10.txt;8;2;0;10;199;0.04;0.01;0.0
1224_9.txt;1;0;0;1;35;0.03;0.0;0.0
8434_9.txt;0;0;0;0;122;0.0;0.0;0.0
11350_9.txt;4;4;0;8;167;0.02;0.02;0.0
6480_10.txt;2;1;0;3;134;0.01;0.01;0.0
11834_7.txt;6;0;1;7;195;0.03;0.0;0.01
9032_8.txt;4;0;0;4;70;0.06;0.0;0.0
10538_8.txt;4;0;0;4;146;0.03;0.0;0.0
6222_9.txt;15;0;0;15;249;0.06;0.0;0.0
9174_9.txt;9;1;1;11;201;0.04;0.0;0.0
12267_8.txt;3;0;0;3;132;0.02;0.0;0.0
4589_10.txt;14;2;0;16;214;0.07;0.01;0.0
4726_7.txt;7;0;0;7;492;0.01;0.0;0.0
4774_10.txt;4;0;1;5;65;0.06;0.0;0.02
3544_9.txt;3;1;0;4;142;0.02;0.01;0.0
7438_10.txt;2;0;0;2;46;0.04;0.0;0.0
9345_9.txt;54;5;3;62;586;0.09;0.01;0.01
5916_10.txt;20;4;0;24;387;0.05;0.01;0.0
271_10.txt;4;0;0;4;145;0.03;0.0;0.0
12454_7.txt;0;0;0;0;140;0.0;0.0;0.0
6261_8.txt;8;1;0;9;123;0.07;0.01;0.0
6346_10.txt;0;0;0;0;55;0.0;0.0;0.0
8778_8.txt;54;1;0;55;522;0.1;0.0;0.0
3788_10.txt;0;3;0;3;100;0.0;0.03;0.0
1521_8.txt;51;1;0;52;1185;0.04;0.0;0.0
3841_9.txt;3;0;0;3;57;0.05;0.0;0.0
8439_10.txt;0;0;0;0;123;0.0;0.0;0.0
279_9.txt;0;0;0;0;163;0.0;0.0;0.0
6497_10.txt;2;1;0;3;138;0.01;0.01;0.0
8350_9.txt;0;0;0;0;185;0.0;0.0;0.0
7829_7.txt;1;0;0;1;55;0.02;0.0;0.0
314_10.txt;3;0;0;3;177;0.02;0.0;0.0
563_10.txt;18;1;3;22;385;0.05;0.0;0.01
2137_8.txt;0;1;0;1;141;0.0;0.01;0.0
1134_9.txt;2;0;0;2;166;0.01;0.0;0.0
11444_10.txt;3;0;0;3;112;0.03;0.0;0.0
1501_7.txt;13;1;3;17;233;0.06;0.0;0.01
149_10.txt;0;2;0;2;602;0.0;0.0;0.0
6895_10.txt;0;0;0;0;61;0.0;0.0;0.0
11423_8.txt;2;3;0;5;170;0.01;0.02;0.0
3922_10.txt;6;0;0;6;96;0.06;0.0;0.0
1072_10.txt;2;0;0;2;146;0.01;0.0;0.0
8035_7.txt;8;0;0;8;127;0.06;0.0;0.0
6879_10.txt;9;0;2;11;198;0.05;0.0;0.01
2069_9.txt;0;0;0;0;55;0.0;0.0;0.0
10032_10.txt;0;0;0;0;62;0.0;0.0;0.0
9144_7.txt;0;1;0;1;133;0.0;0.01;0.0
12094_7.txt;4;1;0;5;197;0.02;0.01;0.0
1946_9.txt;12;0;5;17;403;0.03;0.0;0.01
353_9.txt;18;0;2;20;452;0.04;0.0;0.0
6839_10.txt;14;2;0;16;128;0.11;0.02;0.0
7066_8.txt;14;0;3;17;231;0.06;0.0;0.01
6642_10.txt;15;8;0;23;799;0.02;0.01;0.0
1215_10.txt;1;0;0;1;214;0.0;0.0;0.0
12176_8.txt;27;1;0;28;349;0.08;0.0;0.0
9571_9.txt;5;6;0;11;693;0.01;0.01;0.0
3771_10.txt;29;1;2;32;447;0.06;0.0;0.0
975_9.txt;17;1;0;18;905;0.02;0.0;0.0
5445_10.txt;4;0;3;7;149;0.03;0.0;0.02
11157_7.txt;28;5;0;33;1096;0.03;0.0;0.0
2066_7.txt;0;0;0;0;215;0.0;0.0;0.0
11416_10.txt;1;0;0;1;81;0.01;0.0;0.0
10466_8.txt;7;0;1;8;235;0.03;0.0;0.0
2400_7.txt;16;0;7;23;256;0.06;0.0;0.03
8230_10.txt;10;1;0;11;197;0.05;0.01;0.0
9559_8.txt;12;5;0;17;730;0.02;0.01;0.0
2619_8.txt;21;3;6;30;274;0.08;0.01;0.02
3078_10.txt;1;0;1;2;143;0.01;0.0;0.01
11264_10.txt;2;2;1;5;144;0.01;0.01;0.01
6425_9.txt;3;0;0;3;47;0.06;0.0;0.0
6966_8.txt;6;2;4;12;385;0.02;0.01;0.01
4506_10.txt;1;0;0;1;61;0.02;0.0;0.0
1590_10.txt;11;0;0;11;241;0.05;0.0;0.0
2443_9.txt;0;0;2;2;302;0.0;0.0;0.01
2620_10.txt;24;3;0;27;350;0.07;0.01;0.0
2103_7.txt;0;0;0;0;147;0.0;0.0;0.0
2587_9.txt;2;0;0;2;59;0.03;0.0;0.0
10787_10.txt;0;0;0;0;155;0.0;0.0;0.0
2040_7.txt;3;1;0;4;185;0.02;0.01;0.0
9375_10.txt;4;0;0;4;96;0.04;0.0;0.0
12491_8.txt;2;0;0;2;160;0.01;0.0;0.0
2151_10.txt;3;0;0;3;283;0.01;0.0;0.0
7479_8.txt;2;0;0;2;177;0.01;0.0;0.0
2942_10.txt;6;0;2;8;131;0.05;0.0;0.02
8023_7.txt;17;7;2;26;813;0.02;0.01;0.0
9204_10.txt;54;7;0;61;459;0.12;0.02;0.0
12451_10.txt;10;0;0;10;238;0.04;0.0;0.0
1307_10.txt;4;0;0;4;66;0.06;0.0;0.0
1209_10.txt;0;0;0;0;138;0.0;0.0;0.0
1677_9.txt;19;5;4;28;414;0.05;0.01;0.01
9013_7.txt;5;1;0;6;163;0.03;0.01;0.0
75_8.txt;23;0;2;25;412;0.06;0.0;0.0
10992_10.txt;0;0;0;0;237;0.0;0.0;0.0
8671_7.txt;50;4;9;63;828;0.06;0.0;0.01
4270_10.txt;1;1;0;2;138;0.01;0.01;0.0
497_10.txt;1;0;0;1;100;0.01;0.0;0.0
9544_10.txt;1;0;2;3;120;0.01;0.0;0.02
486_9.txt;8;0;2;10;146;0.05;0.0;0.01
11455_8.txt;11;0;2;13;477;0.02;0.0;0.0
807_10.txt;21;1;6;28;281;0.07;0.0;0.02
2162_10.txt;5;1;0;6;332;0.02;0.0;0.0
12433_8.txt;11;0;0;11;194;0.06;0.0;0.0
12366_10.txt;2;0;0;2;145;0.01;0.0;0.0
8199_10.txt;8;1;0;9;321;0.02;0.0;0.0
7225_10.txt;3;0;1;4;177;0.02;0.0;0.01
11882_8.txt;11;1;0;12;327;0.03;0.0;0.0
4157_8.txt;2;1;4;7;336;0.01;0.0;0.01
4234_7.txt;17;0;0;17;533;0.03;0.0;0.0
4711_8.txt;23;0;2;25;162;0.14;0.0;0.01
2799_10.txt;7;0;0;7;495;0.01;0.0;0.0
9014_10.txt;4;0;0;4;196;0.02;0.0;0.0
6048_9.txt;2;0;0;2;171;0.01;0.0;0.0
8533_8.txt;1;0;2;3;189;0.01;0.0;0.01
207_8.txt;26;1;5;32;258;0.1;0.0;0.02
1132_10.txt;9;2;3;14;150;0.06;0.01;0.02
11897_9.txt;0;0;0;0;158;0.0;0.0;0.0
5993_8.txt;0;0;0;0;138;0.0;0.0;0.0
6137_7.txt;0;1;0;1;212;0.0;0.0;0.0
9244_8.txt;5;0;0;5;175;0.03;0.0;0.0
8398_8.txt;0;0;0;0;191;0.0;0.0;0.0
1897_10.txt;11;0;0;11;253;0.04;0.0;0.0
1608_9.txt;26;2;0;28;330;0.08;0.01;0.0
10518_9.txt;32;6;0;38;325;0.1;0.02;0.0
7945_8.txt;0;0;1;1;238;0.0;0.0;0.0
4545_10.txt;2;0;1;3;134;0.01;0.0;0.01
9068_9.txt;3;0;0;3;209;0.01;0.0;0.0
6792_10.txt;1;0;6;7;420;0.0;0.0;0.01
5751_10.txt;0;0;0;0;86;0.0;0.0;0.0
1353_10.txt;8;0;3;11;381;0.02;0.0;0.01
10860_7.txt;0;0;0;0;136;0.0;0.0;0.0
12226_8.txt;6;0;0;6;290;0.02;0.0;0.0
10580_8.txt;12;5;1;18;149;0.08;0.03;0.01
78_10.txt;4;0;0;4;185;0.02;0.0;0.0
592_10.txt;0;3;0;3;145;0.0;0.02;0.0
12288_9.txt;22;2;2;26;159;0.14;0.01;0.01
9320_10.txt;4;0;4;8;215;0.02;0.0;0.02
7237_10.txt;0;0;0;0;58;0.0;0.0;0.0
4361_10.txt;6;0;4;10;327;0.02;0.0;0.01
8678_9.txt;9;0;0;9;207;0.04;0.0;0.0
1863_10.txt;24;0;2;26;355;0.07;0.0;0.01
6203_7.txt;6;0;0;6;131;0.05;0.0;0.0
3592_10.txt;3;0;0;3;105;0.03;0.0;0.0
8799_8.txt;1;1;0;2;131;0.01;0.01;0.0
3231_10.txt;6;0;0;6;263;0.02;0.0;0.0
16_7.txt;5;0;0;5;136;0.04;0.0;0.0
5670_8.txt;8;0;1;9;185;0.04;0.0;0.01
1082_10.txt;9;1;0;10;160;0.06;0.01;0.0
9340_8.txt;10;2;0;12;184;0.05;0.01;0.0
7244_10.txt;0;0;0;0;138;0.0;0.0;0.0
11209_8.txt;0;0;4;4;133;0.0;0.0;0.03
8661_8.txt;8;1;0;9;179;0.04;0.01;0.0
591_10.txt;31;7;5;43;926;0.03;0.01;0.01
7872_10.txt;0;0;0;0;176;0.0;0.0;0.0
5362_8.txt;5;0;0;5;315;0.02;0.0;0.0
11074_7.txt;10;4;1;15;411;0.02;0.01;0.0
1938_9.txt;0;0;0;0;200;0.0;0.0;0.0
2412_10.txt;1;1;2;4;180;0.01;0.01;0.01
5842_8.txt;5;1;0;6;282;0.02;0.0;0.0
9464_8.txt;45;6;2;53;355;0.13;0.02;0.01
431_8.txt;2;1;0;3;176;0.01;0.01;0.0
10888_8.txt;14;0;1;15;251;0.06;0.0;0.0
5733_7.txt;0;0;0;0;155;0.0;0.0;0.0
6730_10.txt;0;0;0;0;270;0.0;0.0;0.0
9235_9.txt;18;0;2;20;405;0.04;0.0;0.0
2424_7.txt;0;0;0;0;69;0.0;0.0;0.0
7330_8.txt;6;0;0;6;187;0.03;0.0;0.0
4815_10.txt;11;0;6;17;269;0.04;0.0;0.02
9730_8.txt;28;6;0;34;418;0.07;0.01;0.0
5039_10.txt;0;0;0;0;165;0.0;0.0;0.0
10345_7.txt;2;0;0;2;190;0.01;0.0;0.0
2822_7.txt;44;5;5;54;615;0.07;0.01;0.01
11479_10.txt;0;0;0;0;192;0.0;0.0;0.0
2453_8.txt;0;4;3;7;145;0.0;0.03;0.02
6102_10.txt;2;0;6;8;271;0.01;0.0;0.02
1009_8.txt;0;0;0;0;242;0.0;0.0;0.0
8197_8.txt;2;0;2;4;143;0.01;0.0;0.01
7162_10.txt;7;0;0;7;144;0.05;0.0;0.0
239_7.txt;8;0;0;8;173;0.05;0.0;0.0
8765_10.txt;14;9;0;23;232;0.06;0.04;0.0
6732_10.txt;3;3;0;6;156;0.02;0.02;0.0
1159_10.txt;0;0;0;0;64;0.0;0.0;0.0
5449_8.txt;7;0;4;11;172;0.04;0.0;0.02
1455_7.txt;8;2;0;10;202;0.04;0.01;0.0
7422_10.txt;1;0;0;1;152;0.01;0.0;0.0
5599_7.txt;14;0;0;14;388;0.04;0.0;0.0
5522_8.txt;15;4;0;19;539;0.03;0.01;0.0
3896_7.txt;6;3;0;9;247;0.02;0.01;0.0
21_7.txt;10;0;0;10;261;0.04;0.0;0.0
6932_7.txt;19;0;1;20;154;0.12;0.0;0.01
6583_7.txt;50;3;2;55;329;0.15;0.01;0.01
11463_9.txt;1;0;0;1;235;0.0;0.0;0.0
2588_7.txt;5;2;0;7;184;0.03;0.01;0.0
8587_7.txt;15;2;8;25;419;0.04;0.0;0.02
3672_10.txt;8;3;4;15;299;0.03;0.01;0.01
11076_8.txt;3;0;0;3;223;0.01;0.0;0.0
8974_10.txt;2;1;0;3;137;0.01;0.01;0.0
10052_10.txt;0;0;0;0;62;0.0;0.0;0.0
2419_10.txt;2;0;2;4;79;0.03;0.0;0.03
1920_10.txt;17;0;0;17;256;0.07;0.0;0.0
1071_8.txt;10;2;1;13;199;0.05;0.01;0.01
51_10.txt;3;1;0;4;165;0.02;0.01;0.0
1871_10.txt;5;5;1;11;399;0.01;0.01;0.0
1111_10.txt;2;1;0;3;179;0.01;0.01;0.0
3652_10.txt;13;0;1;14;173;0.08;0.0;0.01
6421_8.txt;5;3;0;8;245;0.02;0.01;0.0
11378_8.txt;15;5;1;21;462;0.03;0.01;0.0
5452_8.txt;8;0;0;8;138;0.06;0.0;0.0
11809_10.txt;14;0;0;14;162;0.09;0.0;0.0
5107_10.txt;16;2;0;18;156;0.1;0.01;0.0
9787_7.txt;3;1;0;4;202;0.01;0.0;0.0
1437_8.txt;12;2;0;14;175;0.07;0.01;0.0
7860_10.txt;9;1;1;11;209;0.04;0.0;0.0
3240_10.txt;0;0;0;0;81;0.0;0.0;0.0
11605_10.txt;2;0;0;2;88;0.02;0.0;0.0
10068_8.txt;1;0;0;1;160;0.01;0.0;0.0
11717_8.txt;110;5;0;115;591;0.19;0.01;0.0
10650_8.txt;0;0;0;0;81;0.0;0.0;0.0
5730_10.txt;2;0;0;2;150;0.01;0.0;0.0
297_10.txt;3;0;0;3;75;0.04;0.0;0.0
7795_9.txt;4;3;0;7;142;0.03;0.02;0.0
6038_10.txt;0;0;0;0;187;0.0;0.0;0.0
9657_10.txt;42;1;2;45;696;0.06;0.0;0.0
6278_7.txt;2;1;0;3;118;0.02;0.01;0.0
10367_8.txt;14;1;0;15;241;0.06;0.0;0.0
10165_7.txt;5;1;0;6;167;0.03;0.01;0.0
874_9.txt;0;0;1;1;138;0.0;0.0;0.01
4605_8.txt;4;0;0;4;144;0.03;0.0;0.0
9301_10.txt;19;2;0;21;291;0.07;0.01;0.0
457_10.txt;3;0;0;3;151;0.02;0.0;0.0
6948_10.txt;3;0;1;4;161;0.02;0.0;0.01
4174_9.txt;3;2;0;5;204;0.01;0.01;0.0
5572_10.txt;2;0;0;2;87;0.02;0.0;0.0
2313_10.txt;7;0;0;7;197;0.04;0.0;0.0
7828_10.txt;7;0;0;7;134;0.05;0.0;0.0
11278_8.txt;7;0;0;7;103;0.07;0.0;0.0
8_7.txt;0;0;0;0;99;0.0;0.0;0.0
3305_10.txt;5;2;0;7;221;0.02;0.01;0.0
7571_8.txt;1;0;0;1;77;0.01;0.0;0.0
10839_10.txt;13;0;0;13;271;0.05;0.0;0.0
1808_7.txt;12;2;4;18;498;0.02;0.0;0.01
6858_7.txt;19;5;4;28;672;0.03;0.01;0.01
11792_8.txt;9;0;0;9;300;0.03;0.0;0.0
6282_7.txt;10;1;0;11;270;0.04;0.0;0.0
12056_10.txt;8;2;6;16;474;0.02;0.0;0.01
10463_10.txt;39;0;0;39;816;0.05;0.0;0.0
10563_7.txt;6;0;2;8;386;0.02;0.0;0.01
8596_7.txt;2;0;0;2;114;0.02;0.0;0.0
3567_8.txt;43;7;4;54;425;0.1;0.02;0.01
5079_8.txt;6;0;0;6;122;0.05;0.0;0.0
2308_10.txt;3;0;0;3;219;0.01;0.0;0.0
8606_10.txt;4;1;0;5;139;0.03;0.01;0.0
3590_8.txt;3;0;0;3;81;0.04;0.0;0.0
777_7.txt;11;16;0;27;737;0.01;0.02;0.0
173_7.txt;3;5;0;8;179;0.02;0.03;0.0
10763_8.txt;0;1;0;1;140;0.0;0.01;0.0
1515_7.txt;18;0;0;18;272;0.07;0.0;0.0
3123_10.txt;0;0;0;0;135;0.0;0.0;0.0
9784_8.txt;6;0;0;6;584;0.01;0.0;0.0
4406_9.txt;4;1;0;5;127;0.03;0.01;0.0
11153_10.txt;6;6;0;12;215;0.03;0.03;0.0
6559_10.txt;14;0;2;16;216;0.06;0.0;0.01
7868_8.txt;12;1;0;13;206;0.06;0.0;0.0
897_10.txt;9;2;0;11;258;0.03;0.01;0.0
7485_8.txt;2;0;0;2;172;0.01;0.0;0.0
11293_7.txt;29;2;7;38;323;0.09;0.01;0.02
7023_9.txt;0;0;0;0;111;0.0;0.0;0.0
1520_7.txt;17;0;0;17;257;0.07;0.0;0.0
2849_7.txt;0;12;0;12;384;0.0;0.03;0.0
10868_8.txt;0;0;0;0;146;0.0;0.0;0.0
2576_8.txt;8;1;0;9;338;0.02;0.0;0.0
2664_9.txt;3;0;0;3;141;0.02;0.0;0.0
5342_10.txt;7;0;0;7;455;0.02;0.0;0.0
8588_7.txt;16;3;4;23;216;0.07;0.01;0.02
8873_8.txt;21;2;6;29;363;0.06;0.01;0.02
7755_9.txt;13;2;0;15;205;0.06;0.01;0.0
4164_10.txt;5;7;0;12;422;0.01;0.02;0.0
1398_7.txt;10;1;3;14;445;0.02;0.0;0.01
6833_10.txt;2;0;0;2;132;0.02;0.0;0.0
2640_10.txt;6;0;2;8;161;0.04;0.0;0.01
2979_10.txt;7;2;14;23;259;0.03;0.01;0.05
5888_9.txt;9;5;2;16;213;0.04;0.02;0.01
99_8.txt;3;2;2;7;205;0.01;0.01;0.01
6131_10.txt;2;0;0;2;62;0.03;0.0;0.0
903_8.txt;31;1;1;33;364;0.09;0.0;0.0
10271_10.txt;1;0;0;1;90;0.01;0.0;0.0
8206_10.txt;16;0;0;16;159;0.1;0.0;0.0
1188_8.txt;0;0;0;0;67;0.0;0.0;0.0
6430_10.txt;2;0;3;5;44;0.05;0.0;0.07
5187_7.txt;0;0;0;0;165;0.0;0.0;0.0
9123_10.txt;26;7;0;33;261;0.1;0.03;0.0
1771_10.txt;1;1;0;2;155;0.01;0.01;0.0
9626_8.txt;10;0;0;10;200;0.05;0.0;0.0
6190_7.txt;24;6;0;30;323;0.07;0.02;0.0
5509_10.txt;28;2;4;34;712;0.04;0.0;0.01
1979_9.txt;38;0;1;39;665;0.06;0.0;0.0
2730_9.txt;11;1;0;12;229;0.05;0.0;0.0
5307_7.txt;13;1;0;14;216;0.06;0.0;0.0
6440_8.txt;9;2;0;11;396;0.02;0.01;0.0
7568_10.txt;9;0;0;9;176;0.05;0.0;0.0
1270_7.txt;24;0;0;24;493;0.05;0.0;0.0
488_9.txt;5;0;0;5;138;0.04;0.0;0.0
8001_10.txt;4;2;0;6;148;0.03;0.01;0.0
2746_10.txt;13;4;0;17;413;0.03;0.01;0.0
6217_8.txt;37;1;10;48;965;0.04;0.0;0.01
10390_10.txt;9;0;0;9;299;0.03;0.0;0.0
10393_9.txt;1;0;0;1;78;0.01;0.0;0.0
4201_9.txt;10;2;0;12;144;0.07;0.01;0.0
3320_8.txt;0;2;12;14;161;0.0;0.01;0.07
2592_10.txt;9;0;5;14;498;0.02;0.0;0.01
3686_10.txt;1;3;0;4;256;0.0;0.01;0.0
613_10.txt;10;2;0;12;311;0.03;0.01;0.0
11847_9.txt;0;0;0;0;162;0.0;0.0;0.0
4836_8.txt;6;1;0;7;297;0.02;0.0;0.0
8914_8.txt;5;2;0;7;138;0.04;0.01;0.0
323_10.txt;0;0;0;0;118;0.0;0.0;0.0
683_10.txt;3;1;0;4;225;0.01;0.0;0.0
5738_10.txt;4;3;0;7;147;0.03;0.02;0.0
6943_9.txt;22;4;5;31;1039;0.02;0.0;0.0
4775_7.txt;7;0;0;7;191;0.04;0.0;0.0
1445_8.txt;28;5;2;35;750;0.04;0.01;0.0
1180_9.txt;2;0;0;2;51;0.04;0.0;0.0
10398_8.txt;0;0;1;1;197;0.0;0.0;0.01
338_10.txt;4;2;0;6;116;0.03;0.02;0.0
5250_10.txt;5;0;1;6;210;0.02;0.0;0.0
8061_10.txt;5;0;3;8;118;0.04;0.0;0.03
10589_10.txt;6;0;0;6;115;0.05;0.0;0.0
1374_8.txt;10;1;0;11;217;0.05;0.0;0.0
8937_9.txt;0;0;0;0;71;0.0;0.0;0.0
5907_10.txt;2;2;0;4;127;0.02;0.02;0.0
76_7.txt;9;0;0;9;341;0.03;0.0;0.0
10182_8.txt;0;0;0;0;150;0.0;0.0;0.0
7962_9.txt;7;0;0;7;259;0.03;0.0;0.0
10420_10.txt;17;0;0;17;161;0.11;0.0;0.0
7346_8.txt;0;0;1;1;136;0.0;0.0;0.01
10497_8.txt;0;2;2;4;129;0.0;0.02;0.02
9240_10.txt;0;0;0;0;144;0.0;0.0;0.0
3380_7.txt;7;0;2;9;207;0.03;0.0;0.01
4619_7.txt;2;0;2;4;232;0.01;0.0;0.01
5863_8.txt;4;2;0;6;207;0.02;0.01;0.0
10778_8.txt;0;0;1;1;178;0.0;0.0;0.01
10561_8.txt;30;6;10;46;561;0.05;0.01;0.02
10943_10.txt;3;1;0;4;178;0.02;0.01;0.0
5518_8.txt;20;4;0;24;566;0.04;0.01;0.0
842_9.txt;6;0;0;6;195;0.03;0.0;0.0
1080_9.txt;21;2;0;23;265;0.08;0.01;0.0
2854_10.txt;4;0;0;4;316;0.01;0.0;0.0
5148_7.txt;4;0;0;4;249;0.02;0.0;0.0
9049_8.txt;14;0;1;15;605;0.02;0.0;0.0
5123_8.txt;16;12;0;28;522;0.03;0.02;0.0
11392_8.txt;6;2;0;8;87;0.07;0.02;0.0
11336_7.txt;5;0;0;5;176;0.03;0.0;0.0
5038_10.txt;0;0;0;0;135;0.0;0.0;0.0
7714_10.txt;1;0;2;3;248;0.0;0.0;0.01
8522_10.txt;5;0;0;5;211;0.02;0.0;0.0
11868_10.txt;2;0;0;2;58;0.03;0.0;0.0
9348_7.txt;45;7;0;52;858;0.05;0.01;0.0
4563_8.txt;21;1;0;22;332;0.06;0.0;0.0
7555_7.txt;15;2;1;18;199;0.08;0.01;0.01
6965_7.txt;4;0;0;4;203;0.02;0.0;0.0
4977_7.txt;0;0;1;1;150;0.0;0.0;0.01
11947_9.txt;8;0;0;8;158;0.05;0.0;0.0
1108_7.txt;12;0;2;14;209;0.06;0.0;0.01
1231_7.txt;1;0;0;1;70;0.01;0.0;0.0
8394_10.txt;37;3;0;40;908;0.04;0.0;0.0
3722_10.txt;11;0;0;11;230;0.05;0.0;0.0
5050_7.txt;6;1;0;7;133;0.05;0.01;0.0
2207_9.txt;2;0;0;2;328;0.01;0.0;0.0
2933_10.txt;0;0;0;0;51;0.0;0.0;0.0
8871_10.txt;0;0;0;0;157;0.0;0.0;0.0
472_10.txt;1;0;0;1;55;0.02;0.0;0.0
8926_10.txt;16;2;0;18;341;0.05;0.01;0.0
1720_10.txt;12;0;0;12;235;0.05;0.0;0.0
4663_8.txt;14;0;1;15;131;0.11;0.0;0.01
10148_10.txt;31;11;0;42;616;0.05;0.02;0.0
11119_10.txt;34;0;0;34;317;0.11;0.0;0.0
4892_10.txt;10;0;0;10;213;0.05;0.0;0.0
11660_7.txt;1;5;2;8;273;0.0;0.02;0.01
1313_9.txt;7;0;0;7;146;0.05;0.0;0.0
2802_10.txt;16;2;0;18;236;0.07;0.01;0.0
2792_10.txt;0;1;0;1;127;0.0;0.01;0.0
4261_9.txt;14;5;0;19;376;0.04;0.01;0.0
3036_9.txt;1;1;0;2;167;0.01;0.01;0.0
11016_7.txt;0;0;0;0;95;0.0;0.0;0.0
11941_8.txt;28;6;0;34;371;0.08;0.02;0.0
6316_8.txt;4;2;0;6;143;0.03;0.01;0.0
902_9.txt;0;2;0;2;159;0.0;0.01;0.0
7581_8.txt;14;1;1;16;516;0.03;0.0;0.0
4778_9.txt;4;0;0;4;142;0.03;0.0;0.0
7384_10.txt;5;1;0;6;198;0.03;0.01;0.0
8192_10.txt;0;0;0;0;138;0.0;0.0;0.0
11509_8.txt;46;3;0;49;522;0.09;0.01;0.0
3750_10.txt;0;0;0;0;211;0.0;0.0;0.0
10501_10.txt;1;0;1;2;181;0.01;0.0;0.01
10793_10.txt;7;3;3;13;281;0.02;0.01;0.01
6868_10.txt;1;1;0;2;147;0.01;0.01;0.0
5389_7.txt;16;0;1;17;284;0.06;0.0;0.0
10602_10.txt;0;0;0;0;145;0.0;0.0;0.0
10292_7.txt;7;0;0;7;137;0.05;0.0;0.0
4445_7.txt;7;1;0;8;205;0.03;0.0;0.0
8865_10.txt;49;1;0;50;710;0.07;0.0;0.0
5439_10.txt;13;1;1;15;226;0.06;0.0;0.0
11007_10.txt;9;0;0;9;277;0.03;0.0;0.0
6934_9.txt;4;0;2;6;132;0.03;0.0;0.02
12183_10.txt;4;1;0;5;292;0.01;0.0;0.0
7229_7.txt;2;0;0;2;125;0.02;0.0;0.0
5269_10.txt;6;5;11;22;263;0.02;0.02;0.04
12051_10.txt;0;0;0;0;63;0.0;0.0;0.0
3299_10.txt;5;0;0;5;87;0.06;0.0;0.0
6413_7.txt;11;1;8;20;358;0.03;0.0;0.02
5959_7.txt;9;0;4;13;180;0.05;0.0;0.02
10581_10.txt;36;3;4;43;617;0.06;0.0;0.01
449_10.txt;0;0;0;0;148;0.0;0.0;0.0
8915_10.txt;10;0;0;10;558;0.02;0.0;0.0
272_10.txt;0;1;0;1;170;0.0;0.01;0.0
3715_7.txt;3;1;1;5;206;0.01;0.0;0.0
9296_10.txt;0;0;0;0;212;0.0;0.0;0.0
4707_7.txt;4;0;0;4;164;0.02;0.0;0.0
4368_10.txt;8;0;0;8;106;0.08;0.0;0.0
10818_10.txt;3;0;0;3;441;0.01;0.0;0.0
5153_8.txt;10;1;0;11;456;0.02;0.0;0.0
941_10.txt;10;0;0;10;197;0.05;0.0;0.0
7476_8.txt;4;0;0;4;139;0.03;0.0;0.0
9404_10.txt;14;0;0;14;335;0.04;0.0;0.0
11917_8.txt;3;0;0;3;130;0.02;0.0;0.0
1357_10.txt;12;1;0;13;219;0.05;0.0;0.0
8144_9.txt;0;0;0;0;95;0.0;0.0;0.0
3880_8.txt;1;1;0;2;255;0.0;0.0;0.0
5462_8.txt;5;0;2;7;392;0.01;0.0;0.01
29_10.txt;30;1;15;46;786;0.04;0.0;0.02
2821_9.txt;32;1;1;34;951;0.03;0.0;0.0
6638_10.txt;1;0;0;1;196;0.01;0.0;0.0
2100_7.txt;21;1;3;25;197;0.11;0.01;0.02
4788_10.txt;13;1;0;14;263;0.05;0.0;0.0
7801_9.txt;6;0;2;8;127;0.05;0.0;0.02
174_7.txt;0;3;1;4;239;0.0;0.01;0.0
6656_10.txt;8;3;0;11;174;0.05;0.02;0.0
11437_9.txt;4;2;2;8;87;0.05;0.02;0.02
2325_8.txt;14;0;1;15;119;0.12;0.0;0.01
9684_10.txt;5;0;0;5;123;0.04;0.0;0.0
4434_7.txt;0;0;0;0;158;0.0;0.0;0.0
6319_10.txt;8;0;4;12;140;0.06;0.0;0.03
640_10.txt;3;0;0;3;147;0.02;0.0;0.0
1727_10.txt;10;0;0;10;79;0.13;0.0;0.0
2511_10.txt;0;1;0;1;214;0.0;0.0;0.0
1918_9.txt;8;0;1;9;183;0.04;0.0;0.01
1496_10.txt;8;0;0;8;205;0.04;0.0;0.0
7623_9.txt;4;1;0;5;487;0.01;0.0;0.0
8187_9.txt;4;0;2;6;156;0.03;0.0;0.01
4751_8.txt;3;0;0;3;245;0.01;0.0;0.0
4242_9.txt;2;0;0;2;148;0.01;0.0;0.0
5244_7.txt;8;0;0;8;92;0.09;0.0;0.0
4928_7.txt;18;0;0;18;219;0.08;0.0;0.0
7124_8.txt;5;3;0;8;188;0.03;0.02;0.0
12151_10.txt;0;1;0;1;152;0.0;0.01;0.0
6468_7.txt;9;3;2;14;272;0.03;0.01;0.01
2268_10.txt;27;5;3;35;913;0.03;0.01;0.0
11238_7.txt;0;0;8;8;195;0.0;0.0;0.04
4452_8.txt;0;0;0;0;166;0.0;0.0;0.0
7011_7.txt;8;0;0;8;367;0.02;0.0;0.0
5159_10.txt;9;2;0;11;333;0.03;0.01;0.0
1522_8.txt;27;2;2;31;896;0.03;0.0;0.0
10072_9.txt;0;1;0;1;125;0.0;0.01;0.0
6043_10.txt;0;1;0;1;132;0.0;0.01;0.0
7031_10.txt;5;0;0;5;87;0.06;0.0;0.0
10508_10.txt;8;0;0;8;289;0.03;0.0;0.0
11193_7.txt;7;0;0;7;328;0.02;0.0;0.0
10872_7.txt;14;1;3;18;385;0.04;0.0;0.01
2039_9.txt;1;0;0;1;156;0.01;0.0;0.0
10532_8.txt;8;0;0;8;205;0.04;0.0;0.0
229_10.txt;6;0;0;6;141;0.04;0.0;0.0
164_10.txt;0;0;0;0;94;0.0;0.0;0.0
7217_7.txt;13;0;0;13;165;0.08;0.0;0.0
234_10.txt;6;0;0;6;159;0.04;0.0;0.0
2342_8.txt;11;2;4;17;273;0.04;0.01;0.01
3627_8.txt;0;0;0;0;76;0.0;0.0;0.0
9535_10.txt;19;1;0;20;378;0.05;0.0;0.0
6404_8.txt;2;3;0;5;105;0.02;0.03;0.0
10970_7.txt;15;0;0;15;344;0.04;0.0;0.0
421_9.txt;55;17;1;73;567;0.1;0.03;0.0
2157_10.txt;4;3;0;7;231;0.02;0.01;0.0
91_8.txt;1;0;0;1;159;0.01;0.0;0.0
7736_10.txt;0;0;0;0;46;0.0;0.0;0.0
7803_10.txt;10;3;0;13;226;0.04;0.01;0.0
2886_8.txt;1;0;1;2;124;0.01;0.0;0.01
1931_8.txt;9;4;1;14;490;0.02;0.01;0.0
12474_9.txt;2;0;0;2;57;0.04;0.0;0.0
4666_8.txt;8;2;0;10;166;0.05;0.01;0.0
1829_8.txt;17;2;2;21;257;0.07;0.01;0.01
9405_10.txt;7;2;0;9;130;0.05;0.02;0.0
11940_7.txt;11;1;3;15;216;0.05;0.0;0.01
5364_10.txt;39;5;6;50;833;0.05;0.01;0.01
7317_10.txt;19;0;0;19;397;0.05;0.0;0.0
11691_8.txt;0;0;0;0;141;0.0;0.0;0.0
3340_8.txt;9;7;9;25;503;0.02;0.01;0.02
7060_10.txt;1;0;1;2;174;0.01;0.0;0.01
10247_10.txt;2;0;0;2;283;0.01;0.0;0.0
10286_9.txt;6;0;0;6;290;0.02;0.0;0.0
2337_10.txt;13;0;0;13;451;0.03;0.0;0.0
10506_10.txt;3;0;4;7;150;0.02;0.0;0.03
11565_9.txt;32;1;0;33;397;0.08;0.0;0.0
8849_9.txt;16;0;0;16;310;0.05;0.0;0.0
11403_9.txt;44;15;3;62;620;0.07;0.02;0.0
11839_9.txt;4;0;0;4;113;0.04;0.0;0.0
6604_7.txt;27;7;1;35;528;0.05;0.01;0.0
6140_9.txt;0;0;0;0;59;0.0;0.0;0.0
7935_8.txt;5;4;4;13;508;0.01;0.01;0.01
4099_8.txt;0;0;0;0;512;0.0;0.0;0.0
7750_8.txt;1;1;0;2;187;0.01;0.01;0.0
3321_7.txt;7;1;4;12;136;0.05;0.01;0.03
5088_8.txt;3;1;0;4;207;0.01;0.0;0.0
11806_10.txt;6;7;0;13;298;0.02;0.02;0.0
8136_9.txt;2;0;0;2;247;0.01;0.0;0.0
7338_7.txt;9;0;0;9;294;0.03;0.0;0.0
10303_7.txt;11;0;0;11;166;0.07;0.0;0.0
3296_10.txt;3;0;0;3;116;0.03;0.0;0.0
927_10.txt;2;0;2;4;179;0.01;0.0;0.01
796_8.txt;13;1;2;16;141;0.09;0.01;0.01
4246_8.txt;30;3;0;33;388;0.08;0.01;0.0
5441_10.txt;29;7;2;38;984;0.03;0.01;0.0
380_10.txt;24;0;0;24;186;0.13;0.0;0.0
6153_7.txt;26;9;7;42;381;0.07;0.02;0.02
5884_10.txt;6;0;0;6;125;0.05;0.0;0.0
3951_10.txt;1;0;0;1;139;0.01;0.0;0.0
5246_10.txt;5;0;0;5;215;0.02;0.0;0.0
5679_10.txt;29;8;4;41;264;0.11;0.03;0.02
9043_7.txt;10;0;0;10;407;0.02;0.0;0.0
6465_9.txt;0;2;0;2;123;0.0;0.02;0.0
7724_10.txt;4;0;0;4;237;0.02;0.0;0.0
4251_9.txt;2;1;0;3;45;0.04;0.02;0.0
6543_9.txt;9;0;0;9;130;0.07;0.0;0.0
3202_10.txt;13;0;0;13;130;0.1;0.0;0.0
11073_8.txt;3;0;0;3;277;0.01;0.0;0.0
2463_10.txt;25;1;0;26;420;0.06;0.0;0.0
2252_10.txt;6;4;7;17;302;0.02;0.01;0.02
3095_10.txt;1;1;4;6;310;0.0;0.0;0.01
6671_10.txt;0;0;0;0;64;0.0;0.0;0.0
10481_8.txt;7;1;0;8;238;0.03;0.0;0.0
9171_9.txt;24;4;0;28;414;0.06;0.01;0.0
2391_10.txt;3;0;0;3;147;0.02;0.0;0.0
3270_8.txt;9;0;0;9;115;0.08;0.0;0.0
11850_10.txt;0;0;0;0;66;0.0;0.0;0.0
7995_8.txt;4;3;0;7;243;0.02;0.01;0.0
5323_7.txt;13;1;0;14;278;0.05;0.0;0.0
7140_10.txt;21;5;2;28;319;0.07;0.02;0.01
12197_9.txt;53;7;2;62;938;0.06;0.01;0.0
4305_10.txt;0;0;0;0;192;0.0;0.0;0.0
11703_9.txt;0;0;2;2;188;0.0;0.0;0.01
6740_8.txt;11;0;0;11;203;0.05;0.0;0.0
11965_8.txt;5;0;0;5;142;0.04;0.0;0.0
11595_10.txt;0;0;0;0;32;0.0;0.0;0.0
6751_8.txt;17;2;0;19;323;0.05;0.01;0.0
1755_10.txt;8;0;0;8;403;0.02;0.0;0.0
11639_10.txt;6;0;0;6;194;0.03;0.0;0.0
12032_8.txt;29;0;0;29;324;0.09;0.0;0.0
2996_7.txt;32;4;5;41;360;0.09;0.01;0.01
8815_7.txt;27;21;0;48;408;0.07;0.05;0.0
8881_8.txt;15;0;2;17;533;0.03;0.0;0.0
12245_10.txt;19;3;0;22;380;0.05;0.01;0.0
10677_8.txt;24;0;3;27;519;0.05;0.0;0.01
6237_7.txt;6;9;1;16;268;0.02;0.03;0.0
8803_10.txt;2;7;0;9;288;0.01;0.02;0.0
5080_10.txt;23;0;0;23;218;0.11;0.0;0.0
10111_7.txt;4;0;0;4;163;0.02;0.0;0.0
3695_8.txt;27;11;2;40;683;0.04;0.02;0.0
6441_9.txt;22;0;0;22;470;0.05;0.0;0.0
8543_8.txt;13;1;1;15;203;0.06;0.0;0.0
836_8.txt;7;0;1;8;204;0.03;0.0;0.0
12133_7.txt;27;0;0;27;720;0.04;0.0;0.0
5649_10.txt;0;0;0;0;239;0.0;0.0;0.0
4720_8.txt;0;0;0;0;123;0.0;0.0;0.0
2944_10.txt;4;0;0;4;162;0.02;0.0;0.0
10552_9.txt;32;2;0;34;728;0.04;0.0;0.0
9380_9.txt;10;0;0;10;409;0.02;0.0;0.0
2532_8.txt;23;8;2;33;404;0.06;0.02;0.0
8513_9.txt;1;1;0;2;244;0.0;0.0;0.0
2164_10.txt;0;3;0;3;283;0.0;0.01;0.0
8409_8.txt;2;0;0;2;195;0.01;0.0;0.0
4399_9.txt;1;1;0;2;414;0.0;0.0;0.0
1812_10.txt;4;0;0;4;197;0.02;0.0;0.0
4539_9.txt;5;1;0;6;142;0.04;0.01;0.0
2180_8.txt;25;3;0;28;491;0.05;0.01;0.0
2286_10.txt;3;0;3;6;76;0.04;0.0;0.04
7717_10.txt;2;0;0;2;117;0.02;0.0;0.0
10780_10.txt;7;0;0;7;137;0.05;0.0;0.0
6978_8.txt;1;1;5;7;248;0.0;0.0;0.02
5735_7.txt;4;0;0;4;190;0.02;0.0;0.0
3949_8.txt;8;1;0;9;340;0.02;0.0;0.0
1242_9.txt;1;0;0;1;173;0.01;0.0;0.0
1196_8.txt;3;7;0;10;139;0.02;0.05;0.0
2320_10.txt;0;2;0;2;172;0.0;0.01;0.0
3729_10.txt;2;0;0;2;148;0.01;0.0;0.0
4817_10.txt;16;1;0;17;256;0.06;0.0;0.0
1308_9.txt;2;0;0;2;125;0.02;0.0;0.0
50_10.txt;2;0;0;2;173;0.01;0.0;0.0
1052_8.txt;6;2;3;11;385;0.02;0.01;0.01
12120_10.txt;39;1;0;40;773;0.05;0.0;0.0
7936_7.txt;5;0;1;6;637;0.01;0.0;0.0
1087_10.txt;6;0;0;6;256;0.02;0.0;0.0
6042_9.txt;0;0;0;0;130;0.0;0.0;0.0
6076_9.txt;4;0;0;4;118;0.03;0.0;0.0
2583_10.txt;5;0;0;5;169;0.03;0.0;0.0
9721_7.txt;6;0;0;6;140;0.04;0.0;0.0
9841_7.txt;4;0;0;4;361;0.01;0.0;0.0
7210_8.txt;34;15;2;51;332;0.1;0.05;0.01
5985_10.txt;0;0;2;2;134;0.0;0.0;0.01
349_10.txt;10;0;0;10;308;0.03;0.0;0.0
2033_8.txt;3;0;0;3;147;0.02;0.0;0.0
190_10.txt;48;2;4;54;705;0.07;0.0;0.01
7353_7.txt;2;2;0;4;124;0.02;0.02;0.0
3877_8.txt;5;1;0;6;215;0.02;0.0;0.0
11755_7.txt;0;0;0;0;160;0.0;0.0;0.0
12486_7.txt;0;1;0;1;296;0.0;0.0;0.0
5170_9.txt;2;0;0;2;180;0.01;0.0;0.0
8278_10.txt;3;0;0;3;186;0.02;0.0;0.0
1164_10.txt;4;0;5;9;108;0.04;0.0;0.05
1249_9.txt;15;5;0;20;525;0.03;0.01;0.0
205_8.txt;25;2;0;27;658;0.04;0.0;0.0
6225_8.txt;13;1;1;15;367;0.04;0.0;0.0
4645_9.txt;3;0;0;3;217;0.01;0.0;0.0
11078_10.txt;2;0;0;2;201;0.01;0.0;0.0
12107_10.txt;13;2;0;15;336;0.04;0.01;0.0
6929_8.txt;33;4;4;41;281;0.12;0.01;0.01
11005_10.txt;43;0;5;48;970;0.04;0.0;0.01
3960_10.txt;1;1;0;2;117;0.01;0.01;0.0
4216_10.txt;11;4;1;16;491;0.02;0.01;0.0
9391_8.txt;10;6;0;16;214;0.05;0.03;0.0
2794_8.txt;0;0;0;0;140;0.0;0.0;0.0
5400_10.txt;16;2;2;20;336;0.05;0.01;0.01
10834_7.txt;8;0;0;8;150;0.05;0.0;0.0
741_7.txt;6;0;0;6;186;0.03;0.0;0.0
6664_9.txt;2;0;0;2;176;0.01;0.0;0.0
6328_10.txt;2;1;0;3;159;0.01;0.01;0.0
5426_10.txt;21;1;2;24;320;0.07;0.0;0.01
612_10.txt;0;0;0;0;310;0.0;0.0;0.0
4030_9.txt;4;1;0;5;134;0.03;0.01;0.0
7544_7.txt;0;0;0;0;239;0.0;0.0;0.0
9374_9.txt;39;4;0;43;660;0.06;0.01;0.0
6798_9.txt;6;0;0;6;147;0.04;0.0;0.0
7170_9.txt;9;0;1;10;162;0.06;0.0;0.01
8368_10.txt;0;0;0;0;36;0.0;0.0;0.0
2557_10.txt;5;0;1;6;279;0.02;0.0;0.0
9002_9.txt;1;0;0;1;60;0.02;0.0;0.0
5384_8.txt;7;0;0;7;133;0.05;0.0;0.0
7079_9.txt;10;1;2;13;272;0.04;0.0;0.01
11876_10.txt;23;10;2;35;757;0.03;0.01;0.0
4429_7.txt;4;0;0;4;160;0.03;0.0;0.0
9078_7.txt;1;0;0;1;132;0.01;0.0;0.0
11219_7.txt;25;2;0;27;1072;0.02;0.0;0.0
8664_8.txt;36;0;0;36;281;0.13;0.0;0.0
422_7.txt;24;0;0;24;320;0.07;0.0;0.0
4895_10.txt;5;0;0;5;123;0.04;0.0;0.0
10779_10.txt;0;0;7;7;140;0.0;0.0;0.05
9558_10.txt;0;0;0;0;183;0.0;0.0;0.0
10757_10.txt;2;1;1;4;418;0.0;0.0;0.0
8853_7.txt;39;3;0;42;415;0.09;0.01;0.0
2650_10.txt;1;0;3;4;205;0.0;0.0;0.01
11122_10.txt;6;0;3;9;289;0.02;0.0;0.01
8334_8.txt;58;2;4;64;626;0.09;0.0;0.01
607_10.txt;2;0;0;2;162;0.01;0.0;0.0
10386_8.txt;3;0;0;3;181;0.02;0.0;0.0
6108_8.txt;6;0;0;6;162;0.04;0.0;0.0
11542_7.txt;8;0;0;8;201;0.04;0.0;0.0
4494_8.txt;5;1;0;6;195;0.03;0.01;0.0
10827_10.txt;0;0;0;0;136;0.0;0.0;0.0
6215_7.txt;11;0;2;13;279;0.04;0.0;0.01
3683_9.txt;104;4;4;112;672;0.15;0.01;0.01
3829_10.txt;4;0;0;4;121;0.03;0.0;0.0
6587_9.txt;44;1;0;45;328;0.13;0.0;0.0
5106_8.txt;1;2;0;3;155;0.01;0.01;0.0
10845_10.txt;6;2;2;10;219;0.03;0.01;0.01
1949_8.txt;36;1;2;39;791;0.05;0.0;0.0
11359_9.txt;10;0;1;11;144;0.07;0.0;0.01
9546_8.txt;8;0;2;10;465;0.02;0.0;0.0
1991_10.txt;11;4;0;15;200;0.06;0.02;0.0
9634_8.txt;20;3;13;36;543;0.04;0.01;0.02
1329_8.txt;0;9;0;9;370;0.0;0.02;0.0
5339_8.txt;82;1;2;85;1025;0.08;0.0;0.0
8282_7.txt;1;0;0;1;383;0.0;0.0;0.0
257_7.txt;51;7;10;68;689;0.07;0.01;0.01
8177_8.txt;17;1;1;19;266;0.06;0.0;0.0
5062_9.txt;5;2;0;7;66;0.08;0.03;0.0
10535_7.txt;0;0;0;0;141;0.0;0.0;0.0
5820_7.txt;48;0;2;50;848;0.06;0.0;0.0
49_10.txt;2;0;0;2;240;0.01;0.0;0.0
1925_9.txt;9;0;0;9;241;0.04;0.0;0.0
6828_10.txt;27;2;0;29;364;0.07;0.01;0.0
4027_10.txt;1;0;0;1;113;0.01;0.0;0.0
4501_7.txt;22;0;0;22;277;0.08;0.0;0.0
12002_10.txt;4;0;0;4;123;0.03;0.0;0.0
1788_7.txt;24;1;2;27;861;0.03;0.0;0.0
4377_10.txt;6;0;0;6;282;0.02;0.0;0.0
4592_9.txt;26;0;3;29;722;0.04;0.0;0.0
10059_10.txt;7;0;0;7;194;0.04;0.0;0.0
407_10.txt;1;1;0;2;153;0.01;0.01;0.0
3093_10.txt;2;0;2;4;157;0.01;0.0;0.01
9219_10.txt;3;0;0;3;126;0.02;0.0;0.0
2357_10.txt;10;1;7;18;512;0.02;0.0;0.01
10093_7.txt;10;1;1;12;186;0.05;0.01;0.01
10731_7.txt;2;0;1;3;100;0.02;0.0;0.01
11707_10.txt;3;0;0;3;143;0.02;0.0;0.0
10934_10.txt;0;0;0;0;153;0.0;0.0;0.0
828_10.txt;2;0;0;2;275;0.01;0.0;0.0
5280_8.txt;5;1;0;6;286;0.02;0.0;0.0
2485_10.txt;44;0;1;45;729;0.06;0.0;0.0
9728_7.txt;2;0;0;2;124;0.02;0.0;0.0
7050_7.txt;2;0;0;2;198;0.01;0.0;0.0
10819_10.txt;2;1;0;3;189;0.01;0.01;0.0
8709_8.txt;0;2;0;2;166;0.0;0.01;0.0
9335_10.txt;35;0;1;36;466;0.08;0.0;0.0
3071_9.txt;7;1;0;8;71;0.1;0.01;0.0
2253_8.txt;7;3;2;12;282;0.02;0.01;0.01
7586_10.txt;3;0;0;3;496;0.01;0.0;0.0
1239_8.txt;2;0;0;2;154;0.01;0.0;0.0
4422_8.txt;9;2;3;14;107;0.08;0.02;0.03
9449_10.txt;7;1;0;8;344;0.02;0.0;0.0
6959_7.txt;9;0;0;9;219;0.04;0.0;0.0
7273_8.txt;7;0;0;7;147;0.05;0.0;0.0
6341_7.txt;4;0;0;4;327;0.01;0.0;0.0
2438_9.txt;8;2;0;10;269;0.03;0.01;0.0
3802_10.txt;0;0;0;0;237;0.0;0.0;0.0
10206_10.txt;0;2;3;5;218;0.0;0.01;0.01
9895_8.txt;30;0;0;30;326;0.09;0.0;0.0
6354_10.txt;1;0;0;1;88;0.01;0.0;0.0
11284_8.txt;34;0;0;34;416;0.08;0.0;0.0
1037_8.txt;54;13;8;75;882;0.06;0.01;0.01
1000_8.txt;0;0;0;0;97;0.0;0.0;0.0
10031_10.txt;3;0;0;3;574;0.01;0.0;0.0
5603_7.txt;8;2;0;10;562;0.01;0.0;0.0
373_10.txt;2;0;0;2;152;0.01;0.0;0.0
1731_10.txt;7;0;0;7;171;0.04;0.0;0.0
8451_10.txt;5;4;4;13;255;0.02;0.02;0.02
6204_7.txt;30;0;0;30;494;0.06;0.0;0.0
3249_9.txt;25;3;0;28;321;0.08;0.01;0.0
3401_8.txt;6;0;0;6;160;0.04;0.0;0.0
2107_7.txt;7;0;1;8;188;0.04;0.0;0.01
1021_10.txt;13;0;0;13;182;0.07;0.0;0.0
1420_8.txt;0;0;0;0;375;0.0;0.0;0.0
9145_10.txt;12;0;15;27;328;0.04;0.0;0.05
3821_9.txt;24;5;2;31;1084;0.02;0.0;0.0
7520_8.txt;20;3;13;36;632;0.03;0.0;0.02
1363_10.txt;5;1;0;6;144;0.03;0.01;0.0
7163_10.txt;6;0;0;6;141;0.04;0.0;0.0
7549_7.txt;3;0;0;3;171;0.02;0.0;0.0
8919_7.txt;16;1;1;18;367;0.04;0.0;0.0
4257_10.txt;1;1;0;2;107;0.01;0.01;0.0
9961_9.txt;0;0;0;0;250;0.0;0.0;0.0
3678_8.txt;0;0;0;0;149;0.0;0.0;0.0
12396_7.txt;0;0;0;0;85;0.0;0.0;0.0
2423_7.txt;5;2;0;7;338;0.01;0.01;0.0
3516_8.txt;5;0;0;5;144;0.03;0.0;0.0
8869_7.txt;1;0;0;1;100;0.01;0.0;0.0
3173_8.txt;2;0;0;2;119;0.02;0.0;0.0
1163_7.txt;6;0;0;6;192;0.03;0.0;0.0
12057_10.txt;0;0;0;0;40;0.0;0.0;0.0
9866_7.txt;0;0;1;1;138;0.0;0.0;0.01
3718_8.txt;9;0;0;9;158;0.06;0.0;0.0
4637_8.txt;35;9;2;46;530;0.07;0.02;0.0
12203_10.txt;8;5;0;13;166;0.05;0.03;0.0
2448_8.txt;9;0;0;9;254;0.04;0.0;0.0
3382_10.txt;2;0;0;2;165;0.01;0.0;0.0
3472_10.txt;6;0;0;6;171;0.04;0.0;0.0
1911_10.txt;14;1;0;15;164;0.09;0.01;0.0
1806_8.txt;1;0;0;1;371;0.0;0.0;0.0
5283_7.txt;1;9;0;10;307;0.0;0.03;0.0
4568_10.txt;23;0;1;24;169;0.14;0.0;0.01
1411_7.txt;0;2;1;3;208;0.0;0.01;0.0
7495_7.txt;2;0;0;2;71;0.03;0.0;0.0
1660_8.txt;5;1;0;6;259;0.02;0.0;0.0
2159_10.txt;0;0;0;0;274;0.0;0.0;0.0
8632_9.txt;4;0;0;4;91;0.04;0.0;0.0
1380_7.txt;0;1;0;1;407;0.0;0.0;0.0
2166_7.txt;2;0;0;2;180;0.01;0.0;0.0
5615_8.txt;5;1;0;6;192;0.03;0.01;0.0
5609_10.txt;9;1;0;10;543;0.02;0.0;0.0
9286_9.txt;3;9;0;12;731;0.0;0.01;0.0
6427_10.txt;25;0;5;30;146;0.17;0.0;0.03
1843_9.txt;14;0;0;14;424;0.03;0.0;0.0
4951_8.txt;22;4;4;30;594;0.04;0.01;0.01
3203_10.txt;6;0;0;6;117;0.05;0.0;0.0
4300_7.txt;2;2;0;4;218;0.01;0.01;0.0
11356_9.txt;4;1;0;5;180;0.02;0.01;0.0
10308_8.txt;7;0;1;8;153;0.05;0.0;0.01
9959_7.txt;2;0;2;4;136;0.01;0.0;0.01
5555_10.txt;8;0;6;14;228;0.04;0.0;0.03
4688_10.txt;6;0;3;9;183;0.03;0.0;0.02
10219_10.txt;56;0;0;56;559;0.1;0.0;0.0
8714_10.txt;1;0;0;1;47;0.02;0.0;0.0
11613_7.txt;0;1;0;1;185;0.0;0.01;0.0
5399_8.txt;7;1;0;8;251;0.03;0.0;0.0
3073_8.txt;14;2;0;16;203;0.07;0.01;0.0
8359_8.txt;5;0;0;5;225;0.02;0.0;0.0
11523_7.txt;10;0;0;10;262;0.04;0.0;0.0
4910_8.txt;8;2;0;10;269;0.03;0.01;0.0
5915_7.txt;29;2;5;36;423;0.07;0.0;0.01
4366_9.txt;45;5;1;51;826;0.05;0.01;0.0
6310_10.txt;8;0;4;12;140;0.06;0.0;0.03
2478_10.txt;28;0;1;29;633;0.04;0.0;0.0
3744_10.txt;2;0;0;2;151;0.01;0.0;0.0
11964_7.txt;4;1;0;5;166;0.02;0.01;0.0
9433_10.txt;2;1;1;4;167;0.01;0.01;0.01
11259_10.txt;3;0;0;3;67;0.04;0.0;0.0
1144_8.txt;36;0;0;36;569;0.06;0.0;0.0
8480_10.txt;8;0;3;11;202;0.04;0.0;0.01
6267_10.txt;9;0;5;14;353;0.03;0.0;0.01
3644_8.txt;24;3;2;29;263;0.09;0.01;0.01
11499_10.txt;0;0;0;0;181;0.0;0.0;0.0
7257_10.txt;4;1;0;5;259;0.02;0.0;0.0
8619_7.txt;4;2;0;6;428;0.01;0.0;0.0
10130_10.txt;2;0;0;2;113;0.02;0.0;0.0
3794_10.txt;13;4;1;18;612;0.02;0.01;0.0
11446_10.txt;1;0;0;1;115;0.01;0.0;0.0
8933_7.txt;7;2;0;9;326;0.02;0.01;0.0
7900_10.txt;7;0;0;7;145;0.05;0.0;0.0
6636_8.txt;5;4;7;16;423;0.01;0.01;0.02
4264_10.txt;0;5;1;6;162;0.0;0.03;0.01
2390_7.txt;1;0;2;3;165;0.01;0.0;0.01
10143_8.txt;2;0;0;2;225;0.01;0.0;0.0
2299_7.txt;9;1;0;10;365;0.02;0.0;0.0
9085_8.txt;0;4;0;4;143;0.0;0.03;0.0
5811_9.txt;1;1;0;2;150;0.01;0.01;0.0
6017_8.txt;2;2;0;4;385;0.01;0.01;0.0
6152_10.txt;12;2;1;15;263;0.05;0.01;0.0
11059_9.txt;26;0;2;28;431;0.06;0.0;0.0
10930_8.txt;12;3;1;16;588;0.02;0.01;0.0
5245_8.txt;4;0;0;4;170;0.02;0.0;0.0
9863_10.txt;6;2;0;8;260;0.02;0.01;0.0
5729_9.txt;2;0;0;2;157;0.01;0.0;0.0
5678_10.txt;19;0;0;19;198;0.1;0.0;0.0
1602_9.txt;2;0;2;4;73;0.03;0.0;0.03
4116_9.txt;11;3;4;18;499;0.02;0.01;0.01
2727_9.txt;13;0;0;13;230;0.06;0.0;0.0
9503_7.txt;0;0;0;0;73;0.0;0.0;0.0
11190_10.txt;2;0;0;2;63;0.03;0.0;0.0
6146_7.txt;16;1;1;18;289;0.06;0.0;0.0
8025_9.txt;0;0;0;0;93;0.0;0.0;0.0
4081_10.txt;2;1;0;3;168;0.01;0.01;0.0
856_7.txt;6;0;2;8;156;0.04;0.0;0.01
7460_10.txt;11;0;0;11;279;0.04;0.0;0.0
2713_8.txt;30;0;0;30;349;0.09;0.0;0.0
1782_7.txt;41;0;0;41;516;0.08;0.0;0.0
1534_10.txt;9;0;0;9;96;0.09;0.0;0.0
5528_7.txt;0;0;0;0;134;0.0;0.0;0.0
5055_8.txt;2;0;0;2;80;0.03;0.0;0.0
4514_10.txt;7;0;0;7;150;0.05;0.0;0.0
11563_10.txt;19;0;0;19;216;0.09;0.0;0.0
10941_7.txt;10;0;0;10;155;0.06;0.0;0.0
7462_10.txt;2;0;2;4;334;0.01;0.0;0.01
10781_10.txt;0;0;3;3;128;0.0;0.0;0.02
481_10.txt;6;0;2;8;104;0.06;0.0;0.02
8622_8.txt;0;0;0;0;152;0.0;0.0;0.0
4606_7.txt;1;0;0;1;54;0.02;0.0;0.0
1035_7.txt;14;4;1;19;163;0.09;0.02;0.01
7978_8.txt;0;8;0;8;292;0.0;0.03;0.0
7436_10.txt;4;0;0;4;192;0.02;0.0;0.0
10490_7.txt;6;0;2;8;148;0.04;0.0;0.01
1260_10.txt;2;0;0;2;57;0.04;0.0;0.0
12406_8.txt;33;4;0;37;364;0.09;0.01;0.0
12394_10.txt;0;0;0;0;68;0.0;0.0;0.0
9342_8.txt;39;1;0;40;260;0.15;0.0;0.0
2890_7.txt;28;1;8;37;617;0.05;0.0;0.01
9648_8.txt;2;0;0;2;93;0.02;0.0;0.0
8793_10.txt;0;0;0;0;48;0.0;0.0;0.0
3641_9.txt;29;0;2;31;400;0.07;0.0;0.01
1049_7.txt;2;2;0;4;132;0.02;0.02;0.0
10705_7.txt;1;0;0;1;133;0.01;0.0;0.0
2968_10.txt;0;0;0;0;68;0.0;0.0;0.0
3386_9.txt;13;1;2;16;363;0.04;0.0;0.01
4886_8.txt;22;1;0;23;384;0.06;0.0;0.0
10403_7.txt;41;3;0;44;332;0.12;0.01;0.0
10938_10.txt;0;0;0;0;241;0.0;0.0;0.0
8985_9.txt;3;1;0;4;136;0.02;0.01;0.0
6983_8.txt;5;1;1;7;148;0.03;0.01;0.01
9_7.txt;9;0;0;9;190;0.05;0.0;0.0
2076_9.txt;0;0;0;0;151;0.0;0.0;0.0
7045_10.txt;12;2;0;14;240;0.05;0.01;0.0
2153_9.txt;0;0;0;0;143;0.0;0.0;0.0
5025_10.txt;2;0;0;2;149;0.01;0.0;0.0
11832_7.txt;8;0;1;9;507;0.02;0.0;0.0
4344_9.txt;0;2;0;2;104;0.0;0.02;0.0
11620_8.txt;7;0;0;7;418;0.02;0.0;0.0
10829_10.txt;0;0;0;0;66;0.0;0.0;0.0
3180_8.txt;13;0;0;13;246;0.05;0.0;0.0
2899_10.txt;0;0;0;0;144;0.0;0.0;0.0
6397_8.txt;0;0;1;1;72;0.0;0.0;0.01
2680_7.txt;13;0;0;13;546;0.02;0.0;0.0
5169_7.txt;0;3;0;3;207;0.0;0.01;0.0
5252_9.txt;0;0;0;0;89;0.0;0.0;0.0
9507_10.txt;7;3;0;10;469;0.01;0.01;0.0
6158_10.txt;0;1;0;1;167;0.0;0.01;0.0
73_7.txt;9;0;0;9;266;0.03;0.0;0.0
11008_9.txt;15;0;0;15;393;0.04;0.0;0.0
10389_10.txt;5;0;0;5;160;0.03;0.0;0.0
474_7.txt;9;2;0;11;149;0.06;0.01;0.0
9903_9.txt;2;1;1;4;408;0.0;0.0;0.0
7942_10.txt;0;0;3;3;94;0.0;0.0;0.03
4398_9.txt;8;2;1;11;447;0.02;0.0;0.0
11472_7.txt;0;0;0;0;266;0.0;0.0;0.0
7612_9.txt;0;1;0;1;187;0.0;0.01;0.0
11315_10.txt;42;2;0;44;516;0.08;0.0;0.0
9261_7.txt;9;31;3;43;1105;0.01;0.03;0.0
6884_10.txt;2;0;0;2;133;0.02;0.0;0.0
7278_7.txt;1;1;0;2;208;0.0;0.0;0.0
2992_7.txt;0;1;0;1;136;0.0;0.01;0.0
442_9.txt;2;0;0;2;111;0.02;0.0;0.0
6731_10.txt;0;0;0;0;145;0.0;0.0;0.0
8502_9.txt;18;4;0;22;147;0.12;0.03;0.0
1193_9.txt;0;0;0;0;112;0.0;0.0;0.0
5748_10.txt;5;0;0;5;75;0.07;0.0;0.0
524_10.txt;0;3;1;4;206;0.0;0.01;0.0
10013_7.txt;3;0;0;3;180;0.02;0.0;0.0
7272_10.txt;4;5;1;10;218;0.02;0.02;0.0
1121_7.txt;4;1;0;5;157;0.03;0.01;0.0
6066_10.txt;9;2;0;11;282;0.03;0.01;0.0
10161_9.txt;33;5;0;38;464;0.07;0.01;0.0
5498_7.txt;4;2;2;8;147;0.03;0.01;0.01
4997_9.txt;4;4;0;8;85;0.05;0.05;0.0
6527_8.txt;21;1;0;22;203;0.1;0.0;0.0
7655_10.txt;10;2;2;14;201;0.05;0.01;0.01
8443_9.txt;3;0;0;3;108;0.03;0.0;0.0
5998_10.txt;7;0;0;7;188;0.04;0.0;0.0
10852_10.txt;24;1;2;27;436;0.06;0.0;0.0
11027_10.txt;3;1;0;4;161;0.02;0.01;0.0
5460_8.txt;28;2;2;32;166;0.17;0.01;0.01
8468_7.txt;2;0;0;2;149;0.01;0.0;0.0
3341_7.txt;5;1;0;6;154;0.03;0.01;0.0
4983_7.txt;2;0;4;6;208;0.01;0.0;0.02
8039_8.txt;2;1;0;3;116;0.02;0.01;0.0
5675_9.txt;9;2;0;11;149;0.06;0.01;0.0
7709_7.txt;3;2;0;5;249;0.01;0.01;0.0
2275_7.txt;26;10;6;42;468;0.06;0.02;0.01
10487_7.txt;0;0;0;0;173;0.0;0.0;0.0
1244_8.txt;14;0;0;14;243;0.06;0.0;0.0
981_7.txt;5;0;0;5;65;0.08;0.0;0.0
1503_9.txt;19;1;5;25;756;0.03;0.0;0.01
4463_7.txt;7;3;2;12;212;0.03;0.01;0.01
4758_8.txt;0;1;0;1;200;0.0;0.01;0.0
9602_10.txt;15;6;6;27;272;0.06;0.02;0.02
7850_8.txt;16;0;0;16;539;0.03;0.0;0.0
4388_9.txt;35;6;7;48;705;0.05;0.01;0.01
8901_8.txt;94;3;4;101;1137;0.08;0.0;0.0
6297_10.txt;9;1;2;12;254;0.04;0.0;0.01
4299_8.txt;0;1;0;1;118;0.0;0.01;0.0
6837_10.txt;8;0;4;12;249;0.03;0.0;0.02
658_10.txt;31;1;0;32;394;0.08;0.0;0.0
7934_7.txt;0;0;3;3;345;0.0;0.0;0.01
7720_8.txt;14;0;5;19;519;0.03;0.0;0.01
9662_10.txt;4;0;0;4;93;0.04;0.0;0.0
5041_8.txt;17;1;2;20;341;0.05;0.0;0.01
2762_9.txt;2;0;0;2;173;0.01;0.0;0.0
3758_9.txt;4;0;0;4;171;0.02;0.0;0.0
6020_7.txt;13;5;0;18;393;0.03;0.01;0.0
1143_7.txt;13;2;0;15;336;0.04;0.01;0.0
8134_10.txt;1;0;0;1;66;0.02;0.0;0.0
1631_8.txt;0;0;4;4;165;0.0;0.0;0.02
4480_9.txt;101;7;8;116;743;0.14;0.01;0.01
3505_8.txt;0;4;1;5;246;0.0;0.02;0.0
11800_8.txt;5;0;0;5;51;0.1;0.0;0.0
11150_10.txt;14;3;2;19;648;0.02;0.0;0.0
9932_8.txt;1;0;0;1;353;0.0;0.0;0.0
3993_7.txt;3;1;0;4;269;0.01;0.0;0.0
5791_9.txt;2;0;0;2;123;0.02;0.0;0.0
3653_10.txt;10;0;0;10;90;0.11;0.0;0.0
10657_8.txt;4;0;0;4;150;0.03;0.0;0.0
6609_8.txt;4;3;1;8;569;0.01;0.01;0.0
7498_10.txt;0;0;0;0;73;0.0;0.0;0.0
2892_10.txt;3;0;2;5;205;0.01;0.0;0.01
6771_7.txt;5;0;0;5;153;0.03;0.0;0.0
8175_7.txt;4;0;0;4;150;0.03;0.0;0.0
11788_8.txt;3;0;0;3;284;0.01;0.0;0.0
8625_7.txt;2;0;0;2;280;0.01;0.0;0.0
4598_9.txt;5;0;0;5;88;0.06;0.0;0.0
12027_10.txt;1;0;0;1;149;0.01;0.0;0.0
7046_7.txt;16;3;3;22;355;0.05;0.01;0.01
9962_9.txt;10;1;0;11;224;0.04;0.0;0.0
12159_7.txt;20;1;0;21;348;0.06;0.0;0.0
5608_9.txt;8;0;0;8;290;0.03;0.0;0.0
355_9.txt;4;1;1;6;151;0.03;0.01;0.01
5471_8.txt;23;1;0;24;249;0.09;0.0;0.0
138_7.txt;5;0;0;5;154;0.03;0.0;0.0
749_10.txt;36;0;0;36;531;0.07;0.0;0.0
1360_10.txt;2;0;0;2;87;0.02;0.0;0.0
5125_7.txt;4;2;0;6;116;0.03;0.02;0.0
3225_10.txt;2;0;0;2;87;0.02;0.0;0.0
3646_8.txt;21;7;31;59;794;0.03;0.01;0.04
1909_10.txt;6;1;1;8;146;0.04;0.01;0.01
3640_8.txt;6;0;0;6;200;0.03;0.0;0.0
4218_8.txt;8;0;0;8;335;0.02;0.0;0.0
7597_9.txt;0;0;0;0;431;0.0;0.0;0.0
1601_8.txt;31;0;12;43;330;0.09;0.0;0.04
9795_7.txt;3;1;0;4;287;0.01;0.0;0.0
9472_8.txt;44;1;4;49;936;0.05;0.0;0.0
9818_7.txt;11;2;1;14;497;0.02;0.0;0.0
8689_7.txt;4;0;0;4;100;0.04;0.0;0.0
1419_7.txt;4;5;1;10;936;0.0;0.01;0.0
5856_8.txt;0;0;0;0;118;0.0;0.0;0.0
3009_8.txt;2;2;5;9;274;0.01;0.01;0.02
9664_10.txt;6;0;0;6;129;0.05;0.0;0.0
5587_7.txt;12;0;0;12;564;0.02;0.0;0.0
12445_9.txt;0;0;0;0;167;0.0;0.0;0.0
8294_8.txt;4;0;0;4;151;0.03;0.0;0.0
5230_10.txt;0;0;0;0;115;0.0;0.0;0.0
1701_10.txt;4;0;0;4;111;0.04;0.0;0.0
6246_9.txt;4;0;1;5;264;0.02;0.0;0.0
2861_10.txt;3;2;2;7;358;0.01;0.01;0.01
1716_8.txt;25;3;0;28;270;0.09;0.01;0.0
5099_7.txt;7;0;0;7;166;0.04;0.0;0.0
2909_10.txt;5;3;0;8;115;0.04;0.03;0.0
3241_8.txt;10;5;0;15;228;0.04;0.02;0.0
3086_10.txt;9;1;4;14;108;0.08;0.01;0.04
2269_10.txt;1;0;0;1;202;0.0;0.0;0.0
6621_8.txt;0;2;0;2;134;0.0;0.01;0.0
1533_8.txt;3;6;1;10;177;0.02;0.03;0.01
5804_10.txt;11;3;0;14;182;0.06;0.02;0.0
10112_7.txt;21;0;0;21;258;0.08;0.0;0.0
535_10.txt;11;0;0;11;298;0.04;0.0;0.0
1985_10.txt;13;1;0;14;382;0.03;0.0;0.0
10813_10.txt;5;0;0;5;220;0.02;0.0;0.0
9270_9.txt;0;3;0;3;216;0.0;0.01;0.0
3289_10.txt;13;5;4;22;518;0.03;0.01;0.01
4943_10.txt;7;0;0;7;405;0.02;0.0;0.0
1923_10.txt;66;1;3;70;1185;0.06;0.0;0.0
8976_7.txt;39;7;12;58;393;0.1;0.02;0.03
3972_7.txt;39;0;30;69;603;0.06;0.0;0.05
12021_9.txt;32;5;2;39;428;0.07;0.01;0.0
351_10.txt;0;0;0;0;140;0.0;0.0;0.0
6891_9.txt;31;2;0;33;770;0.04;0.0;0.0
7470_10.txt;8;0;0;8;273;0.03;0.0;0.0
9933_8.txt;8;1;0;9;167;0.05;0.01;0.0
6361_10.txt;12;0;0;12;273;0.04;0.0;0.0
1018_8.txt;0;0;0;0;59;0.0;0.0;0.0
12350_9.txt;4;4;0;8;373;0.01;0.01;0.0
723_8.txt;51;0;7;58;875;0.06;0.0;0.01
7794_7.txt;5;0;0;5;168;0.03;0.0;0.0
1_7.txt;20;3;2;25;138;0.14;0.02;0.01
1970_9.txt;12;0;0;12;800;0.01;0.0;0.0
5413_10.txt;37;0;1;38;828;0.04;0.0;0.0
1296_10.txt;0;1;0;1;178;0.0;0.01;0.0
767_9.txt;0;3;0;3;191;0.0;0.02;0.0
1067_7.txt;6;0;0;6;612;0.01;0.0;0.0
6758_10.txt;20;3;0;23;623;0.03;0.0;0.0
3111_7.txt;9;2;1;12;459;0.02;0.0;0.0
7790_9.txt;2;0;1;3;52;0.04;0.0;0.02
3006_9.txt;5;0;1;6;279;0.02;0.0;0.0
9413_9.txt;12;0;1;13;440;0.03;0.0;0.0
4819_7.txt;17;2;0;19;581;0.03;0.0;0.0
1827_10.txt;5;0;0;5;285;0.02;0.0;0.0
12109_10.txt;13;5;1;19;176;0.07;0.03;0.01
639_10.txt;15;1;2;18;199;0.08;0.01;0.01
6930_8.txt;11;2;2;15;427;0.03;0.0;0.0
4205_8.txt;20;7;4;31;770;0.03;0.01;0.01
8620_8.txt;0;0;0;0;199;0.0;0.0;0.0
875_10.txt;10;1;0;11;198;0.05;0.01;0.0
5720_10.txt;1;0;0;1;163;0.01;0.0;0.0
12284_7.txt;4;0;0;4;128;0.03;0.0;0.0
8668_9.txt;36;2;0;38;1033;0.03;0.0;0.0
3876_8.txt;17;0;0;17;205;0.08;0.0;0.0
5272_7.txt;1;0;0;1;99;0.01;0.0;0.0
9923_7.txt;12;2;1;15;1127;0.01;0.0;0.0
11050_8.txt;0;0;0;0;153;0.0;0.0;0.0
3242_8.txt;2;0;0;2;136;0.01;0.0;0.0
4316_10.txt;0;4;0;4;437;0.0;0.01;0.0
2447_10.txt;6;1;0;7;174;0.03;0.01;0.0
153_10.txt;0;0;0;0;218;0.0;0.0;0.0
5874_10.txt;0;0;0;0;154;0.0;0.0;0.0
1367_10.txt;0;0;0;0;70;0.0;0.0;0.0
7728_7.txt;2;0;0;2;111;0.02;0.0;0.0
10480_10.txt;0;0;0;0;55;0.0;0.0;0.0
5760_8.txt;0;2;1;3;255;0.0;0.01;0.0
10134_7.txt;26;0;0;26;723;0.04;0.0;0.0
561_10.txt;102;10;3;115;918;0.11;0.01;0.0
860_8.txt;4;0;0;4;200;0.02;0.0;0.0
8953_8.txt;9;0;2;11;451;0.02;0.0;0.0
4942_7.txt;5;2;0;7;300;0.02;0.01;0.0
499_8.txt;0;0;0;0;203;0.0;0.0;0.0
5132_8.txt;5;0;0;5;123;0.04;0.0;0.0
10998_7.txt;24;0;2;26;494;0.05;0.0;0.0
6461_10.txt;2;3;0;5;132;0.02;0.02;0.0
8358_9.txt;3;0;1;4;185;0.02;0.0;0.01
3528_7.txt;25;1;0;26;394;0.06;0.0;0.0
6643_7.txt;5;3;0;8;258;0.02;0.01;0.0
11329_9.txt;6;1;0;7;146;0.04;0.01;0.0
1513_7.txt;5;0;0;5;330;0.02;0.0;0.0
2549_8.txt;9;0;0;9;155;0.06;0.0;0.0
3710_9.txt;42;5;0;47;743;0.06;0.01;0.0
4964_10.txt;4;8;2;14;275;0.01;0.03;0.01
299_10.txt;6;2;0;8;135;0.04;0.01;0.0
7240_8.txt;0;0;0;0;84;0.0;0.0;0.0
8019_7.txt;5;6;8;19;604;0.01;0.01;0.01
1526_9.txt;57;5;1;63;824;0.07;0.01;0.0
61_10.txt;3;0;0;3;669;0.0;0.0;0.0
8333_9.txt;7;0;0;7;151;0.05;0.0;0.0
372_10.txt;25;2;0;27;469;0.05;0.0;0.0
3643_10.txt;0;9;0;9;215;0.0;0.04;0.0
6688_9.txt;15;0;0;15;190;0.08;0.0;0.0
2331_10.txt;7;0;0;7;219;0.03;0.0;0.0
7119_10.txt;4;6;5;15;261;0.02;0.02;0.02
1192_8.txt;23;0;3;26;483;0.05;0.0;0.01
534_10.txt;16;2;3;21;685;0.02;0.0;0.0
6544_10.txt;4;0;0;4;185;0.02;0.0;0.0
1225_10.txt;0;2;0;2;154;0.0;0.01;0.0
12114_7.txt;11;7;0;18;207;0.05;0.03;0.0
10077_10.txt;0;1;0;1;61;0.0;0.02;0.0
2910_7.txt;15;0;0;15;264;0.06;0.0;0.0
6926_10.txt;34;2;0;36;578;0.06;0.0;0.0
3377_8.txt;0;0;2;2;171;0.0;0.0;0.01
3629_8.txt;0;0;0;0;84;0.0;0.0;0.0
1146_7.txt;0;0;0;0;95;0.0;0.0;0.0
12316_10.txt;25;2;0;27;329;0.08;0.01;0.0
949_8.txt;3;0;0;3;95;0.03;0.0;0.0
5802_10.txt;4;0;0;4;47;0.09;0.0;0.0
10631_8.txt;0;0;0;0;162;0.0;0.0;0.0
7477_9.txt;3;2;0;5;132;0.02;0.02;0.0
9836_9.txt;2;0;2;4;164;0.01;0.0;0.01
5699_8.txt;5;0;0;5;316;0.02;0.0;0.0
9675_8.txt;9;2;2;13;387;0.02;0.01;0.01
11912_10.txt;3;2;0;5;256;0.01;0.01;0.0
2911_10.txt;1;0;0;1;225;0.0;0.0;0.0
10301_8.txt;4;0;2;6;95;0.04;0.0;0.02
2645_8.txt;0;0;0;0;182;0.0;0.0;0.0
9029_10.txt;0;0;0;0;79;0.0;0.0;0.0
3923_10.txt;1;0;1;2;164;0.01;0.0;0.01
8725_10.txt;1;0;1;2;101;0.01;0.0;0.01
2575_7.txt;11;0;3;14;394;0.03;0.0;0.01
392_9.txt;4;1;0;5;212;0.02;0.0;0.0
3213_10.txt;13;0;0;13;153;0.08;0.0;0.0
8703_10.txt;0;0;0;0;154;0.0;0.0;0.0
9166_9.txt;13;0;0;13;266;0.05;0.0;0.0
5316_7.txt;4;0;0;4;89;0.04;0.0;0.0
2936_10.txt;10;2;1;13;257;0.04;0.01;0.0
489_7.txt;25;4;6;35;365;0.07;0.01;0.02
12106_10.txt;11;0;0;11;144;0.08;0.0;0.0
9480_10.txt;0;1;0;1;40;0.0;0.03;0.0
7083_10.txt;10;0;0;10;203;0.05;0.0;0.0
8053_8.txt;11;2;0;13;184;0.06;0.01;0.0
7770_7.txt;25;4;0;29;405;0.06;0.01;0.0
7641_10.txt;1;0;0;1;93;0.01;0.0;0.0
2254_8.txt;17;10;14;41;359;0.05;0.03;0.04
5553_8.txt;11;0;0;11;191;0.06;0.0;0.0
8352_9.txt;4;0;0;4;88;0.05;0.0;0.0
12048_10.txt;0;1;0;1;76;0.0;0.01;0.0
11737_8.txt;3;0;0;3;183;0.02;0.0;0.0
10770_7.txt;2;0;0;2;56;0.04;0.0;0.0
10333_8.txt;7;1;1;9;395;0.02;0.0;0.0
8943_7.txt;17;3;0;20;230;0.07;0.01;0.0
5142_10.txt;1;0;0;1;164;0.01;0.0;0.0
12028_10.txt;0;0;0;0;42;0.0;0.0;0.0
6338_9.txt;2;0;0;2;106;0.02;0.0;0.0
3785_10.txt;9;1;2;12;356;0.03;0.0;0.01
6743_9.txt;17;2;0;19;285;0.06;0.01;0.0
6612_8.txt;1;3;0;4;136;0.01;0.02;0.0
9059_7.txt;5;0;0;5;198;0.03;0.0;0.0
10604_7.txt;2;0;0;2;38;0.05;0.0;0.0
4419_7.txt;23;1;3;27;389;0.06;0.0;0.01
11656_9.txt;1;0;0;1;138;0.01;0.0;0.0
10903_10.txt;5;1;0;6;168;0.03;0.01;0.0
9109_7.txt;4;0;0;4;196;0.02;0.0;0.0
3432_8.txt;2;6;0;8;221;0.01;0.03;0.0
8254_8.txt;25;1;1;27;380;0.07;0.0;0.0
8601_10.txt;8;3;0;11;233;0.03;0.01;0.0
2229_7.txt;2;0;0;2;217;0.01;0.0;0.0
7223_10.txt;21;1;3;25;433;0.05;0.0;0.01
5358_10.txt;18;0;2;20;177;0.1;0.0;0.01
4791_10.txt;6;7;0;13;695;0.01;0.01;0.0
9689_9.txt;2;0;0;2;62;0.03;0.0;0.0
4432_10.txt;1;0;1;2;253;0.0;0.0;0.0
10409_10.txt;7;3;0;10;795;0.01;0.0;0.0
4621_9.txt;0;0;0;0;163;0.0;0.0;0.0
7332_7.txt;10;0;3;13;449;0.02;0.0;0.01
8676_8.txt;7;0;0;7;138;0.05;0.0;0.0
9200_8.txt;6;0;0;6;174;0.03;0.0;0.0
8211_7.txt;2;0;0;2;109;0.02;0.0;0.0
11870_10.txt;2;0;0;2;53;0.04;0.0;0.0
7048_10.txt;18;1;3;22;499;0.04;0.0;0.01
9575_9.txt;14;4;0;18;596;0.02;0.01;0.0
11761_10.txt;10;2;1;13;108;0.09;0.02;0.01
3208_7.txt;1;0;0;1;47;0.02;0.0;0.0
1666_8.txt;3;0;0;3;277;0.01;0.0;0.0
7649_9.txt;7;0;0;7;72;0.1;0.0;0.0
940_10.txt;7;3;0;10;229;0.03;0.01;0.0
2897_10.txt;34;0;8;42;765;0.04;0.0;0.01
6555_8.txt;10;0;0;10;191;0.05;0.0;0.0
6859_7.txt;35;0;8;43;823;0.04;0.0;0.01
9277_9.txt;8;6;0;14;253;0.03;0.02;0.0
4152_10.txt;25;0;3;28;723;0.03;0.0;0.0
5209_8.txt;15;0;0;15;223;0.07;0.0;0.0
5458_10.txt;1;1;0;2;169;0.01;0.01;0.0
5845_7.txt;10;0;0;10;610;0.02;0.0;0.0
4208_10.txt;2;2;0;4;368;0.01;0.01;0.0
9677_9.txt;0;0;0;0;139;0.0;0.0;0.0
10036_8.txt;19;3;1;23;378;0.05;0.01;0.0
10399_10.txt;7;1;0;8;359;0.02;0.0;0.0
6078_8.txt;6;0;0;6;138;0.04;0.0;0.0
7731_9.txt;4;0;0;4;124;0.03;0.0;0.0
5030_9.txt;0;1;0;1;79;0.0;0.01;0.0
1832_7.txt;10;0;0;10;352;0.03;0.0;0.0
5938_10.txt;2;0;2;4;294;0.01;0.0;0.01
9586_10.txt;0;0;0;0;136;0.0;0.0;0.0
11486_8.txt;0;1;0;1;58;0.0;0.02;0.0
8837_8.txt;3;4;0;7;164;0.02;0.02;0.0
9711_9.txt;2;7;0;9;254;0.01;0.03;0.0
10354_9.txt;21;2;1;24;636;0.03;0.0;0.0
4865_7.txt;12;0;4;16;216;0.06;0.0;0.02
7313_10.txt;4;0;0;4;311;0.01;0.0;0.0
1945_8.txt;14;4;6;24;352;0.04;0.01;0.02
7727_9.txt;7;0;0;7;147;0.05;0.0;0.0
1699_10.txt;0;3;0;3;69;0.0;0.04;0.0
10583_10.txt;31;2;10;43;474;0.07;0.0;0.02
5409_10.txt;3;1;0;4;137;0.02;0.01;0.0
4845_9.txt;8;0;0;8;190;0.04;0.0;0.0
1878_10.txt;14;0;0;14;483;0.03;0.0;0.0
3997_10.txt;9;0;0;9;489;0.02;0.0;0.0
3355_10.txt;7;1;0;8;200;0.04;0.01;0.0
10738_9.txt;0;6;0;6;299;0.0;0.02;0.0
7856_10.txt;24;1;6;31;484;0.05;0.0;0.01
2488_10.txt;2;0;0;2;99;0.02;0.0;0.0
6104_10.txt;2;0;0;2;217;0.01;0.0;0.0
80_9.txt;2;0;1;3;116;0.02;0.0;0.01
10730_10.txt;7;0;0;7;248;0.03;0.0;0.0
10812_8.txt;6;1;2;9;694;0.01;0.0;0.0
9339_10.txt;19;0;5;24;175;0.11;0.0;0.03
9747_10.txt;15;9;0;24;248;0.06;0.04;0.0
6552_9.txt;4;0;0;4;190;0.02;0.0;0.0
10755_10.txt;0;0;0;0;142;0.0;0.0;0.0
2002_7.txt;9;0;0;9;141;0.06;0.0;0.0
11553_9.txt;14;2;1;17;513;0.03;0.0;0.0
10065_9.txt;0;4;0;4;322;0.0;0.01;0.0
8462_9.txt;0;0;0;0;243;0.0;0.0;0.0
6669_10.txt;16;0;0;16;427;0.04;0.0;0.0
4115_8.txt;7;1;0;8;425;0.02;0.0;0.0
2761_10.txt;3;4;0;7;184;0.02;0.02;0.0
7739_10.txt;20;0;0;20;201;0.1;0.0;0.0
9440_8.txt;0;0;3;3;190;0.0;0.0;0.02
4391_8.txt;6;0;0;6;497;0.01;0.0;0.0
5516_7.txt;31;2;7;40;590;0.05;0.0;0.01
6683_8.txt;4;0;0;4;185;0.02;0.0;0.0
4225_10.txt;10;0;0;10;66;0.15;0.0;0.0
744_7.txt;4;1;0;5;102;0.04;0.01;0.0
6388_7.txt;0;0;5;5;358;0.0;0.0;0.01
5197_10.txt;4;0;0;4;189;0.02;0.0;0.0
1702_9.txt;0;0;0;0;96;0.0;0.0;0.0
5179_7.txt;2;0;0;2;235;0.01;0.0;0.0
90_7.txt;0;0;0;0;190;0.0;0.0;0.0
10452_10.txt;3;3;0;6;283;0.01;0.01;0.0
7634_7.txt;0;0;0;0;102;0.0;0.0;0.0
2866_9.txt;25;4;1;30;552;0.05;0.01;0.0
10783_10.txt;4;0;0;4;173;0.02;0.0;0.0
2470_10.txt;3;0;0;3;87;0.03;0.0;0.0
6509_9.txt;0;0;0;0;366;0.0;0.0;0.0
2023_7.txt;8;0;0;8;483;0.02;0.0;0.0
3052_10.txt;13;0;0;13;122;0.11;0.0;0.0
2853_8.txt;2;0;0;2;180;0.01;0.0;0.0
2913_7.txt;4;3;6;13;235;0.02;0.01;0.03
1421_9.txt;2;0;0;2;194;0.01;0.0;0.0
7861_10.txt;20;0;2;22;478;0.04;0.0;0.0
7938_7.txt;35;0;0;35;323;0.11;0.0;0.0
6565_8.txt;13;0;1;14;283;0.05;0.0;0.0
7682_8.txt;6;1;2;9;170;0.04;0.01;0.01
757_8.txt;1;0;0;1;218;0.0;0.0;0.0
6996_8.txt;2;0;0;2;153;0.01;0.0;0.0
10478_8.txt;0;1;0;1;250;0.0;0.0;0.0
9724_7.txt;2;2;0;4;196;0.01;0.01;0.0
3315_10.txt;6;0;0;6;129;0.05;0.0;0.0
6520_7.txt;6;0;1;7;103;0.06;0.0;0.01
7315_10.txt;12;0;0;12;321;0.04;0.0;0.0
3462_7.txt;37;1;1;39;613;0.06;0.0;0.0
7329_8.txt;2;7;0;9;207;0.01;0.03;0.0
6989_7.txt;4;0;0;4;190;0.02;0.0;0.0
4000_10.txt;8;2;0;10;111;0.07;0.02;0.0
604_8.txt;8;1;2;11;186;0.04;0.01;0.01
6529_7.txt;11;0;4;15;196;0.06;0.0;0.02
649_10.txt;5;0;0;5;94;0.05;0.0;0.0
3542_8.txt;18;6;2;26;500;0.04;0.01;0.0
2824_8.txt;28;2;1;31;387;0.07;0.01;0.0
870_10.txt;6;1;0;7;321;0.02;0.0;0.0
6623_7.txt;0;0;0;0;132;0.0;0.0;0.0
6285_7.txt;14;0;2;16;298;0.05;0.0;0.01
5047_8.txt;10;0;1;11;219;0.05;0.0;0.0
1372_7.txt;17;1;0;18;193;0.09;0.01;0.0
12420_9.txt;0;0;1;1;127;0.0;0.0;0.01
5824_10.txt;0;0;0;0;53;0.0;0.0;0.0
11810_7.txt;12;1;0;13;399;0.03;0.0;0.0
1181_9.txt;7;0;0;7;144;0.05;0.0;0.0
9565_8.txt;9;3;2;14;382;0.02;0.01;0.01
8823_8.txt;0;0;1;1;161;0.0;0.0;0.01
3294_9.txt;50;4;9;63;435;0.11;0.01;0.02
5019_10.txt;11;1;0;12;114;0.1;0.01;0.0
6914_8.txt;4;0;0;4;139;0.03;0.0;0.0
9968_9.txt;2;1;0;3;169;0.01;0.01;0.0
12137_10.txt;10;2;5;17;244;0.04;0.01;0.02
7041_7.txt;50;5;6;61;499;0.1;0.01;0.01
11301_7.txt;20;1;0;21;934;0.02;0.0;0.0
2756_9.txt;0;0;0;0;100;0.0;0.0;0.0
3142_8.txt;10;0;2;12;226;0.04;0.0;0.01
6709_10.txt;8;0;0;8;132;0.06;0.0;0.0
8894_10.txt;0;0;0;0;62;0.0;0.0;0.0
4474_10.txt;79;7;6;92;940;0.08;0.01;0.01
5233_10.txt;20;0;0;20;336;0.06;0.0;0.0
9206_8.txt;2;0;0;2;215;0.01;0.0;0.0
6313_9.txt;19;1;4;24;148;0.13;0.01;0.03
12281_9.txt;0;0;0;0;56;0.0;0.0;0.0
3055_9.txt;23;1;1;25;364;0.06;0.0;0.0
8484_10.txt;0;0;0;0;62;0.0;0.0;0.0
10588_10.txt;33;3;5;41;433;0.08;0.01;0.01
8031_9.txt;11;1;0;12;206;0.05;0.0;0.0
948_10.txt;5;0;0;5;147;0.03;0.0;0.0
5182_8.txt;0;0;0;0;130;0.0;0.0;0.0
4785_10.txt;9;2;0;11;429;0.02;0.0;0.0
3080_10.txt;0;0;1;1;129;0.0;0.0;0.01
4294_8.txt;4;4;3;11;266;0.02;0.02;0.01
2347_10.txt;2;0;1;3;137;0.01;0.0;0.01
3191_8.txt;32;2;2;36;233;0.14;0.01;0.01
11973_10.txt;39;0;2;41;159;0.25;0.0;0.01
7901_7.txt;11;2;4;17;312;0.04;0.01;0.01
12400_8.txt;0;0;0;0;291;0.0;0.0;0.0
9983_7.txt;0;0;0;0;175;0.0;0.0;0.0
9984_9.txt;0;0;2;2;456;0.0;0.0;0.0
3775_7.txt;22;0;0;22;395;0.06;0.0;0.0
10810_8.txt;1;0;0;1;85;0.01;0.0;0.0
11754_7.txt;10;0;0;10;67;0.15;0.0;0.0
10565_9.txt;23;0;8;31;302;0.08;0.0;0.03
6571_10.txt;23;2;0;25;264;0.09;0.01;0.0
8954_8.txt;59;11;0;70;622;0.09;0.02;0.0
337_9.txt;9;6;2;17;466;0.02;0.01;0.0
6293_10.txt;7;0;1;8;150;0.05;0.0;0.01
8700_7.txt;0;0;0;0;192;0.0;0.0;0.0
8935_8.txt;26;5;0;31;567;0.05;0.01;0.0
2656_10.txt;26;0;2;28;1052;0.02;0.0;0.0
2551_9.txt;20;0;1;21;234;0.09;0.0;0.0
11918_10.txt;0;6;16;22;403;0.0;0.01;0.04
8105_8.txt;8;2;0;10;505;0.02;0.0;0.0
4493_9.txt;3;2;0;5;74;0.04;0.03;0.0
6987_10.txt;3;0;0;3;170;0.02;0.0;0.0
11924_10.txt;1;0;0;1;37;0.03;0.0;0.0
4265_8.txt;7;0;2;9;168;0.04;0.0;0.01
11905_8.txt;18;1;4;23;620;0.03;0.0;0.01
11154_10.txt;5;11;2;18;343;0.01;0.03;0.01
924_7.txt;0;0;3;3;135;0.0;0.0;0.02
9046_8.txt;13;1;0;14;319;0.04;0.0;0.0
2360_10.txt;0;0;0;0;161;0.0;0.0;0.0
529_10.txt;0;1;0;1;235;0.0;0.0;0.0
4981_10.txt;2;0;2;4;391;0.01;0.0;0.01
6303_8.txt;9;4;1;14;144;0.06;0.03;0.01
2774_10.txt;14;2;0;16;219;0.06;0.01;0.0
10615_8.txt;0;1;0;1;89;0.0;0.01;0.0
1873_8.txt;14;1;2;17;190;0.07;0.01;0.01
9695_10.txt;15;3;2;20;160;0.09;0.02;0.01
7761_10.txt;27;5;4;36;648;0.04;0.01;0.01
3480_10.txt;14;1;0;15;152;0.09;0.01;0.0
9610_10.txt;7;0;0;7;121;0.06;0.0;0.0
1397_7.txt;1;0;0;1;147;0.01;0.0;0.0
10702_10.txt;7;1;0;8;209;0.03;0.0;0.0
11705_7.txt;2;0;0;2;73;0.03;0.0;0.0
4326_7.txt;17;2;4;23;676;0.03;0.0;0.01
12466_7.txt;13;0;1;14;352;0.04;0.0;0.0
12389_10.txt;6;2;1;9;274;0.02;0.01;0.0
973_9.txt;6;1;0;7;202;0.03;0.0;0.0
7618_10.txt;24;0;0;24;218;0.11;0.0;0.0
3146_10.txt;1;0;0;1;152;0.01;0.0;0.0
5438_10.txt;13;1;2;16;297;0.04;0.0;0.01
8623_7.txt;4;0;1;5;377;0.01;0.0;0.0
9134_7.txt;1;0;0;1;181;0.01;0.0;0.0
2682_9.txt;19;0;0;19;491;0.04;0.0;0.0
2494_10.txt;6;0;3;9;204;0.03;0.0;0.01
11655_10.txt;0;0;0;0;125;0.0;0.0;0.0
2233_10.txt;0;2;0;2;229;0.0;0.01;0.0
4107_10.txt;2;0;0;2;145;0.01;0.0;0.0
11324_10.txt;0;0;0;0;285;0.0;0.0;0.0
11235_8.txt;14;1;1;16;457;0.03;0.0;0.0
6289_10.txt;3;0;0;3;145;0.02;0.0;0.0
6517_10.txt;1;0;0;1;137;0.01;0.0;0.0
2846_10.txt;0;2;0;2;205;0.0;0.01;0.0
1859_8.txt;2;1;0;3;203;0.01;0.0;0.0
9700_10.txt;9;1;0;10;334;0.03;0.0;0.0
10400_10.txt;6;0;2;8;120;0.05;0.0;0.02
621_10.txt;25;2;4;31;639;0.04;0.0;0.01
6553_10.txt;4;4;0;8;410;0.01;0.01;0.0
4511_9.txt;3;1;2;6;185;0.02;0.01;0.01
6065_10.txt;3;3;0;6;311;0.01;0.01;0.0
10717_10.txt;0;1;0;1;231;0.0;0.0;0.0
433_10.txt;4;1;0;5;137;0.03;0.01;0.0
8729_10.txt;1;0;1;2;172;0.01;0.0;0.01
11412_10.txt;10;1;0;11;179;0.06;0.01;0.0
10601_10.txt;15;4;1;20;170;0.09;0.02;0.01
7628_8.txt;8;0;0;8;143;0.06;0.0;0.0
1481_10.txt;2;1;2;5;111;0.02;0.01;0.02
9011_9.txt;12;2;0;14;190;0.06;0.01;0.0
11808_9.txt;56;2;9;67;530;0.11;0.0;0.02
2241_7.txt;7;0;0;7;141;0.05;0.0;0.0
1322_8.txt;1;0;0;1;136;0.01;0.0;0.0
11343_8.txt;1;0;0;1;160;0.01;0.0;0.0
11920_9.txt;6;0;0;6;129;0.05;0.0;0.0
2013_8.txt;49;3;6;58;776;0.06;0.0;0.01
5291_8.txt;15;2;2;19;293;0.05;0.01;0.01
2969_10.txt;6;0;1;7;152;0.04;0.0;0.01
5188_8.txt;59;0;0;59;479;0.12;0.0;0.0
7553_10.txt;1;0;0;1;161;0.01;0.0;0.0
3260_8.txt;0;0;0;0;126;0.0;0.0;0.0
3067_9.txt;1;0;1;2;197;0.01;0.0;0.01
4166_9.txt;21;5;0;26;276;0.08;0.02;0.0
2628_10.txt;20;2;0;22;238;0.08;0.01;0.0
6478_10.txt;2;1;0;3;78;0.03;0.01;0.0
4457_8.txt;14;1;3;18;122;0.11;0.01;0.02
9835_9.txt;9;0;0;9;244;0.04;0.0;0.0
1527_7.txt;17;0;0;17;217;0.08;0.0;0.0
1611_10.txt;11;9;0;20;742;0.01;0.01;0.0
11641_7.txt;4;0;0;4;415;0.01;0.0;0.0
8413_8.txt;0;0;0;0;214;0.0;0.0;0.0
7753_10.txt;11;1;0;12;211;0.05;0.0;0.0
6466_10.txt;0;3;0;3;166;0.0;0.02;0.0
1407_7.txt;21;2;0;23;761;0.03;0.0;0.0
6750_8.txt;0;0;0;0;169;0.0;0.0;0.0
7010_10.txt;6;0;0;6;248;0.02;0.0;0.0
12216_8.txt;0;1;0;1;318;0.0;0.0;0.0
180_9.txt;0;0;1;1;212;0.0;0.0;0.0
7499_7.txt;0;2;0;2;139;0.0;0.01;0.0
11910_10.txt;7;6;1;14;158;0.04;0.04;0.01
922_8.txt;10;2;1;13;327;0.03;0.01;0.0
67_10.txt;7;0;0;7;392;0.02;0.0;0.0
7147_10.txt;0;1;0;1;59;0.0;0.02;0.0
3733_10.txt;2;3;1;6;186;0.01;0.02;0.01
9683_9.txt;1;0;0;1;98;0.01;0.0;0.0
5513_7.txt;7;0;0;7;271;0.03;0.0;0.0
8808_9.txt;7;13;0;20;566;0.01;0.02;0.0
5349_7.txt;11;1;0;12;294;0.04;0.0;0.0
9989_9.txt;14;2;0;16;388;0.04;0.01;0.0
4483_8.txt;11;0;0;11;171;0.06;0.0;0.0
1409_8.txt;15;0;1;16;499;0.03;0.0;0.0
11981_9.txt;16;0;0;16;215;0.07;0.0;0.0
9635_7.txt;0;0;0;0;81;0.0;0.0;0.0
11189_8.txt;4;0;1;5;61;0.07;0.0;0.02
8414_7.txt;19;1;0;20;544;0.03;0.0;0.0
2813_8.txt;2;0;0;2;299;0.01;0.0;0.0
6062_10.txt;0;0;0;0;120;0.0;0.0;0.0
2217_7.txt;8;0;0;8;158;0.05;0.0;0.0
6724_8.txt;0;0;0;0;131;0.0;0.0;0.0
4007_9.txt;14;0;0;14;317;0.04;0.0;0.0
5683_10.txt;28;0;1;29;378;0.07;0.0;0.0
9282_8.txt;2;1;0;3;148;0.01;0.01;0.0
10754_10.txt;0;0;3;3;157;0.0;0.0;0.02
4142_10.txt;0;1;0;1;192;0.0;0.01;0.0
4313_9.txt;2;0;2;4;141;0.01;0.0;0.01
853_9.txt;21;3;2;26;255;0.08;0.01;0.01
1324_7.txt;12;4;0;16;329;0.04;0.01;0.0
12324_10.txt;0;0;0;0;66;0.0;0.0;0.0
12363_9.txt;9;0;0;9;243;0.04;0.0;0.0
2579_8.txt;33;0;1;34;605;0.05;0.0;0.0
9347_7.txt;53;1;4;58;720;0.07;0.0;0.01
5750_8.txt;14;1;0;15;315;0.04;0.0;0.0
478_7.txt;3;1;1;5;133;0.02;0.01;0.01
1170_8.txt;1;2;0;3;131;0.01;0.02;0.0
9697_8.txt;1;0;0;1;120;0.01;0.0;0.0
2059_7.txt;1;0;0;1;137;0.01;0.0;0.0
8316_9.txt;6;1;0;7;150;0.04;0.01;0.0
5920_9.txt;21;0;0;21;322;0.07;0.0;0.0
11251_10.txt;69;3;0;72;768;0.09;0.0;0.0
6511_10.txt;0;0;2;2;272;0.0;0.0;0.01
3745_10.txt;0;0;0;0;128;0.0;0.0;0.0
7378_8.txt;3;0;0;3;156;0.02;0.0;0.0
7399_10.txt;4;1;0;5;176;0.02;0.01;0.0
6712_9.txt;9;0;0;9;135;0.07;0.0;0.0
6563_7.txt;45;1;0;46;649;0.07;0.0;0.0
4969_7.txt;4;0;2;6;164;0.02;0.0;0.01
10379_10.txt;18;0;1;19;192;0.09;0.0;0.01
11521_10.txt;2;0;0;2;88;0.02;0.0;0.0
5778_9.txt;0;2;0;2;138;0.0;0.01;0.0
125_7.txt;11;2;0;13;420;0.03;0.0;0.0
12296_8.txt;32;3;7;42;954;0.03;0.0;0.01
11757_9.txt;13;1;0;14;89;0.15;0.01;0.0
11894_10.txt;2;0;0;2;153;0.01;0.0;0.0
594_9.txt;30;1;0;31;185;0.16;0.01;0.0
2060_8.txt;0;0;0;0;108;0.0;0.0;0.0
6675_8.txt;1;0;3;4;167;0.01;0.0;0.02
11357_10.txt;12;5;2;19;286;0.04;0.02;0.01
8178_8.txt;32;0;3;35;473;0.07;0.0;0.01
1389_8.txt;28;0;0;28;244;0.11;0.0;0.0
6245_10.txt;0;0;0;0;133;0.0;0.0;0.0
4001_8.txt;43;5;0;48;739;0.06;0.01;0.0
5635_7.txt;23;1;2;26;805;0.03;0.0;0.0
7472_9.txt;0;1;0;1;165;0.0;0.01;0.0
12163_8.txt;0;0;0;0;112;0.0;0.0;0.0
6550_10.txt;23;0;2;25;322;0.07;0.0;0.01
4341_8.txt;8;0;0;8;154;0.05;0.0;0.0
9230_8.txt;7;2;1;10;391;0.02;0.01;0.0
9132_10.txt;6;0;4;10;346;0.02;0.0;0.01
3493_8.txt;1;1;0;2;125;0.01;0.01;0.0
4956_10.txt;0;3;1;4;237;0.0;0.01;0.0
8020_8.txt;5;1;2;8;173;0.03;0.01;0.01
6265_7.txt;13;1;0;14;128;0.1;0.01;0.0
2382_7.txt;6;1;3;10;190;0.03;0.01;0.02
4898_7.txt;2;1;0;3;62;0.03;0.02;0.0
10434_10.txt;2;0;0;2;117;0.02;0.0;0.0
4958_10.txt;9;0;0;9;288;0.03;0.0;0.0
2073_7.txt;6;0;4;10;284;0.02;0.0;0.01
5776_10.txt;18;0;3;21;550;0.03;0.0;0.01
1893_10.txt;10;0;0;10;149;0.07;0.0;0.0
1198_10.txt;8;0;0;8;489;0.02;0.0;0.0
9113_8.txt;3;8;0;11;217;0.01;0.04;0.0
4289_7.txt;7;0;0;7;435;0.02;0.0;0.0
5694_9.txt;9;0;0;9;120;0.07;0.0;0.0
6935_8.txt;8;2;1;11;189;0.04;0.01;0.01
1889_10.txt;10;0;0;10;149;0.07;0.0;0.0
5511_8.txt;12;7;0;19;516;0.02;0.01;0.0
7760_10.txt;24;8;1;33;379;0.06;0.02;0.0
10924_10.txt;0;0;0;0;96;0.0;0.0;0.0
630_10.txt;0;0;0;0;148;0.0;0.0;0.0
9941_7.txt;0;4;0;4;191;0.0;0.02;0.0
10174_7.txt;4;1;0;5;313;0.01;0.0;0.0
5042_9.txt;3;0;1;4;169;0.02;0.0;0.01
10539_10.txt;1;0;0;1;146;0.01;0.0;0.0
6923_10.txt;20;0;1;21;139;0.14;0.0;0.01
5393_10.txt;12;0;1;13;178;0.07;0.0;0.01
4816_8.txt;3;2;2;7;277;0.01;0.01;0.01
3041_7.txt;35;6;10;51;1054;0.03;0.01;0.01
411_10.txt;3;1;0;4;405;0.01;0.0;0.0
762_9.txt;0;1;0;1;182;0.0;0.01;0.0
9642_10.txt;0;2;0;2;128;0.0;0.02;0.0
5154_8.txt;9;2;1;12;193;0.05;0.01;0.01
4686_10.txt;2;0;0;2;240;0.01;0.0;0.0
9623_7.txt;5;2;0;7;344;0.01;0.01;0.0
2199_7.txt;33;7;5;45;739;0.04;0.01;0.01
754_9.txt;3;0;0;3;534;0.01;0.0;0.0
4040_8.txt;0;0;0;0;158;0.0;0.0;0.0
2378_8.txt;0;1;0;1;131;0.0;0.01;0.0
9538_10.txt;3;1;10;14;464;0.01;0.0;0.02
3134_8.txt;6;0;0;6;126;0.05;0.0;0.0
12093_8.txt;18;2;4;24;448;0.04;0.0;0.01
8724_10.txt;1;0;0;1;67;0.01;0.0;0.0
9914_7.txt;12;3;6;21;257;0.05;0.01;0.02
9607_9.txt;11;0;0;11;322;0.03;0.0;0.0
8010_7.txt;6;4;7;17;250;0.02;0.02;0.03
2808_10.txt;6;0;0;6;214;0.03;0.0;0.0
11781_8.txt;0;0;0;0;145;0.0;0.0;0.0
6778_8.txt;27;0;1;28;262;0.1;0.0;0.0
1624_10.txt;12;0;0;12;153;0.08;0.0;0.0
9017_8.txt;8;0;0;8;142;0.06;0.0;0.0
10564_10.txt;2;0;2;4;55;0.04;0.0;0.04
7880_8.txt;21;0;4;25;202;0.1;0.0;0.02
11779_7.txt;0;4;0;4;306;0.0;0.01;0.0
8755_7.txt;7;2;1;10;534;0.01;0.0;0.0
10889_10.txt;16;0;0;16;179;0.09;0.0;0.0
11762_8.txt;11;0;1;12;251;0.04;0.0;0.0
1217_10.txt;0;0;0;0;170;0.0;0.0;0.0
766_10.txt;0;3;0;3;135;0.0;0.02;0.0
7388_10.txt;11;0;0;11;76;0.14;0.0;0.0
8797_8.txt;4;1;0;5;85;0.05;0.01;0.0
5541_9.txt;0;0;0;0;71;0.0;0.0;0.0
7742_8.txt;10;0;0;10;186;0.05;0.0;0.0
4509_10.txt;19;6;3;28;488;0.04;0.01;0.01
5969_10.txt;2;0;4;6;79;0.03;0.0;0.05
4028_10.txt;11;5;0;16;604;0.02;0.01;0.0
12266_9.txt;3;0;0;3;246;0.01;0.0;0.0
5846_10.txt;0;0;2;2;145;0.0;0.0;0.01
1550_10.txt;24;20;10;54;616;0.04;0.03;0.02
676_8.txt;17;0;0;17;395;0.04;0.0;0.0
7143_10.txt;2;0;0;2;124;0.02;0.0;0.0
934_9.txt;32;2;0;34;517;0.06;0.0;0.0
7534_10.txt;5;1;0;6;133;0.04;0.01;0.0
2731_10.txt;4;0;0;4;140;0.03;0.0;0.0
9422_9.txt;2;0;0;2;74;0.03;0.0;0.0
1094_9.txt;2;0;0;2;127;0.02;0.0;0.0
9238_10.txt;0;1;0;1;156;0.0;0.01;0.0
1537_9.txt;2;0;0;2;135;0.01;0.0;0.0
3617_8.txt;0;2;0;2;113;0.0;0.02;0.0
3568_7.txt;4;0;0;4;115;0.03;0.0;0.0
9324_7.txt;4;1;0;5;264;0.02;0.0;0.0
11367_10.txt;25;3;1;29;734;0.03;0.0;0.0
8912_10.txt;0;0;5;5;288;0.0;0.0;0.02
117_10.txt;22;4;2;28;382;0.06;0.01;0.01
5266_10.txt;0;0;2;2;82;0.0;0.0;0.02
2852_7.txt;6;0;1;7;289;0.02;0.0;0.0
3032_7.txt;2;0;0;2;55;0.04;0.0;0.0
145_10.txt;0;0;0;0;145;0.0;0.0;0.0
447_10.txt;0;0;2;2;139;0.0;0.0;0.01
11014_10.txt;3;0;0;3;90;0.03;0.0;0.0
9588_10.txt;1;1;0;2;165;0.01;0.01;0.0
1126_9.txt;1;0;0;1;162;0.01;0.0;0.0
12330_7.txt;0;0;6;6;424;0.0;0.0;0.01
7067_7.txt;14;1;3;18;168;0.08;0.01;0.02
3690_9.txt;6;3;1;10;378;0.02;0.01;0.0
9659_8.txt;0;0;0;0;141;0.0;0.0;0.0
7806_10.txt;7;2;0;9;192;0.04;0.01;0.0
6613_7.txt;0;0;1;1;273;0.0;0.0;0.0
788_8.txt;3;0;1;4;232;0.01;0.0;0.0
2752_7.txt;5;0;0;5;180;0.03;0.0;0.0
3257_9.txt;26;1;0;27;289;0.09;0.0;0.0
12214_10.txt;0;2;0;2;96;0.0;0.02;0.0
12146_7.txt;10;4;3;17;471;0.02;0.01;0.01
9608_10.txt;2;0;0;2;58;0.03;0.0;0.0
8929_8.txt;0;0;0;0;184;0.0;0.0;0.0
8754_8.txt;6;1;0;7;189;0.03;0.01;0.0
3650_10.txt;5;0;0;5;498;0.01;0.0;0.0
7512_8.txt;8;0;1;9;429;0.02;0.0;0.0
6260_10.txt;1;0;0;1;132;0.01;0.0;0.0
8585_8.txt;19;3;0;22;304;0.06;0.01;0.0
6911_10.txt;19;3;0;22;193;0.1;0.02;0.0
3096_10.txt;0;0;0;0;165;0.0;0.0;0.0
107_10.txt;6;0;0;6;134;0.04;0.0;0.0
10877_10.txt;9;0;0;9;176;0.05;0.0;0.0
11269_8.txt;1;3;0;4;272;0.0;0.01;0.0
9633_7.txt;7;0;3;10;217;0.03;0.0;0.01
339_10.txt;2;1;0;3;181;0.01;0.01;0.0
3023_7.txt;17;4;2;23;245;0.07;0.02;0.01
5027_10.txt;0;0;0;0;72;0.0;0.0;0.0
11141_10.txt;35;2;0;37;600;0.06;0.0;0.0
2558_10.txt;2;0;0;2;216;0.01;0.0;0.0
11814_7.txt;40;0;2;42;300;0.13;0.0;0.01
4283_10.txt;0;0;0;0;48;0.0;0.0;0.0
1406_8.txt;9;0;0;9;253;0.04;0.0;0.0
8830_8.txt;0;0;0;0;195;0.0;0.0;0.0
3612_7.txt;17;2;1;20;872;0.02;0.0;0.0
2959_10.txt;0;2;0;2;127;0.0;0.02;0.0
2937_10.txt;0;0;0;0;137;0.0;0.0;0.0
4705_7.txt;4;1;0;5;107;0.04;0.01;0.0
7069_8.txt;14;2;0;16;296;0.05;0.01;0.0
2567_9.txt;35;17;5;57;522;0.07;0.03;0.01
6580_8.txt;12;4;0;16;203;0.06;0.02;0.0
11138_10.txt;19;16;0;35;275;0.07;0.06;0.0
9247_10.txt;10;0;0;10;230;0.04;0.0;0.0
5913_10.txt;22;5;9;36;759;0.03;0.01;0.01
2450_9.txt;4;0;0;4;174;0.02;0.0;0.0
7670_8.txt;14;1;0;15;447;0.03;0.0;0.0
4717_8.txt;12;1;0;13;109;0.11;0.01;0.0
955_7.txt;0;0;0;0;61;0.0;0.0;0.0
2845_8.txt;27;8;0;35;819;0.03;0.01;0.0
184_8.txt;43;3;0;46;327;0.13;0.01;0.0
7034_10.txt;9;0;2;11;192;0.05;0.0;0.01
10511_7.txt;23;1;0;24;347;0.07;0.0;0.0
5242_7.txt;0;0;1;1;125;0.0;0.0;0.01
344_8.txt;10;0;0;10;121;0.08;0.0;0.0
4333_10.txt;5;0;0;5;131;0.04;0.0;0.0
2258_7.txt;8;2;0;10;177;0.05;0.01;0.0
8515_8.txt;2;0;0;2;88;0.02;0.0;0.0
1376_7.txt;30;1;10;41;933;0.03;0.0;0.01
11554_8.txt;35;0;2;37;632;0.06;0.0;0.0
11069_10.txt;2;0;0;2;142;0.01;0.0;0.0
8802_7.txt;10;2;0;12;232;0.04;0.01;0.0
9617_10.txt;39;0;0;39;447;0.09;0.0;0.0
8949_7.txt;3;0;0;3;84;0.04;0.0;0.0
6554_7.txt;7;0;0;7;200;0.04;0.0;0.0
3660_10.txt;10;1;0;11;253;0.04;0.0;0.0
3335_8.txt;0;0;0;0;293;0.0;0.0;0.0
5606_8.txt;2;0;0;2;183;0.01;0.0;0.0
8172_9.txt;0;0;0;0;476;0.0;0.0;0.0
12240_8.txt;4;0;1;5;171;0.02;0.0;0.01
4171_7.txt;4;0;0;4;677;0.01;0.0;0.0
9415_8.txt;10;0;2;12;756;0.01;0.0;0.0
7732_8.txt;5;0;0;5;75;0.07;0.0;0.0
4721_8.txt;2;0;0;2;82;0.02;0.0;0.0
1899_7.txt;32;0;2;34;334;0.1;0.0;0.01
435_8.txt;6;3;0;9;605;0.01;0.0;0.0
12097_7.txt;10;0;0;10;272;0.04;0.0;0.0
6112_7.txt;0;0;0;0;143;0.0;0.0;0.0
4595_10.txt;7;0;0;7;145;0.05;0.0;0.0
4564_10.txt;11;0;0;11;286;0.04;0.0;0.0
3551_8.txt;65;7;6;78;569;0.11;0.01;0.01
8248_9.txt;18;0;0;18;264;0.07;0.0;0.0
2063_8.txt;0;0;0;0;42;0.0;0.0;0.0
5544_7.txt;5;2;0;7;288;0.02;0.01;0.0
6323_7.txt;20;0;0;20;272;0.07;0.0;0.0
1986_10.txt;6;0;0;6;180;0.03;0.0;0.0
5175_10.txt;0;0;0;0;60;0.0;0.0;0.0
3725_8.txt;2;0;1;3;161;0.01;0.0;0.01
9124_10.txt;6;0;0;6;129;0.05;0.0;0.0
815_7.txt;12;0;2;14;730;0.02;0.0;0.0
8589_7.txt;18;0;3;21;382;0.05;0.0;0.01
9402_7.txt;2;1;0;3;189;0.01;0.01;0.0
10343_7.txt;20;0;0;20;218;0.09;0.0;0.0
9862_9.txt;2;0;2;4;286;0.01;0.0;0.01
7446_8.txt;0;6;0;6;169;0.0;0.04;0.0
10178_10.txt;6;0;0;6;191;0.03;0.0;0.0
9892_8.txt;0;2;0;2;197;0.0;0.01;0.0
11108_10.txt;9;0;0;9;223;0.04;0.0;0.0
10428_10.txt;0;1;1;2;147;0.0;0.01;0.01
4389_10.txt;20;0;0;20;310;0.06;0.0;0.0
2247_10.txt;6;0;0;6;163;0.04;0.0;0.0
10577_10.txt;2;0;0;2;129;0.02;0.0;0.0
6259_8.txt;0;0;0;0;123;0.0;0.0;0.0
9776_8.txt;14;4;6;24;616;0.02;0.01;0.01
2565_9.txt;1;2;0;3;159;0.01;0.01;0.0
7373_8.txt;16;3;5;24;596;0.03;0.01;0.01
7592_9.txt;10;2;0;12;403;0.02;0.0;0.0
11694_7.txt;25;2;0;27;543;0.05;0.0;0.0
8712_8.txt;16;4;4;24;813;0.02;0.0;0.0
1487_9.txt;5;1;0;6;126;0.04;0.01;0.0
36_10.txt;2;0;0;2;42;0.05;0.0;0.0
7417_10.txt;0;0;0;0;143;0.0;0.0;0.0
4004_9.txt;2;0;0;2;126;0.02;0.0;0.0
12358_7.txt;0;0;0;0;129;0.0;0.0;0.0
6607_9.txt;0;1;5;6;235;0.0;0.0;0.02
6857_10.txt;5;2;1;8;156;0.03;0.01;0.01
5306_7.txt;4;0;1;5;56;0.07;0.0;0.02
1685_10.txt;4;0;2;6;318;0.01;0.0;0.01
8716_10.txt;0;0;0;0;36;0.0;0.0;0.0
9313_9.txt;2;2;0;4;184;0.01;0.01;0.0
1216_10.txt;3;0;2;5;374;0.01;0.0;0.01
10196_10.txt;2;0;0;2;109;0.02;0.0;0.0
8773_8.txt;46;4;5;55;385;0.12;0.01;0.01
4674_7.txt;10;0;0;10;117;0.09;0.0;0.0
6582_7.txt;26;1;0;27;325;0.08;0.0;0.0
3621_8.txt;2;0;0;2;50;0.04;0.0;0.0
961_9.txt;2;5;1;8;479;0.0;0.01;0.0
12476_10.txt;0;0;0;0;51;0.0;0.0;0.0
1475_8.txt;23;0;1;24;1119;0.02;0.0;0.0
10450_10.txt;8;0;0;8;162;0.05;0.0;0.0
9086_7.txt;0;0;0;0;193;0.0;0.0;0.0
11642_10.txt;4;0;0;4;491;0.01;0.0;0.0
7325_9.txt;9;0;0;9;125;0.07;0.0;0.0
6875_10.txt;1;1;0;2;175;0.01;0.01;0.0
3468_10.txt;7;0;0;7;155;0.05;0.0;0.0
1853_8.txt;0;0;0;0;95;0.0;0.0;0.0
8527_8.txt;1;2;0;3;137;0.01;0.01;0.0
10008_7.txt;12;0;0;12;375;0.03;0.0;0.0
11307_10.txt;3;1;0;4;159;0.02;0.01;0.0
120_8.txt;6;0;0;6;363;0.02;0.0;0.0
10045_10.txt;6;0;1;7;515;0.01;0.0;0.0
5122_9.txt;10;2;4;16;173;0.06;0.01;0.02
2291_7.txt;2;0;0;2;129;0.02;0.0;0.0
4252_9.txt;8;0;0;8;65;0.12;0.0;0.0
10608_10.txt;2;0;0;2;66;0.03;0.0;0.0
11431_10.txt;0;4;0;4;238;0.0;0.02;0.0
2106_10.txt;8;0;0;8;148;0.05;0.0;0.0
12142_9.txt;40;3;2;45;605;0.07;0.0;0.0
8770_7.txt;13;0;0;13;186;0.07;0.0;0.0
703_10.txt;1;0;0;1;153;0.01;0.0;0.0
408_10.txt;0;0;2;2;115;0.0;0.0;0.02
2744_10.txt;19;2;0;21;668;0.03;0.0;0.0
1442_7.txt;35;8;4;47;835;0.04;0.01;0.0
10366_10.txt;7;1;0;8;185;0.04;0.01;0.0
5718_7.txt;7;0;0;7;310;0.02;0.0;0.0
11101_10.txt;6;0;1;7;181;0.03;0.0;0.01
7409_10.txt;2;1;0;3;107;0.02;0.01;0.0
112_10.txt;7;0;0;7;117;0.06;0.0;0.0
3846_10.txt;5;0;0;5;323;0.02;0.0;0.0
7636_8.txt;0;0;0;0;353;0.0;0.0;0.0
7677_10.txt;4;1;0;5;171;0.02;0.01;0.0
8311_9.txt;4;0;0;4;84;0.05;0.0;0.0
4187_7.txt;6;1;0;7;179;0.03;0.01;0.0
533_10.txt;28;3;2;33;593;0.05;0.01;0.0
7379_9.txt;0;1;0;1;67;0.0;0.01;0.0
7745_8.txt;3;0;0;3;220;0.01;0.0;0.0
8356_10.txt;0;1;1;2;183;0.0;0.01;0.01
10647_8.txt;1;0;0;1;193;0.01;0.0;0.0
9119_10.txt;1;0;0;1;122;0.01;0.0;0.0
4781_8.txt;5;0;1;6;96;0.05;0.0;0.01
9505_10.txt;7;0;0;7;54;0.13;0.0;0.0
4811_8.txt;74;13;6;93;1124;0.07;0.01;0.01
1006_8.txt;12;1;0;13;382;0.03;0.0;0.0
6628_7.txt;9;5;0;14;470;0.02;0.01;0.0
6818_10.txt;6;0;0;6;53;0.11;0.0;0.0
4768_10.txt;1;0;0;1;143;0.01;0.0;0.0
6142_9.txt;16;3;0;19;192;0.08;0.02;0.0
2280_7.txt;4;2;0;6;301;0.01;0.01;0.0
2210_9.txt;15;0;0;15;384;0.04;0.0;0.0
11077_8.txt;11;2;2;15;349;0.03;0.01;0.01
634_8.txt;11;3;0;14;281;0.04;0.01;0.0
9066_8.txt;0;0;0;0;294;0.0;0.0;0.0
2306_10.txt;7;2;2;11;275;0.03;0.01;0.01
9482_7.txt;14;4;1;19;177;0.08;0.02;0.01
11025_7.txt;19;2;0;21;306;0.06;0.01;0.0
1860_9.txt;6;0;0;6;76;0.08;0.0;0.0
1498_8.txt;10;0;0;10;235;0.04;0.0;0.0
5653_10.txt;0;1;0;1;137;0.0;0.01;0.0
6166_10.txt;12;3;3;18;335;0.04;0.01;0.01
5324_10.txt;11;3;5;19;850;0.01;0.0;0.01
10317_7.txt;9;0;2;11;236;0.04;0.0;0.01
9005_8.txt;0;0;0;0;50;0.0;0.0;0.0
2158_10.txt;6;2;1;9;273;0.02;0.01;0.0
4172_10.txt;1;0;0;1;40;0.03;0.0;0.0
9991_10.txt;7;0;0;7;193;0.04;0.0;0.0
6992_10.txt;9;0;3;12;242;0.04;0.0;0.01
8910_10.txt;0;2;0;2;273;0.0;0.01;0.0
5965_10.txt;5;0;1;6;176;0.03;0.0;0.01
7903_10.txt;1;0;0;1;313;0.0;0.0;0.0
1790_9.txt;0;0;0;0;251;0.0;0.0;0.0
9877_8.txt;20;2;3;25;226;0.09;0.01;0.01
10610_8.txt;6;0;0;6;151;0.04;0.0;0.0
7613_9.txt;0;0;0;0;136;0.0;0.0;0.0
1724_10.txt;7;2;0;9;479;0.01;0.0;0.0
4353_9.txt;5;2;0;7;214;0.02;0.01;0.0
6631_7.txt;6;0;0;6;162;0.04;0.0;0.0
10488_10.txt;6;0;0;6;176;0.03;0.0;0.0
2636_9.txt;19;2;3;24;261;0.07;0.01;0.01
8701_8.txt;8;0;0;8;339;0.02;0.0;0.0
6340_10.txt;54;0;0;54;617;0.09;0.0;0.0
9523_10.txt;19;3;8;30;277;0.07;0.01;0.03
1778_10.txt;1;0;0;1;210;0.0;0.0;0.0
9077_9.txt;8;0;1;9;263;0.03;0.0;0.0
4708_7.txt;18;0;0;18;183;0.1;0.0;0.0
83_10.txt;17;1;1;19;259;0.07;0.0;0.0
7865_8.txt;4;0;0;4;171;0.02;0.0;0.0
1651_10.txt;5;2;1;8;147;0.03;0.01;0.01
2075_8.txt;2;3;0;5;180;0.01;0.02;0.0
4052_8.txt;9;4;3;16;544;0.02;0.01;0.01
8958_10.txt;10;4;0;14;136;0.07;0.03;0.0
1288_8.txt;17;0;1;18;518;0.03;0.0;0.0
4228_10.txt;2;1;0;3;107;0.02;0.01;0.0
9459_8.txt;14;0;0;14;216;0.06;0.0;0.0
5085_7.txt;36;2;3;41;904;0.04;0.0;0.0
12315_9.txt;0;1;0;1;107;0.0;0.01;0.0
9359_8.txt;7;0;0;7;184;0.04;0.0;0.0
10181_8.txt;9;1;4;14;211;0.04;0.0;0.02
12255_10.txt;19;0;0;19;284;0.07;0.0;0.0
12124_8.txt;23;1;2;26;478;0.05;0.0;0.0
7864_8.txt;8;0;0;8;408;0.02;0.0;0.0
9560_9.txt;14;2;0;16;489;0.03;0.0;0.0
4713_8.txt;29;3;0;32;267;0.11;0.01;0.0
10688_9.txt;4;1;0;5;155;0.03;0.01;0.0
4889_10.txt;0;0;0;0;66;0.0;0.0;0.0
578_10.txt;10;1;0;11;533;0.02;0.0;0.0
813_10.txt;54;7;5;66;746;0.07;0.01;0.01
6816_7.txt;23;0;0;23;546;0.04;0.0;0.0
10342_7.txt;6;0;0;6;166;0.04;0.0;0.0
1061_10.txt;8;2;0;10;96;0.08;0.02;0.0
7789_10.txt;2;0;0;2;38;0.05;0.0;0.0
11664_9.txt;25;1;3;29;769;0.03;0.0;0.0
3611_10.txt;2;0;0;2;142;0.01;0.0;0.0
5728_10.txt;0;0;0;0;172;0.0;0.0;0.0
1525_9.txt;14;4;1;19;550;0.03;0.01;0.0
11682_7.txt;28;0;1;29;433;0.06;0.0;0.0
6928_9.txt;29;2;2;33;452;0.06;0.0;0.0
11476_10.txt;0;0;0;0;256;0.0;0.0;0.0
7392_8.txt;0;0;0;0;141;0.0;0.0;0.0
9643_10.txt;6;0;0;6;129;0.05;0.0;0.0
15_7.txt;7;0;4;11;266;0.03;0.0;0.02
953_10.txt;11;1;0;12;208;0.05;0.0;0.0
12029_10.txt;11;0;0;11;88;0.13;0.0;0.0
7076_10.txt;6;0;0;6;201;0.03;0.0;0.0
11935_7.txt;45;0;12;57;579;0.08;0.0;0.02
4806_8.txt;16;3;0;19;229;0.07;0.01;0.0
9811_7.txt;35;12;2;49;443;0.08;0.03;0.0
4254_9.txt;0;0;0;0;45;0.0;0.0;0.0
7582_8.txt;11;0;0;11;158;0.07;0.0;0.0
10319_7.txt;11;0;0;11;395;0.03;0.0;0.0
799_8.txt;15;0;0;15;157;0.1;0.0;0.0
4074_10.txt;36;12;3;51;1138;0.03;0.01;0.0
4092_10.txt;0;2;0;2;136;0.0;0.01;0.0
8017_9.txt;51;4;2;57;283;0.18;0.01;0.01
6230_8.txt;19;1;5;25;351;0.05;0.0;0.01
3731_10.txt;0;1;2;3;55;0.0;0.02;0.04
8726_9.txt;5;0;1;6;295;0.02;0.0;0.0
8642_8.txt;16;1;0;17;246;0.07;0.0;0.0
264_7.txt;19;0;1;20;290;0.07;0.0;0.0
10499_10.txt;2;0;1;3;55;0.04;0.0;0.02
9467_10.txt;10;0;0;10;156;0.06;0.0;0.0
1930_10.txt;2;0;0;2;160;0.01;0.0;0.0
8918_10.txt;3;0;0;3;111;0.03;0.0;0.0
186_8.txt;17;0;0;17;223;0.08;0.0;0.0
5444_8.txt;5;0;2;7;174;0.03;0.0;0.01
12373_7.txt;12;0;2;14;213;0.06;0.0;0.01
5437_10.txt;6;6;1;13;206;0.03;0.03;0.0
9705_10.txt;16;6;4;26;959;0.02;0.01;0.0
6834_10.txt;2;3;0;5;204;0.01;0.01;0.0
5113_10.txt;0;0;0;0;86;0.0;0.0;0.0
9909_7.txt;12;1;0;13;268;0.04;0.0;0.0
7557_9.txt;3;1;0;4;239;0.01;0.0;0.0
7858_10.txt;9;0;1;10;158;0.06;0.0;0.01
1844_8.txt;13;0;1;14;321;0.04;0.0;0.0
6031_7.txt;7;4;4;15;383;0.02;0.01;0.01
11170_10.txt;0;0;0;0;193;0.0;0.0;0.0
4749_8.txt;4;2;0;6;218;0.02;0.01;0.0
2092_10.txt;6;1;0;7;205;0.03;0.0;0.0
4727_7.txt;4;0;1;5;159;0.03;0.0;0.01
5143_8.txt;2;0;0;2;292;0.01;0.0;0.0
11606_10.txt;0;0;0;0;60;0.0;0.0;0.0
277_8.txt;0;0;0;0;485;0.0;0.0;0.0
1876_10.txt;16;0;0;16;144;0.11;0.0;0.0
1756_7.txt;11;0;0;11;211;0.05;0.0;0.0
8119_10.txt;0;0;0;0;71;0.0;0.0;0.0
6532_8.txt;9;0;1;10;327;0.03;0.0;0.0
10285_10.txt;42;0;0;42;672;0.06;0.0;0.0
11347_10.txt;0;0;0;0;49;0.0;0.0;0.0
850_8.txt;15;1;0;16;141;0.11;0.01;0.0
11863_10.txt;13;0;0;13;216;0.06;0.0;0.0
646_9.txt;6;0;0;6;228;0.03;0.0;0.0
6321_7.txt;36;2;0;38;509;0.07;0.0;0.0
148_9.txt;2;0;0;2;127;0.02;0.0;0.0
11490_9.txt;0;0;0;0;181;0.0;0.0;0.0
8739_9.txt;0;1;0;1;217;0.0;0.0;0.0
11261_9.txt;4;0;0;4;82;0.05;0.0;0.0
7051_10.txt;13;1;0;14;271;0.05;0.0;0.0
121_10.txt;4;0;0;4;235;0.02;0.0;0.0
3792_8.txt;0;0;0;0;78;0.0;0.0;0.0
8305_7.txt;7;0;0;7;217;0.03;0.0;0.0
11627_8.txt;5;1;0;6;156;0.03;0.01;0.0
1291_10.txt;0;0;0;0;90;0.0;0.0;0.0
8561_10.txt;24;0;2;26;166;0.14;0.0;0.01
8653_10.txt;6;0;1;7;392;0.02;0.0;0.0
708_8.txt;0;0;0;0;119;0.0;0.0;0.0
462_8.txt;3;3;0;6;136;0.02;0.02;0.0
9224_10.txt;9;0;0;9;174;0.05;0.0;0.0
10132_9.txt;22;0;0;22;198;0.11;0.0;0.0
7972_10.txt;0;0;0;0;180;0.0;0.0;0.0
11137_7.txt;14;3;7;24;202;0.07;0.01;0.03
7647_7.txt;14;0;0;14;423;0.03;0.0;0.0
3338_7.txt;1;0;4;5;131;0.01;0.0;0.03
7365_7.txt;6;0;0;6;144;0.04;0.0;0.0
8469_7.txt;2;0;0;2;115;0.02;0.0;0.0
8861_9.txt;16;1;0;17;328;0.05;0.0;0.0
878_7.txt;0;0;0;0;173;0.0;0.0;0.0
11273_9.txt;27;1;0;28;570;0.05;0.0;0.0
4901_9.txt;5;0;0;5;117;0.04;0.0;0.0
2220_9.txt;2;0;0;2;569;0.0;0.0;0.0
9998_9.txt;2;0;0;2;133;0.02;0.0;0.0
1675_9.txt;31;0;2;33;492;0.06;0.0;0.0
11732_7.txt;3;2;0;5;303;0.01;0.01;0.0
9195_10.txt;11;0;0;11;388;0.03;0.0;0.0
2054_9.txt;43;10;3;56;606;0.07;0.02;0.0
11105_10.txt;32;6;0;38;603;0.05;0.01;0.0
5181_10.txt;4;0;0;4;151;0.03;0.0;0.0
2226_10.txt;1;0;1;2;371;0.0;0.0;0.0
4883_10.txt;0;0;0;0;130;0.0;0.0;0.0
5314_10.txt;0;0;0;0;141;0.0;0.0;0.0
522_8.txt;6;0;0;6;93;0.06;0.0;0.0
10878_7.txt;0;1;0;1;181;0.0;0.01;0.0
9813_8.txt;6;1;0;7;131;0.05;0.01;0.0
7948_7.txt;9;5;0;14;547;0.02;0.01;0.0
3585_9.txt;0;0;0;0;180;0.0;0.0;0.0
8644_7.txt;6;0;0;6;459;0.01;0.0;0.0
3124_9.txt;10;1;2;13;456;0.02;0.0;0.0
9550_7.txt;0;1;0;1;126;0.0;0.01;0.0
5506_10.txt;2;2;1;5;152;0.01;0.01;0.01
2071_9.txt;9;1;0;10;133;0.07;0.01;0.0
6092_8.txt;0;0;2;2;191;0.0;0.0;0.01
7132_10.txt;9;4;0;13;139;0.06;0.03;0.0
3252_9.txt;12;2;1;15;280;0.04;0.01;0.0
10449_9.txt;0;1;0;1;166;0.0;0.01;0.0
3547_8.txt;23;1;0;24;165;0.14;0.01;0.0
3300_9.txt;16;0;0;16;191;0.08;0.0;0.0
2411_9.txt;1;1;0;2;257;0.0;0.0;0.0
10723_8.txt;0;2;2;4;261;0.0;0.01;0.01
11063_10.txt;11;0;0;11;179;0.06;0.0;0.0
10252_9.txt;2;0;0;2;279;0.01;0.0;0.0
1698_10.txt;0;0;0;0;55;0.0;0.0;0.0
10012_8.txt;1;0;0;1;163;0.01;0.0;0.0
319_9.txt;0;0;0;0;36;0.0;0.0;0.0
4581_10.txt;23;17;11;51;547;0.04;0.03;0.02
1250_10.txt;0;1;2;3;392;0.0;0.0;0.01
10923_9.txt;0;2;0;2;141;0.0;0.01;0.0
6624_9.txt;0;6;2;8;174;0.0;0.03;0.01
7188_8.txt;9;0;2;11;269;0.03;0.0;0.01
3816_7.txt;10;4;0;14;306;0.03;0.01;0.0
12173_8.txt;5;0;2;7;128;0.04;0.0;0.02
7969_10.txt;0;0;0;0;83;0.0;0.0;0.0
3297_10.txt;7;1;0;8;155;0.05;0.01;0.0
9455_9.txt;18;2;3;23;778;0.02;0.0;0.0
11180_7.txt;28;1;2;31;785;0.04;0.0;0.0
1410_9.txt;7;3;2;12;184;0.04;0.02;0.01
5311_7.txt;0;0;0;0;120;0.0;0.0;0.0
12084_8.txt;9;1;2;12;253;0.04;0.0;0.01
8812_10.txt;0;3;0;3;281;0.0;0.01;0.0
12139_10.txt;11;0;0;11;203;0.05;0.0;0.0
2530_8.txt;9;0;0;9;137;0.07;0.0;0.0
7473_9.txt;3;0;0;3;103;0.03;0.0;0.0
3082_10.txt;0;1;1;2;144;0.0;0.01;0.01
5006_10.txt;0;0;0;0;194;0.0;0.0;0.0
7085_9.txt;26;3;0;29;384;0.07;0.01;0.0
1634_7.txt;8;0;1;9;182;0.04;0.0;0.01
12215_10.txt;0;0;0;0;153;0.0;0.0;0.0
5830_8.txt;8;0;0;8;291;0.03;0.0;0.0
877_8.txt;1;1;0;2;92;0.01;0.01;0.0
7172_10.txt;5;20;0;25;695;0.01;0.03;0.0
2675_9.txt;0;1;0;1;50;0.0;0.02;0.0
11070_9.txt;0;0;0;0;121;0.0;0.0;0.0
7216_10.txt;5;0;0;5;134;0.04;0.0;0.0
3897_10.txt;2;1;1;4;256;0.01;0.0;0.0
11485_10.txt;0;0;0;0;142;0.0;0.0;0.0
8498_9.txt;2;0;0;2;84;0.02;0.0;0.0
1518_8.txt;48;0;0;48;1082;0.04;0.0;0.0
9202_8.txt;9;0;0;9;208;0.04;0.0;0.0
2049_7.txt;1;0;0;1;94;0.01;0.0;0.0
10220_7.txt;5;0;0;5;349;0.01;0.0;0.0
7886_10.txt;9;0;0;9;185;0.05;0.0;0.0
2038_7.txt;0;0;0;0;143;0.0;0.0;0.0
9331_9.txt;5;0;0;5;136;0.04;0.0;0.0
9092_7.txt;0;3;0;3;136;0.0;0.02;0.0
10663_8.txt;31;0;4;35;572;0.05;0.0;0.01
3837_9.txt;16;2;0;18;268;0.06;0.01;0.0
7135_10.txt;3;0;0;3;96;0.03;0.0;0.0
6193_7.txt;41;3;3;47;676;0.06;0.0;0.0
11103_10.txt;28;0;0;28;294;0.1;0.0;0.0
9367_9.txt;11;0;0;11;303;0.04;0.0;0.0
5545_8.txt;1;0;0;1;274;0.0;0.0;0.0
5127_10.txt;1;2;0;3;174;0.01;0.01;0.0
3763_8.txt;2;0;0;2;188;0.01;0.0;0.0
6129_7.txt;6;0;2;8;402;0.01;0.0;0.0
5260_10.txt;2;0;0;2;147;0.01;0.0;0.0
5734_9.txt;7;0;0;7;247;0.03;0.0;0.0
9461_7.txt;16;0;1;17;242;0.07;0.0;0.0
8889_8.txt;2;0;0;2;172;0.01;0.0;0.0
10775_8.txt;0;2;0;2;77;0.0;0.03;0.0
243_10.txt;12;0;0;12;119;0.1;0.0;0.0
9949_9.txt;0;0;0;0;144;0.0;0.0;0.0
6284_7.txt;28;0;6;34;945;0.03;0.0;0.01
3589_8.txt;6;0;0;6;167;0.04;0.0;0.0
10007_7.txt;44;3;0;47;475;0.09;0.01;0.0
2825_9.txt;15;1;0;16;406;0.04;0.0;0.0
2706_9.txt;6;1;0;7;152;0.04;0.01;0.0
7511_9.txt;20;6;1;27;1136;0.02;0.01;0.0
3345_9.txt;7;0;2;9;347;0.02;0.0;0.01
7875_7.txt;20;1;0;21;520;0.04;0.0;0.0
6721_10.txt;10;2;0;12;400;0.03;0.01;0.0
12074_10.txt;9;1;0;10;312;0.03;0.0;0.0
3935_9.txt;8;0;0;8;179;0.04;0.0;0.0
11719_7.txt;15;1;0;16;267;0.06;0.0;0.0
5184_9.txt;24;3;0;27;192;0.13;0.02;0.0
5493_10.txt;10;6;4;20;463;0.02;0.01;0.01
3827_10.txt;6;0;0;6;153;0.04;0.0;0.0
10391_10.txt;3;3;0;6;160;0.02;0.02;0.0
6521_7.txt;5;1;0;6;181;0.03;0.01;0.0
543_10.txt;3;0;0;3;91;0.03;0.0;0.0
5331_10.txt;0;0;0;0;171;0.0;0.0;0.0
12320_8.txt;28;0;3;31;429;0.07;0.0;0.01
9125_10.txt;0;0;0;0;43;0.0;0.0;0.0
1563_10.txt;11;2;2;15;158;0.07;0.01;0.01
10690_10.txt;3;0;0;3;54;0.06;0.0;0.0
5412_9.txt;3;0;0;3;152;0.02;0.0;0.0
12244_7.txt;28;4;4;36;495;0.06;0.01;0.01
10939_8.txt;0;0;0;0;178;0.0;0.0;0.0
5685_10.txt;3;0;1;4;136;0.02;0.0;0.01
3170_9.txt;4;0;2;6;141;0.03;0.0;0.01
7444_10.txt;0;0;0;0;59;0.0;0.0;0.0
1187_10.txt;14;7;6;27;265;0.05;0.03;0.02
9834_10.txt;2;0;0;2;92;0.02;0.0;0.0
5455_7.txt;4;2;0;6;158;0.03;0.01;0.0
410_8.txt;0;1;0;1;289;0.0;0.0;0.0
987_8.txt;0;0;0;0;48;0.0;0.0;0.0
6333_8.txt;0;0;0;0;158;0.0;0.0;0.0
4159_9.txt;2;0;0;2;123;0.02;0.0;0.0
4559_10.txt;2;0;0;2;343;0.01;0.0;0.0
8824_8.txt;3;0;0;3;131;0.02;0.0;0.0
11267_10.txt;12;3;5;20;163;0.07;0.02;0.03
9350_10.txt;13;0;0;13;189;0.07;0.0;0.0
8224_8.txt;9;0;0;9;153;0.06;0.0;0.0
6824_10.txt;28;6;0;34;1115;0.03;0.01;0.0
6130_7.txt;0;0;0;0;91;0.0;0.0;0.0
9038_8.txt;11;0;0;11;143;0.08;0.0;0.0
12434_10.txt;5;0;0;5;122;0.04;0.0;0.0
560_8.txt;18;5;0;23;178;0.1;0.03;0.0
10899_10.txt;5;0;0;5;163;0.03;0.0;0.0
261_8.txt;0;0;0;0;73;0.0;0.0;0.0
3689_8.txt;32;2;0;34;516;0.06;0.0;0.0
162_8.txt;0;1;0;1;119;0.0;0.01;0.0
6188_9.txt;41;2;0;43;287;0.14;0.01;0.0
7779_7.txt;5;1;0;6;215;0.02;0.0;0.0
9023_10.txt;0;1;0;1;92;0.0;0.01;0.0
10756_8.txt;0;0;0;0;53;0.0;0.0;0.0
1252_8.txt;3;4;0;7;184;0.02;0.02;0.0
10192_8.txt;5;0;0;5;168;0.03;0.0;0.0
12217_10.txt;5;6;0;11;413;0.01;0.01;0.0
6686_9.txt;0;0;0;0;169;0.0;0.0;0.0
11502_10.txt;1;0;0;1;249;0.0;0.0;0.0
5102_7.txt;7;1;2;10;172;0.04;0.01;0.01
7929_10.txt;31;1;4;36;499;0.06;0.0;0.01
11306_8.txt;16;0;0;16;491;0.03;0.0;0.0
3404_8.txt;29;0;6;35;470;0.06;0.0;0.01
6804_7.txt;14;4;1;19;285;0.05;0.01;0.0
1440_7.txt;5;0;0;5;147;0.03;0.0;0.0
3366_10.txt;4;0;0;4;173;0.02;0.0;0.0
11543_8.txt;8;0;0;8;128;0.06;0.0;0.0
1562_10.txt;12;0;0;12;185;0.06;0.0;0.0
3910_10.txt;2;1;1;4;234;0.01;0.0;0.0
8384_7.txt;0;0;0;0;213;0.0;0.0;0.0
4677_9.txt;16;0;0;16;176;0.09;0.0;0.0
3620_10.txt;3;1;0;4;132;0.02;0.01;0.0
11404_10.txt;34;9;4;47;759;0.04;0.01;0.01
8240_9.txt;5;1;1;7;156;0.03;0.01;0.01
7548_8.txt;0;0;2;2;426;0.0;0.0;0.0
11505_7.txt;43;3;3;49;827;0.05;0.0;0.0
10476_9.txt;8;0;0;8;219;0.04;0.0;0.0
2585_7.txt;29;0;1;30;400;0.07;0.0;0.0
9155_10.txt;0;0;0;0;182;0.0;0.0;0.0
12135_10.txt;36;2;7;45;716;0.05;0.0;0.01
4722_8.txt;0;0;0;0;172;0.0;0.0;0.0
4279_10.txt;6;4;0;10;216;0.03;0.02;0.0
10281_7.txt;26;0;0;26;741;0.04;0.0;0.0
752_7.txt;7;2;0;9;245;0.03;0.01;0.0
4878_10.txt;11;1;2;14;473;0.02;0.0;0.0
5865_9.txt;3;3;0;6;147;0.02;0.02;0.0
232_10.txt;0;0;0;0;143;0.0;0.0;0.0
2425_7.txt;2;0;1;3;171;0.01;0.0;0.01
11417_7.txt;9;0;0;9;282;0.03;0.0;0.0
5163_7.txt;23;2;0;25;607;0.04;0.0;0.0
1963_8.txt;2;0;0;2;257;0.01;0.0;0.0
6359_10.txt;7;0;0;7;147;0.05;0.0;0.0
1744_10.txt;8;3;0;11;159;0.05;0.02;0.0
3279_8.txt;8;0;0;8;333;0.02;0.0;0.0
11510_10.txt;15;0;1;16;665;0.02;0.0;0.0
8600_8.txt;10;0;1;11;306;0.03;0.0;0.0
5453_8.txt;4;0;0;4;68;0.06;0.0;0.0
1267_7.txt;7;0;0;7;128;0.05;0.0;0.0
8948_7.txt;10;0;0;10;127;0.08;0.0;0.0
801_8.txt;8;0;0;8;204;0.04;0.0;0.0
1617_8.txt;19;2;1;22;207;0.09;0.01;0.0
2203_8.txt;7;2;0;9;189;0.04;0.01;0.0
11309_9.txt;14;4;0;18;163;0.09;0.02;0.0
11811_8.txt;31;0;3;34;376;0.08;0.0;0.01
11386_8.txt;91;23;11;125;1074;0.08;0.02;0.01
9492_7.txt;12;0;0;12;173;0.07;0.0;0.0
10288_10.txt;2;0;0;2;44;0.05;0.0;0.0
8309_7.txt;4;0;0;4;141;0.03;0.0;0.0
12076_8.txt;7;1;0;8;156;0.04;0.01;0.0
3824_9.txt;2;1;0;3;627;0.0;0.0;0.0
7054_9.txt;2;0;0;2;140;0.01;0.0;0.0
12246_9.txt;13;0;2;15;214;0.06;0.0;0.01
7561_9.txt;6;1;0;7;164;0.04;0.01;0.0
3261_9.txt;7;1;0;8;117;0.06;0.01;0.0
7529_10.txt;13;1;2;16;250;0.05;0.0;0.01
7295_10.txt;2;0;0;2;131;0.02;0.0;0.0
3759_8.txt;23;0;2;25;254;0.09;0.0;0.01
5982_9.txt;12;1;2;15;274;0.04;0.0;0.01
8229_10.txt;4;0;0;4;131;0.03;0.0;0.0
10922_10.txt;1;2;3;6;219;0.0;0.01;0.01
11821_10.txt;37;0;2;39;524;0.07;0.0;0.0
12329_10.txt;0;0;0;0;73;0.0;0.0;0.0
424_8.txt;6;2;0;8;150;0.04;0.01;0.0
811_10.txt;14;0;0;14;272;0.05;0.0;0.0
2045_9.txt;10;1;12;23;649;0.02;0.0;0.02
2016_7.txt;63;7;5;75;608;0.1;0.01;0.01
9995_10.txt;0;0;0;0;106;0.0;0.0;0.0
12202_9.txt;29;5;3;37;524;0.06;0.01;0.01
6476_10.txt;4;0;0;4;245;0.02;0.0;0.0
3497_10.txt;2;0;0;2;128;0.02;0.0;0.0
6717_7.txt;0;0;0;0;400;0.0;0.0;0.0
5023_10.txt;0;0;0;0;79;0.0;0.0;0.0
9528_9.txt;54;2;1;57;592;0.09;0.0;0.0
1483_9.txt;0;1;0;1;145;0.0;0.01;0.0
12026_8.txt;18;0;0;18;214;0.08;0.0;0.0
1857_10.txt;4;0;0;4;64;0.06;0.0;0.0
11250_9.txt;22;3;2;27;589;0.04;0.01;0.0
812_10.txt;38;3;8;49;876;0.04;0.0;0.01
12162_8.txt;36;2;0;38;487;0.07;0.0;0.0
5486_10.txt;6;3;0;9;186;0.03;0.02;0.0
9793_7.txt;4;0;0;4;131;0.03;0.0;0.0
7282_9.txt;2;0;0;2;408;0.0;0.0;0.0
11094_9.txt;8;1;0;9;172;0.05;0.01;0.0
7390_10.txt;0;0;0;0;43;0.0;0.0;0.0
8752_9.txt;10;7;0;17;338;0.03;0.02;0.0
7798_10.txt;4;0;0;4;174;0.02;0.0;0.0
2715_8.txt;1;3;3;7;250;0.0;0.01;0.01
4570_10.txt;10;1;0;11;180;0.06;0.01;0.0
8138_10.txt;9;0;0;9;198;0.05;0.0;0.0
10865_7.txt;0;2;0;2;143;0.0;0.01;0.0
2639_7.txt;12;2;4;18;521;0.02;0.0;0.01
2873_10.txt;10;0;4;14;289;0.03;0.0;0.01
8345_7.txt;4;0;0;4;148;0.03;0.0;0.0
1020_10.txt;3;1;0;4;695;0.0;0.0;0.0
5787_9.txt;0;0;0;0;161;0.0;0.0;0.0
8037_10.txt;2;0;0;2;158;0.01;0.0;0.0
9456_8.txt;8;0;0;8;303;0.03;0.0;0.0
5895_10.txt;3;0;0;3;131;0.02;0.0;0.0
6437_9.txt;8;0;0;8;270;0.03;0.0;0.0
7543_8.txt;0;0;0;0;362;0.0;0.0;0.0
12008_8.txt;30;0;7;37;478;0.06;0.0;0.01
11253_9.txt;2;0;0;2;174;0.01;0.0;0.0
7565_10.txt;3;0;1;4;487;0.01;0.0;0.0
8528_7.txt;2;0;0;2;143;0.01;0.0;0.0
6892_8.txt;14;1;1;16;185;0.08;0.01;0.01
1178_10.txt;24;2;5;31;231;0.1;0.01;0.02
8280_8.txt;8;2;0;10;172;0.05;0.01;0.0
8076_7.txt;13;2;6;21;208;0.06;0.01;0.03
222_10.txt;21;0;0;21;344;0.06;0.0;0.0
5300_8.txt;3;0;0;3;56;0.05;0.0;0.0
5837_7.txt;9;1;1;11;279;0.03;0.0;0.0
2726_9.txt;0;0;0;0;86;0.0;0.0;0.0
2791_10.txt;2;0;0;2;256;0.01;0.0;0.0
12333_9.txt;22;1;0;23;555;0.04;0.0;0.0
2375_8.txt;0;0;0;0;118;0.0;0.0;0.0
1734_7.txt;1;0;0;1;135;0.01;0.0;0.0
11944_10.txt;7;0;0;7;157;0.04;0.0;0.0
9537_8.txt;0;0;0;0;311;0.0;0.0;0.0
4093_8.txt;29;0;0;29;552;0.05;0.0;0.0
4158_10.txt;0;0;0;0;66;0.0;0.0;0.0
671_7.txt;22;4;0;26;600;0.04;0.01;0.0
5130_10.txt;3;0;0;3;139;0.02;0.0;0.0
911_10.txt;36;1;1;38;472;0.08;0.0;0.0
8486_10.txt;5;1;0;6;46;0.11;0.02;0.0
9849_9.txt;0;0;0;0;100;0.0;0.0;0.0
8702_10.txt;5;1;0;6;243;0.02;0.0;0.0
9737_9.txt;7;2;0;9;124;0.06;0.02;0.0
5378_7.txt;2;1;0;3;295;0.01;0.0;0.0
668_7.txt;7;0;0;7;242;0.03;0.0;0.0
9584_10.txt;0;0;0;0;146;0.0;0.0;0.0
3253_8.txt;0;0;0;0;83;0.0;0.0;0.0
9127_7.txt;3;0;0;3;168;0.02;0.0;0.0
546_10.txt;4;0;1;5;104;0.04;0.0;0.01
188_7.txt;5;1;0;6;202;0.02;0.0;0.0
6598_8.txt;0;3;0;3;190;0.0;0.02;0.0
3591_9.txt;6;1;0;7;225;0.03;0.0;0.0
10153_9.txt;4;2;0;6;113;0.04;0.02;0.0
4827_9.txt;5;0;0;5;163;0.03;0.0;0.0
2195_10.txt;16;2;0;18;162;0.1;0.01;0.0
6753_7.txt;14;0;1;15;138;0.1;0.0;0.01
12210_9.txt;1;0;0;1;132;0.01;0.0;0.0
7530_9.txt;5;0;0;5;134;0.04;0.0;0.0
2844_9.txt;42;11;2;55;685;0.06;0.02;0.0
7423_9.txt;1;0;3;4;145;0.01;0.0;0.02
12234_8.txt;16;3;2;21;752;0.02;0.0;0.0
6494_10.txt;0;4;0;4;246;0.0;0.02;0.0
12465_9.txt;1;6;4;11;314;0.0;0.02;0.01
2657_10.txt;5;0;0;5;262;0.02;0.0;0.0
6820_7.txt;0;0;0;0;179;0.0;0.0;0.0
10920_10.txt;0;0;0;0;122;0.0;0.0;0.0
8296_8.txt;8;1;0;9;163;0.05;0.01;0.0
12283_8.txt;10;0;0;10;259;0.04;0.0;0.0
10803_8.txt;0;0;0;0;160;0.0;0.0;0.0
2132_9.txt;10;1;0;11;209;0.05;0.0;0.0
6000_9.txt;6;1;0;7;218;0.03;0.0;0.0
2552_10.txt;27;0;0;27;158;0.17;0.0;0.0
9552_8.txt;0;0;0;0;50;0.0;0.0;0.0
3953_10.txt;4;0;1;5;149;0.03;0.0;0.01
8374_7.txt;0;0;0;0;94;0.0;0.0;0.0
8433_9.txt;2;2;0;4;79;0.03;0.03;0.0
224_10.txt;22;0;4;26;323;0.07;0.0;0.01
8077_7.txt;0;0;0;0;249;0.0;0.0;0.0
6236_8.txt;6;2;2;10;215;0.03;0.01;0.01
342_10.txt;0;0;0;0;70;0.0;0.0;0.0
8893_9.txt;0;1;0;1;149;0.0;0.01;0.0
3657_7.txt;4;0;0;4;137;0.03;0.0;0.0
3441_8.txt;2;0;0;2;154;0.01;0.0;0.0
2839_10.txt;16;2;0;18;176;0.09;0.01;0.0
11383_7.txt;4;1;0;5;118;0.03;0.01;0.0
6507_10.txt;11;0;0;11;437;0.03;0.0;0.0
7762_8.txt;17;2;0;19;299;0.06;0.01;0.0
5600_8.txt;0;0;0;0;163;0.0;0.0;0.0
7536_10.txt;6;2;0;8;226;0.03;0.01;0.0
1336_7.txt;9;0;4;13;400;0.02;0.0;0.01
5208_7.txt;10;0;0;10;177;0.06;0.0;0.0
5476_8.txt;17;5;4;26;562;0.03;0.01;0.01
2467_10.txt;15;0;0;15;192;0.08;0.0;0.0
6459_10.txt;1;1;0;2;173;0.01;0.01;0.0
5666_10.txt;6;2;0;8;263;0.02;0.01;0.0
11513_8.txt;9;1;3;13;234;0.04;0.0;0.01
9704_10.txt;16;2;3;21;448;0.04;0.0;0.01
4095_8.txt;2;0;0;2;145;0.01;0.0;0.0
10233_7.txt;4;4;1;9;248;0.02;0.02;0.0
2240_7.txt;11;2;2;15;356;0.03;0.01;0.01
10675_8.txt;5;0;0;5;131;0.04;0.0;0.0
9093_10.txt;1;0;0;1;177;0.01;0.0;0.0
12037_10.txt;0;3;2;5;363;0.0;0.01;0.01
3457_7.txt;13;0;0;13;422;0.03;0.0;0.0
11390_10.txt;9;0;1;10;178;0.05;0.0;0.01
10251_10.txt;0;0;0;0;84;0.0;0.0;0.0
9615_9.txt;0;2;0;2;118;0.0;0.02;0.0
65_10.txt;4;0;3;7;152;0.03;0.0;0.02
7334_7.txt;15;1;0;16;688;0.02;0.0;0.0
1599_7.txt;5;0;0;5;123;0.04;0.0;0.0
7873_8.txt;5;1;0;6;223;0.02;0.0;0.0
6727_9.txt;7;0;2;9;349;0.02;0.0;0.01
8150_10.txt;4;2;2;8;164;0.02;0.01;0.01
7465_10.txt;50;11;4;65;1672;0.03;0.01;0.0
4719_10.txt;0;0;0;0;158;0.0;0.0;0.0
8272_7.txt;17;0;0;17;309;0.06;0.0;0.0
3224_7.txt;11;0;0;11;299;0.04;0.0;0.0
10856_8.txt;2;0;0;2;209;0.01;0.0;0.0
10719_10.txt;33;2;1;36;380;0.09;0.01;0.0
10976_10.txt;1;3;0;4;325;0.0;0.01;0.0
7638_7.txt;24;0;2;26;320;0.07;0.0;0.01
4522_9.txt;4;0;0;4;96;0.04;0.0;0.0
11776_9.txt;2;0;0;2;206;0.01;0.0;0.0
990_9.txt;3;0;0;3;128;0.02;0.0;0.0
2186_8.txt;19;1;0;20;135;0.14;0.01;0.0
8683_9.txt;25;0;0;25;499;0.05;0.0;0.0
7679_10.txt;4;0;0;4;145;0.03;0.0;0.0
8780_10.txt;16;1;0;17;161;0.1;0.01;0.0
5157_7.txt;20;2;0;22;450;0.04;0.0;0.0
816_10.txt;6;0;0;6;327;0.02;0.0;0.0
1655_8.txt;2;4;0;6;147;0.01;0.03;0.0
9735_8.txt;6;0;1;7;302;0.02;0.0;0.0
4084_7.txt;0;1;0;1;335;0.0;0.0;0.0
4641_9.txt;2;2;0;4;157;0.01;0.01;0.0
6125_9.txt;9;0;0;9;232;0.04;0.0;0.0
5446_9.txt;4;0;2;6;207;0.02;0.0;0.01
8719_10.txt;0;0;1;1;114;0.0;0.0;0.01
6302_8.txt;2;0;0;2;100;0.02;0.0;0.0
3399_10.txt;13;1;0;14;282;0.05;0.0;0.0
6877_7.txt;17;2;7;26;558;0.03;0.0;0.01
6400_9.txt;0;1;0;1;114;0.0;0.01;0.0
9896_8.txt;5;0;0;5;259;0.02;0.0;0.0
11636_8.txt;0;0;0;0;226;0.0;0.0;0.0
5743_10.txt;6;0;0;6;95;0.06;0.0;0.0
7231_8.txt;10;0;0;10;148;0.07;0.0;0.0
1510_8.txt;19;0;0;19;589;0.03;0.0;0.0
6549_8.txt;5;0;0;5;188;0.03;0.0;0.0
3822_10.txt;15;5;0;20;791;0.02;0.01;0.0
872_9.txt;20;0;0;20;522;0.04;0.0;0.0
3434_8.txt;2;1;3;6;137;0.01;0.01;0.02
9161_10.txt;36;4;1;41;564;0.06;0.01;0.0
10458_10.txt;0;0;0;0;101;0.0;0.0;0.0
10459_9.txt;0;1;0;1;97;0.0;0.01;0.0
4032_9.txt;2;3;0;5;153;0.01;0.02;0.0
3555_7.txt;41;10;8;59;896;0.05;0.01;0.01
11107_10.txt;25;0;0;25;238;0.11;0.0;0.0
11573_10.txt;3;11;9;23;419;0.01;0.03;0.02
3614_7.txt;0;0;0;0;157;0.0;0.0;0.0
2496_8.txt;6;1;1;8;135;0.04;0.01;0.01
6016_10.txt;1;0;0;1;42;0.02;0.0;0.0
10874_10.txt;6;1;0;7;287;0.02;0.0;0.0
1283_10.txt;0;3;0;3;128;0.0;0.02;0.0
9007_10.txt;5;0;0;5;49;0.1;0.0;0.0
4461_8.txt;4;1;0;5;65;0.06;0.02;0.0
3764_8.txt;12;0;0;12;291;0.04;0.0;0.0
1958_10.txt;16;8;0;24;510;0.03;0.02;0.0
1769_8.txt;12;0;0;12;257;0.05;0.0;0.0
11405_8.txt;62;0;6;68;482;0.13;0.0;0.01
1429_9.txt;2;0;0;2;358;0.01;0.0;0.0
6243_9.txt;4;0;0;4;132;0.03;0.0;0.0
9378_9.txt;9;3;0;12;95;0.09;0.03;0.0
1721_8.txt;3;0;0;3;145;0.02;0.0;0.0
2178_9.txt;7;2;0;9;345;0.02;0.01;0.0
10027_7.txt;7;0;0;7;280;0.03;0.0;0.0
12327_9.txt;42;9;3;54;1234;0.03;0.01;0.0
6506_10.txt;2;0;0;2;216;0.01;0.0;0.0
7174_9.txt;2;8;0;10;110;0.02;0.07;0.0
11575_10.txt;1;0;0;1;161;0.01;0.0;0.0
9770_10.txt;1;0;0;1;145;0.01;0.0;0.0
12264_9.txt;1;0;0;1;137;0.01;0.0;0.0
3108_8.txt;6;1;1;8;239;0.03;0.0;0.0
849_7.txt;22;0;3;25;707;0.03;0.0;0.0
4290_9.txt;9;0;0;9;153;0.06;0.0;0.0
9233_8.txt;4;0;0;4;188;0.02;0.0;0.0
5722_8.txt;2;1;0;3;358;0.01;0.0;0.0
9090_9.txt;32;5;4;41;356;0.09;0.01;0.01
1150_10.txt;92;4;2;98;1164;0.08;0.0;0.0
530_10.txt;35;2;0;37;428;0.08;0.0;0.0
2709_8.txt;47;1;0;48;830;0.06;0.0;0.0
4006_8.txt;35;1;0;36;645;0.05;0.0;0.0
7630_8.txt;21;0;0;21;149;0.14;0.0;0.0
5538_7.txt;4;0;0;4;325;0.01;0.0;0.0
1814_10.txt;6;0;0;6;107;0.06;0.0;0.0
11558_10.txt;1;0;0;1;158;0.01;0.0;0.0
7486_8.txt;17;0;0;17;501;0.03;0.0;0.0
248_10.txt;15;1;4;20;226;0.07;0.0;0.02
11657_9.txt;9;3;0;12;340;0.03;0.01;0.0
8251_10.txt;0;0;0;0;207;0.0;0.0;0.0
10931_7.txt;6;0;0;6;250;0.02;0.0;0.0
2740_8.txt;16;1;0;17;212;0.08;0.0;0.0
12325_9.txt;18;5;3;26;419;0.04;0.01;0.01
4588_9.txt;3;0;0;3;150;0.02;0.0;0.0
12483_9.txt;3;0;0;3;183;0.02;0.0;0.0
9354_9.txt;22;0;0;22;575;0.04;0.0;0.0
11454_10.txt;5;0;0;5;177;0.03;0.0;0.0
10985_9.txt;3;0;0;3;218;0.01;0.0;0.0
9003_10.txt;7;0;1;8;245;0.03;0.0;0.0
8723_8.txt;0;0;0;0;66;0.0;0.0;0.0
2144_8.txt;0;0;0;0;107;0.0;0.0;0.0
3582_8.txt;12;1;0;13;313;0.04;0.0;0.0
10226_10.txt;1;1;0;2;121;0.01;0.01;0.0
11975_7.txt;21;0;4;25;195;0.11;0.0;0.02
11320_10.txt;0;0;0;0;72;0.0;0.0;0.0
11291_10.txt;0;1;0;1;147;0.0;0.01;0.0
6985_10.txt;41;5;5;51;1150;0.04;0.0;0.0
2235_10.txt;0;1;0;1;193;0.0;0.01;0.0
5618_10.txt;5;1;0;6;158;0.03;0.01;0.0
9931_9.txt;4;1;0;5;174;0.02;0.01;0.0
12367_9.txt;5;0;0;5;181;0.03;0.0;0.0
334_10.txt;1;1;0;2;136;0.01;0.01;0.0
8880_8.txt;0;3;0;3;311;0.0;0.01;0.0
8710_7.txt;0;0;0;0;139;0.0;0.0;0.0
7366_7.txt;5;0;0;5;158;0.03;0.0;0.0
950_9.txt;6;0;0;6;103;0.06;0.0;0.0
1112_8.txt;30;6;6;42;513;0.06;0.01;0.01
4132_7.txt;24;1;0;25;311;0.08;0.0;0.0
10616_7.txt;18;0;0;18;486;0.04;0.0;0.0
6195_10.txt;14;3;0;17;497;0.03;0.01;0.0
9982_9.txt;13;1;2;16;211;0.06;0.0;0.01
5848_7.txt;0;0;0;0;180;0.0;0.0;0.0
11537_7.txt;27;0;1;28;295;0.09;0.0;0.0
3016_10.txt;9;3;0;12;305;0.03;0.01;0.0
4124_8.txt;4;0;2;6;130;0.03;0.0;0.02
2569_10.txt;5;0;0;5;61;0.08;0.0;0.0
9710_10.txt;4;1;0;5;138;0.03;0.01;0.0
1753_9.txt;20;0;0;20;829;0.02;0.0;0.0
8304_8.txt;0;0;0;0;307;0.0;0.0;0.0
3858_10.txt;5;0;0;5;195;0.03;0.0;0.0
8764_8.txt;10;3;2;15;146;0.07;0.02;0.01
10230_9.txt;2;11;4;17;242;0.01;0.05;0.02
4288_9.txt;0;0;0;0;123;0.0;0.0;0.0
2767_8.txt;4;0;0;4;90;0.04;0.0;0.0
1912_9.txt;2;0;1;3;160;0.01;0.0;0.01
10195_8.txt;17;2;0;19;288;0.06;0.01;0.0
11145_8.txt;14;6;2;22;345;0.04;0.02;0.01
4608_9.txt;17;5;0;22;594;0.03;0.01;0.0
7092_8.txt;18;3;0;21;477;0.04;0.01;0.0
6745_8.txt;30;2;0;32;745;0.04;0.0;0.0
12127_8.txt;37;0;0;37;445;0.08;0.0;0.0
226_10.txt;2;0;0;2;59;0.03;0.0;0.0
3214_10.txt;16;0;0;16;125;0.13;0.0;0.0
590_10.txt;31;4;0;35;593;0.05;0.01;0.0
290_9.txt;2;0;0;2;158;0.01;0.0;0.0
11609_10.txt;24;10;4;38;459;0.05;0.02;0.01
8013_8.txt;10;1;0;11;338;0.03;0.0;0.0
238_10.txt;15;0;2;17;403;0.04;0.0;0.0
1227_8.txt;0;0;0;0;125;0.0;0.0;0.0
6428_8.txt;0;0;0;0;42;0.0;0.0;0.0
1036_9.txt;6;1;0;7;70;0.09;0.01;0.0
3815_7.txt;5;0;0;5;464;0.01;0.0;0.0
12191_7.txt;28;10;2;40;839;0.03;0.01;0.0
169_8.txt;49;0;0;49;583;0.08;0.0;0.0
1887_8.txt;13;0;0;13;303;0.04;0.0;0.0
2677_9.txt;0;0;0;0;47;0.0;0.0;0.0
6414_8.txt;8;1;1;10;387;0.02;0.0;0.0
5480_10.txt;7;4;0;11;156;0.04;0.03;0.0
2582_8.txt;68;6;5;79;852;0.08;0.01;0.01
5284_9.txt;0;2;0;2;144;0.0;0.01;0.0
3223_8.txt;2;0;0;2;117;0.02;0.0;0.0
8447_8.txt;2;0;0;2;323;0.01;0.0;0.0
11569_8.txt;7;0;0;7;312;0.02;0.0;0.0
772_10.txt;8;2;2;12;118;0.07;0.02;0.02
4103_7.txt;10;2;6;18;241;0.04;0.01;0.02
1682_7.txt;17;1;1;19;384;0.04;0.0;0.0
9878_7.txt;5;0;0;5;100;0.05;0.0;0.0
11009_7.txt;8;0;1;9;162;0.05;0.0;0.01
11413_10.txt;0;0;0;0;76;0.0;0.0;0.0
3274_8.txt;3;0;3;6;144;0.02;0.0;0.02
5902_9.txt;2;0;0;2;249;0.01;0.0;0.0
4582_7.txt;1;0;0;1;67;0.01;0.0;0.0
6412_9.txt;22;6;6;34;334;0.07;0.02;0.02
7897_8.txt;6;0;0;6;268;0.02;0.0;0.0
8801_9.txt;13;2;0;15;212;0.06;0.01;0.0
2809_8.txt;0;1;0;1;530;0.0;0.0;0.0
143_7.txt;3;1;1;5;531;0.01;0.0;0.0
10315_8.txt;20;2;2;24;701;0.03;0.0;0.0
7912_8.txt;0;0;0;0;145;0.0;0.0;0.0
898_10.txt;4;0;0;4;164;0.02;0.0;0.0
12259_7.txt;30;1;0;31;348;0.09;0.0;0.0
6972_9.txt;1;2;0;3;247;0.0;0.01;0.0
11407_7.txt;44;2;0;46;650;0.07;0.0;0.0
8281_7.txt;4;0;0;4;433;0.01;0.0;0.0
4108_7.txt;6;2;0;8;159;0.04;0.01;0.0
4475_8.txt;28;7;3;38;573;0.05;0.01;0.01
6649_8.txt;53;5;8;66;964;0.05;0.01;0.01
204_10.txt;8;0;0;8;213;0.04;0.0;0.0
12377_10.txt;24;17;5;46;774;0.03;0.02;0.01
9016_10.txt;0;0;0;0;55;0.0;0.0;0.0
4277_10.txt;0;1;0;1;144;0.0;0.01;0.0
1604_9.txt;0;0;0;0;91;0.0;0.0;0.0
7309_9.txt;25;1;0;26;619;0.04;0.0;0.0
2896_9.txt;6;0;2;8;491;0.01;0.0;0.0
6964_7.txt;59;0;0;59;698;0.08;0.0;0.0
10003_8.txt;7;0;0;7;138;0.05;0.0;0.0
652_10.txt;8;0;0;8;195;0.04;0.0;0.0
802_10.txt;15;0;4;19;258;0.06;0.0;0.02
4_8.txt;5;7;1;13;277;0.02;0.03;0.0
10006_7.txt;43;2;0;45;425;0.1;0.0;0.0
1416_10.txt;0;0;0;0;126;0.0;0.0;0.0
8343_7.txt;42;3;1;46;394;0.11;0.01;0.0
5744_7.txt;11;0;0;11;151;0.07;0.0;0.0
7847_9.txt;9;0;3;12;273;0.03;0.0;0.01
9466_7.txt;38;3;0;41;405;0.09;0.01;0.0
3351_8.txt;9;0;0;9;123;0.07;0.0;0.0
3445_7.txt;8;0;0;8;429;0.02;0.0;0.0
4881_9.txt;9;2;1;12;231;0.04;0.01;0.0
9031_10.txt;56;6;12;74;1087;0.05;0.01;0.01
1433_10.txt;0;0;0;0;33;0.0;0.0;0.0
1767_8.txt;21;1;0;22;399;0.05;0.0;0.0
5231_10.txt;5;0;0;5;117;0.04;0.0;0.0
9916_7.txt;13;7;0;20;404;0.03;0.02;0.0
5124_10.txt;2;0;0;2;90;0.02;0.0;0.0
4247_10.txt;24;4;1;29;271;0.09;0.01;0.0
2068_8.txt;53;1;0;54;364;0.15;0.0;0.0
7733_9.txt;1;0;0;1;70;0.01;0.0;0.0
11288_8.txt;6;0;0;6;313;0.02;0.0;0.0
8878_9.txt;0;0;0;0;65;0.0;0.0;0.0
7519_9.txt;55;6;6;67;736;0.07;0.01;0.01
1110_9.txt;0;2;2;4;140;0.0;0.01;0.01
7817_10.txt;33;3;0;36;556;0.06;0.01;0.0
2805_9.txt;4;1;0;5;299;0.01;0.0;0.0
8583_9.txt;20;1;2;23;302;0.07;0.0;0.01
3309_9.txt;11;2;0;13;238;0.05;0.01;0.0
8711_7.txt;3;1;0;4;157;0.02;0.01;0.0
9978_8.txt;0;0;1;1;212;0.0;0.0;0.0
2906_9.txt;6;0;0;6;167;0.04;0.0;0.0
5474_9.txt;1;0;0;1;132;0.01;0.0;0.0
9284_8.txt;4;3;0;7;367;0.01;0.01;0.0
3342_7.txt;2;2;3;7;265;0.01;0.01;0.01
11338_10.txt;2;0;0;2;150;0.01;0.0;0.0
1868_10.txt;4;0;0;4;127;0.03;0.0;0.0
11257_7.txt;0;0;0;0;140;0.0;0.0;0.0
5477_7.txt;1;2;1;4;135;0.01;0.01;0.01
5507_7.txt;9;6;0;15;206;0.04;0.03;0.0
3_10.txt;0;0;0;0;122;0.0;0.0;0.0
10696_7.txt;8;0;0;8;152;0.05;0.0;0.0
242_8.txt;6;2;0;8;141;0.04;0.01;0.0
6927_10.txt;11;0;0;11;589;0.02;0.0;0.0
11993_9.txt;14;1;1;16;149;0.09;0.01;0.01
10661_9.txt;23;2;0;25;450;0.05;0.0;0.0
11848_10.txt;2;0;0;2;164;0.01;0.0;0.0
11608_10.txt;2;1;0;3;177;0.01;0.01;0.0
8182_7.txt;19;2;4;25;538;0.04;0.0;0.01
2468_10.txt;9;0;2;11;254;0.04;0.0;0.01
11279_10.txt;2;0;0;2;56;0.04;0.0;0.0
2654_10.txt;3;0;3;6;200;0.01;0.0;0.01
5111_10.txt;5;0;1;6;153;0.03;0.0;0.01
10229_8.txt;10;1;1;12;367;0.03;0.0;0.0
476_7.txt;0;0;0;0;216;0.0;0.0;0.0
6575_8.txt;13;2;0;15;138;0.09;0.01;0.0
11968_10.txt;1;0;2;3;331;0.0;0.0;0.01
5705_10.txt;4;1;0;5;131;0.03;0.01;0.0
12072_10.txt;24;0;6;30;388;0.06;0.0;0.02
8095_8.txt;19;2;5;26;456;0.04;0.0;0.01
11545_8.txt;35;0;0;35;624;0.06;0.0;0.0
4839_10.txt;1;1;0;2;57;0.02;0.02;0.0
12472_10.txt;1;0;0;1;67;0.01;0.0;0.0
10335_8.txt;7;0;1;8;285;0.02;0.0;0.0
3719_9.txt;3;0;0;3;85;0.04;0.0;0.0
10352_10.txt;4;1;0;5;151;0.03;0.01;0.0
11358_9.txt;1;0;2;3;187;0.01;0.0;0.01
4813_9.txt;20;11;0;31;536;0.04;0.02;0.0
6986_8.txt;2;2;2;6;186;0.01;0.01;0.01
3921_9.txt;9;1;0;10;274;0.03;0.0;0.0
10921_10.txt;0;0;0;0;262;0.0;0.0;0.0
2561_7.txt;11;2;0;13;168;0.07;0.01;0.0
209_8.txt;10;0;0;10;142;0.07;0.0;0.0
4356_8.txt;44;1;0;45;604;0.07;0.0;0.0
10823_8.txt;30;0;1;31;328;0.09;0.0;0.0
0_9.txt;2;0;6;8;167;0.01;0.0;0.04
7142_8.txt;38;2;2;42;336;0.11;0.01;0.01
2929_10.txt;0;0;0;0;62;0.0;0.0;0.0
7221_8.txt;24;2;0;26;424;0.06;0.0;0.0
10461_9.txt;0;1;0;1;136;0.0;0.01;0.0
10652_9.txt;7;0;0;7;153;0.05;0.0;0.0
2310_9.txt;3;0;0;3;206;0.01;0.0;0.0
4386_9.txt;9;2;0;11;217;0.04;0.01;0.0
4380_8.txt;10;0;0;10;160;0.06;0.0;0.0
12348_9.txt;0;0;0;0;137;0.0;0.0;0.0
10758_8.txt;18;5;3;26;677;0.03;0.01;0.0
12275_9.txt;3;0;0;3;120;0.03;0.0;0.0
10254_8.txt;0;1;0;1;72;0.0;0.01;0.0
11838_9.txt;0;0;0;0;175;0.0;0.0;0.0
4055_10.txt;7;1;5;13;247;0.03;0.0;0.02
5010_10.txt;24;7;3;34;1147;0.02;0.01;0.0
998_7.txt;9;0;0;9;145;0.06;0.0;0.0
2867_10.txt;3;0;1;4;218;0.01;0.0;0.0
2096_10.txt;10;0;0;10;172;0.06;0.0;0.0
6570_8.txt;2;0;0;2;64;0.03;0.0;0.0
9239_8.txt;2;1;1;4;208;0.01;0.0;0.0
12104_7.txt;3;2;0;5;126;0.02;0.02;0.0
5890_8.txt;20;19;2;41;734;0.03;0.03;0.0
94_10.txt;2;0;0;2;152;0.01;0.0;0.0
5289_10.txt;5;0;4;9;139;0.04;0.0;0.03
9373_9.txt;9;3;0;12;166;0.05;0.02;0.0
11144_8.txt;36;12;0;48;916;0.04;0.01;0.0
3856_10.txt;11;4;0;15;259;0.04;0.02;0.0
11574_10.txt;0;3;0;3;105;0.0;0.03;0.0
10898_7.txt;1;0;0;1;169;0.01;0.0;0.0
10433_9.txt;4;4;0;8;197;0.02;0.02;0.0
1104_8.txt;33;2;0;35;401;0.08;0.0;0.0
6998_7.txt;6;0;0;6;310;0.02;0.0;0.0
3891_10.txt;3;2;0;5;163;0.02;0.01;0.0
5672_9.txt;10;1;0;11;182;0.05;0.01;0.0
8789_10.txt;0;0;0;0;36;0.0;0.0;0.0
3754_8.txt;7;0;5;12;209;0.03;0.0;0.02
7433_10.txt;1;2;0;3;101;0.01;0.02;0.0
1301_10.txt;7;0;0;7;244;0.03;0.0;0.0
7005_9.txt;2;0;0;2;207;0.01;0.0;0.0
9516_8.txt;28;0;0;28;198;0.14;0.0;0.0
3925_10.txt;45;4;6;55;637;0.07;0.01;0.01
7602_10.txt;2;0;0;2;329;0.01;0.0;0.0
1471_9.txt;18;0;2;20;457;0.04;0.0;0.0
10418_9.txt;29;5;0;34;444;0.07;0.01;0.0
136_10.txt;1;1;1;3;140;0.01;0.01;0.01
276_10.txt;0;0;0;0;138;0.0;0.0;0.0
382_10.txt;2;1;2;5;110;0.02;0.01;0.02
12164_9.txt;4;3;1;8;259;0.02;0.01;0.0
5344_7.txt;4;12;0;16;346;0.01;0.03;0.0
3514_7.txt;3;0;0;3;52;0.06;0.0;0.0
363_10.txt;2;0;0;2;120;0.02;0.0;0.0
3237_8.txt;0;3;0;3;306;0.0;0.01;0.0
12362_8.txt;0;0;0;0;343;0.0;0.0;0.0
2738_10.txt;2;0;0;2;168;0.01;0.0;0.0
6422_7.txt;36;6;5;47;702;0.05;0.01;0.01
9791_9.txt;2;2;0;4;129;0.02;0.02;0.0
8984_10.txt;8;0;0;8;144;0.06;0.0;0.0
10340_9.txt;8;0;0;8;204;0.04;0.0;0.0
6367_7.txt;0;0;3;3;106;0.0;0.0;0.03
5540_10.txt;10;0;0;10;213;0.05;0.0;0.0
1138_10.txt;4;0;0;4;126;0.03;0.0;0.0
6504_10.txt;1;0;0;1;174;0.01;0.0;0.0
8959_8.txt;9;0;0;9;180;0.05;0.0;0.0
3761_8.txt;12;0;0;12;149;0.08;0.0;0.0
9390_9.txt;7;0;2;9;106;0.07;0.0;0.02
2721_9.txt;13;3;0;16;176;0.07;0.02;0.0
4327_8.txt;11;0;2;13;241;0.05;0.0;0.01
6924_7.txt;31;2;0;33;341;0.09;0.01;0.0
3751_10.txt;3;0;0;3;175;0.02;0.0;0.0
9742_10.txt;9;8;0;17;246;0.04;0.03;0.0
8221_9.txt;7;0;0;7;161;0.04;0.0;0.0
1206_10.txt;0;0;0;0;57;0.0;0.0;0.0
10670_10.txt;0;0;0;0;54;0.0;0.0;0.0
10683_7.txt;1;0;0;1;345;0.0;0.0;0.0
9935_7.txt;23;0;3;26;418;0.06;0.0;0.01
10193_9.txt;24;2;2;28;680;0.04;0.0;0.0
10324_9.txt;17;0;0;17;243;0.07;0.0;0.0
8135_10.txt;2;0;0;2;149;0.01;0.0;0.0
6805_10.txt;9;0;0;9;227;0.04;0.0;0.0
1028_10.txt;0;0;0;0;382;0.0;0.0;0.0
1596_8.txt;7;2;0;9;107;0.07;0.02;0.0
11450_10.txt;1;0;0;1;81;0.01;0.0;0.0
3103_7.txt;2;1;0;3;181;0.01;0.01;0.0
6756_10.txt;56;0;0;56;541;0.1;0.0;0.0
3038_8.txt;34;13;9;56;939;0.04;0.01;0.01
9327_8.txt;0;2;0;2;186;0.0;0.01;0.0
6227_7.txt;7;2;2;11;227;0.03;0.01;0.01
8860_8.txt;35;1;4;40;1072;0.03;0.0;0.0
6693_10.txt;6;0;0;6;50;0.12;0.0;0.0
9246_8.txt;6;2;0;8;282;0.02;0.01;0.0
5012_10.txt;0;0;1;1;90;0.0;0.0;0.01
1290_7.txt;2;0;0;2;165;0.01;0.0;0.0
9435_7.txt;27;3;0;30;472;0.06;0.01;0.0
12085_8.txt;3;2;0;5;222;0.01;0.01;0.0
4222_7.txt;2;0;0;2;178;0.01;0.0;0.0
7404_9.txt;0;1;0;1;82;0.0;0.01;0.0
2513_9.txt;3;1;0;4;155;0.02;0.01;0.0
2686_9.txt;5;0;0;5;76;0.07;0.0;0.0
9567_7.txt;17;3;0;20;394;0.04;0.01;0.0
11845_10.txt;2;4;1;7;260;0.01;0.02;0.0
5216_8.txt;7;0;4;11;186;0.04;0.0;0.02
4057_7.txt;32;3;0;35;487;0.07;0.01;0.0
7640_10.txt;33;1;0;34;858;0.04;0.0;0.0
6710_10.txt;15;0;0;15;177;0.08;0.0;0.0
11110_9.txt;13;0;0;13;385;0.03;0.0;0.0
7123_10.txt;21;2;0;23;398;0.05;0.01;0.0
11243_10.txt;0;3;0;3;152;0.0;0.02;0.0
11854_7.txt;5;0;0;5;151;0.03;0.0;0.0
6940_10.txt;61;3;1;65;566;0.11;0.01;0.0
11802_7.txt;1;0;0;1;161;0.01;0.0;0.0
3469_10.txt;1;0;0;1;181;0.01;0.0;0.0
7807_10.txt;1;0;0;1;129;0.01;0.0;0.0
8626_7.txt;3;0;0;3;361;0.01;0.0;0.0
3112_7.txt;36;1;2;39;812;0.04;0.0;0.0
6481_10.txt;1;3;1;5;125;0.01;0.02;0.01
8064_10.txt;37;5;6;48;578;0.06;0.01;0.01
664_7.txt;21;0;5;26;410;0.05;0.0;0.01
4835_10.txt;0;1;0;1;80;0.0;0.01;0.0
4914_7.txt;14;1;0;15;406;0.03;0.0;0.0
6122_8.txt;0;0;0;0;161;0.0;0.0;0.0
7885_9.txt;9;1;0;10;403;0.02;0.0;0.0
6420_7.txt;3;2;4;9;147;0.02;0.01;0.03
8608_9.txt;6;0;0;6;150;0.04;0.0;0.0
9739_7.txt;14;1;0;15;184;0.08;0.01;0.0
10197_7.txt;9;0;5;14;279;0.03;0.0;0.02
9947_10.txt;0;0;0;0;77;0.0;0.0;0.0
847_7.txt;32;3;0;35;755;0.04;0.0;0.0
9408_10.txt;16;1;0;17;487;0.03;0.0;0.0
6593_7.txt;2;2;1;5;117;0.02;0.02;0.01
6176_9.txt;17;1;2;20;229;0.07;0.0;0.01
11058_10.txt;0;0;0;0;81;0.0;0.0;0.0
2838_10.txt;9;6;2;17;168;0.05;0.04;0.01
1186_8.txt;12;1;0;13;246;0.05;0.0;0.0
1959_7.txt;17;1;2;20;663;0.03;0.0;0.0
5632_8.txt;31;0;0;31;407;0.08;0.0;0.0
7493_7.txt;42;3;0;45;567;0.07;0.01;0.0
9110_8.txt;0;0;0;0;128;0.0;0.0;0.0
1652_10.txt;9;4;0;13;269;0.03;0.01;0.0
10414_10.txt;8;3;5;16;318;0.03;0.01;0.02
11263_10.txt;2;1;0;3;132;0.02;0.01;0.0
2246_10.txt;2;1;0;3;157;0.01;0.01;0.0
736_10.txt;6;1;3;10;236;0.03;0.0;0.01
4495_9.txt;0;0;0;0;397;0.0;0.0;0.0
700_8.txt;4;0;0;4;122;0.03;0.0;0.0
4799_10.txt;5;0;0;5;432;0.01;0.0;0.0
11842_10.txt;0;0;0;0;69;0.0;0.0;0.0
5681_8.txt;17;0;1;18;185;0.09;0.0;0.01
4382_8.txt;14;0;0;14;280;0.05;0.0;0.0
8939_9.txt;14;1;3;18;181;0.08;0.01;0.02
4420_8.txt;0;0;0;0;86;0.0;0.0;0.0
3691_8.txt;0;1;0;1;134;0.0;0.01;0.0
12098_8.txt;22;4;4;30;812;0.03;0.0;0.0
5158_10.txt;10;1;0;11;268;0.04;0.0;0.0
4823_7.txt;11;4;3;18;276;0.04;0.01;0.01
1560_9.txt;4;0;1;5;166;0.02;0.0;0.01
2847_8.txt;25;15;3;43;315;0.08;0.05;0.01
2934_10.txt;9;0;0;9;82;0.11;0.0;0.0
2834_9.txt;1;2;0;3;143;0.01;0.01;0.0
5897_10.txt;1;3;0;4;167;0.01;0.02;0.0
12019_8.txt;16;2;0;18;219;0.07;0.01;0.0
8478_8.txt;4;0;0;4;216;0.02;0.0;0.0
564_8.txt;20;1;1;22;91;0.22;0.01;0.01
3136_8.txt;4;0;0;4;108;0.04;0.0;0.0
4126_8.txt;4;0;2;6;118;0.03;0.0;0.02
6921_9.txt;2;0;0;2;92;0.02;0.0;0.0
179_8.txt;14;0;2;16;598;0.02;0.0;0.0
8529_9.txt;5;0;0;5;95;0.05;0.0;0.0
5960_8.txt;2;0;0;2;143;0.01;0.0;0.0
5785_10.txt;0;0;0;0;192;0.0;0.0;0.0
4145_10.txt;2;0;0;2;144;0.01;0.0;0.0
2050_7.txt;11;6;6;23;373;0.03;0.02;0.02
12430_7.txt;2;0;2;4;93;0.02;0.0;0.02
5059_7.txt;2;0;0;2;161;0.01;0.0;0.0
7890_7.txt;19;1;0;20;275;0.07;0.0;0.0
3070_7.txt;0;0;0;0;84;0.0;0.0;0.0
2616_10.txt;2;1;1;4;180;0.01;0.01;0.01
6416_7.txt;21;3;5;29;408;0.05;0.01;0.01
9137_10.txt;0;0;0;0;146;0.0;0.0;0.0
7502_7.txt;6;0;0;6;160;0.04;0.0;0.0
2763_8.txt;8;0;0;8;118;0.07;0.0;0.0
6002_7.txt;0;0;0;0;77;0.0;0.0;0.0
10592_8.txt;2;5;0;7;188;0.01;0.03;0.0
6072_7.txt;10;1;0;11;291;0.03;0.0;0.0
453_10.txt;0;0;0;0;151;0.0;0.0;0.0
9693_8.txt;2;0;0;2;140;0.01;0.0;0.0
10560_9.txt;8;0;0;8;418;0.02;0.0;0.0
9964_10.txt;1;6;2;9;393;0.0;0.02;0.01
10974_10.txt;19;5;0;24;188;0.1;0.03;0.0
11496_10.txt;4;2;0;6;147;0.03;0.01;0.0
1304_7.txt;10;0;0;10;167;0.06;0.0;0.0
5465_8.txt;19;3;2;24;267;0.07;0.01;0.01
1459_10.txt;0;4;2;6;248;0.0;0.02;0.01
5651_10.txt;7;0;0;7;158;0.04;0.0;0.0
609_9.txt;21;0;0;21;328;0.06;0.0;0.0
4593_10.txt;12;3;0;15;314;0.04;0.01;0.0
8102_7.txt;5;1;0;6;404;0.01;0.0;0.0
2600_10.txt;64;10;7;81;928;0.07;0.01;0.01
1504_9.txt;6;0;0;6;139;0.04;0.0;0.0
4989_8.txt;17;0;0;17;291;0.06;0.0;0.0
3845_7.txt;2;0;0;2;101;0.02;0.0;0.0
4698_10.txt;2;0;0;2;102;0.02;0.0;0.0
4105_10.txt;0;0;0;0;50;0.0;0.0;0.0
2741_10.txt;19;2;2;23;480;0.04;0.0;0.0
3723_8.txt;3;0;1;4;104;0.03;0.0;0.01
9555_10.txt;14;0;3;17;171;0.08;0.0;0.02
8504_8.txt;16;1;0;17;302;0.05;0.0;0.0
5093_10.txt;14;2;0;16;416;0.03;0.0;0.0
8523_9.txt;2;0;0;2;166;0.01;0.0;0.0
1315_10.txt;2;0;0;2;61;0.03;0.0;0.0
10782_7.txt;5;2;0;7;307;0.02;0.01;0.0
5297_8.txt;4;0;0;4;180;0.02;0.0;0.0
8905_10.txt;3;0;0;3;250;0.01;0.0;0.0
9885_10.txt;8;0;0;8;92;0.09;0.0;0.0
11217_7.txt;6;1;0;7;279;0.02;0.0;0.0
1453_8.txt;4;0;0;4;111;0.04;0.0;0.0
2277_10.txt;7;0;0;7;99;0.07;0.0;0.0
7968_10.txt;0;0;1;1;404;0.0;0.0;0.0
7121_10.txt;10;3;0;13;489;0.02;0.01;0.0
12125_8.txt;8;0;0;8;164;0.05;0.0;0.0
5147_8.txt;16;1;0;17;374;0.04;0.0;0.0
1904_7.txt;36;0;0;36;411;0.09;0.0;0.0
5251_7.txt;10;1;0;11;233;0.04;0.0;0.0
1450_8.txt;5;0;0;5;124;0.04;0.0;0.0
399_9.txt;2;2;5;9;132;0.02;0.02;0.04
8617_9.txt;4;1;1;6;296;0.01;0.0;0.0
5411_10.txt;0;0;1;1;151;0.0;0.0;0.01
7684_7.txt;0;0;0;0;156;0.0;0.0;0.0
210_10.txt;8;0;0;8;173;0.05;0.0;0.0
3631_7.txt;2;0;0;2;100;0.02;0.0;0.0
2931_10.txt;2;1;0;3;161;0.01;0.01;0.0
11181_10.txt;30;0;0;30;397;0.08;0.0;0.0
3121_10.txt;27;8;2;37;1069;0.03;0.01;0.0
929_10.txt;4;1;5;10;270;0.01;0.0;0.02
11233_10.txt;16;1;8;25;431;0.04;0.0;0.02
4400_10.txt;0;1;0;1;110;0.0;0.01;0.0
9801_10.txt;7;2;2;11;371;0.02;0.01;0.01
11713_10.txt;2;0;1;3;242;0.01;0.0;0.0
625_10.txt;17;2;1;20;585;0.03;0.0;0.0
7772_7.txt;43;9;3;55;390;0.11;0.02;0.01
7114_9.txt;21;6;3;30;384;0.05;0.02;0.01
71_10.txt;2;0;0;2;252;0.01;0.0;0.0
3956_10.txt;0;0;0;0;118;0.0;0.0;0.0
3272_8.txt;4;0;0;4;388;0.01;0.0;0.0
6457_7.txt;9;0;3;12;775;0.01;0.0;0.0
2783_8.txt;0;0;0;0;155;0.0;0.0;0.0
10255_9.txt;0;1;0;1;151;0.0;0.01;0.0
1400_7.txt;3;0;0;3;328;0.01;0.0;0.0
6863_7.txt;11;0;0;11;237;0.05;0.0;0.0
11161_8.txt;0;2;0;2;112;0.0;0.02;0.0
6955_10.txt;15;0;0;15;171;0.09;0.0;0.0
10246_10.txt;4;0;0;4;362;0.01;0.0;0.0
3999_10.txt;8;0;0;8;164;0.05;0.0;0.0
5523_8.txt;31;12;3;46;1007;0.03;0.01;0.0
6597_9.txt;0;2;0;2;132;0.0;0.02;0.0
8616_8.txt;19;2;0;21;669;0.03;0.0;0.0
12368_8.txt;15;0;1;16;220;0.07;0.0;0.0
7616_10.txt;0;0;0;0;254;0.0;0.0;0.0
10586_10.txt;27;1;5;33;533;0.05;0.0;0.01
7611_9.txt;0;0;1;1;342;0.0;0.0;0.0
1866_8.txt;4;3;0;7;189;0.02;0.02;0.0
10236_8.txt;7;4;0;11;86;0.08;0.05;0.0
6037_10.txt;5;2;3;10;158;0.03;0.01;0.02
4087_10.txt;0;0;0;0;365;0.0;0.0;0.0
7600_10.txt;0;0;1;1;174;0.0;0.0;0.01
10527_10.txt;18;2;0;20;163;0.11;0.01;0.0
11921_10.txt;0;0;0;0;69;0.0;0.0;0.0
7431_10.txt;7;0;0;7;147;0.05;0.0;0.0
7320_10.txt;31;0;0;31;916;0.03;0.0;0.0
3905_10.txt;0;0;0;0;139;0.0;0.0;0.0
3156_9.txt;0;0;0;0;232;0.0;0.0;0.0
11020_8.txt;35;0;5;40;384;0.09;0.0;0.01
793_9.txt;6;0;0;6;217;0.03;0.0;0.0
8386_9.txt;0;0;0;0;73;0.0;0.0;0.0
4911_9.txt;9;0;0;9;231;0.04;0.0;0.0
9424_10.txt;3;2;0;5;276;0.01;0.01;0.0
454_8.txt;0;1;0;1;163;0.0;0.01;0.0
890_9.txt;11;3;0;14;132;0.08;0.02;0.0
8258_9.txt;6;0;1;7;332;0.02;0.0;0.0
6640_8.txt;0;0;2;2;177;0.0;0.0;0.01
3571_7.txt;4;0;1;5;147;0.03;0.0;0.01
6538_8.txt;3;0;0;3;162;0.02;0.0;0.0
10910_10.txt;9;0;0;9;213;0.04;0.0;0.0
9062_7.txt;0;0;0;0;160;0.0;0.0;0.0
1319_10.txt;5;0;3;8;380;0.01;0.0;0.01
8660_7.txt;1;0;0;1;205;0.0;0.0;0.0
538_10.txt;1;1;3;5;94;0.01;0.01;0.03
5711_8.txt;7;1;2;10;352;0.02;0.0;0.01
11559_10.txt;10;0;0;10;171;0.06;0.0;0.0
8573_10.txt;6;0;4;10;251;0.02;0.0;0.02
6606_9.txt;3;1;0;4;215;0.01;0.0;0.0
3765_10.txt;29;0;0;29;530;0.05;0.0;0.0
8114_8.txt;25;0;3;28;404;0.06;0.0;0.01
2770_8.txt;14;3;0;17;123;0.11;0.02;0.0
7830_10.txt;10;2;0;12;136;0.07;0.01;0.0
5376_7.txt;24;2;2;28;756;0.03;0.0;0.0
10980_7.txt;19;6;3;28;408;0.05;0.01;0.01
2874_10.txt;5;0;0;5;266;0.02;0.0;0.0
11983_10.txt;18;0;0;18;151;0.12;0.0;0.0
3034_7.txt;4;0;0;4;141;0.03;0.0;0.0
12049_10.txt;0;0;0;0;261;0.0;0.0;0.0
5945_10.txt;12;7;1;20;805;0.01;0.01;0.0
9993_10.txt;3;0;0;3;101;0.03;0.0;0.0
6938_9.txt;4;0;0;4;250;0.02;0.0;0.0
9210_10.txt;2;0;0;2;175;0.01;0.0;0.0
8341_10.txt;9;0;5;14;204;0.04;0.0;0.02
11237_8.txt;0;0;2;2;169;0.0;0.0;0.01
330_10.txt;1;2;0;3;162;0.01;0.01;0.0
2941_10.txt;8;0;0;8;140;0.06;0.0;0.0
6872_7.txt;0;0;3;3;57;0.0;0.0;0.05
5643_7.txt;47;3;0;50;379;0.12;0.01;0.0
12102_8.txt;7;0;0;7;206;0.03;0.0;0.0
7756_10.txt;4;0;0;4;168;0.02;0.0;0.0
4789_10.txt;22;2;0;24;355;0.06;0.01;0.0
5119_10.txt;4;0;0;4;147;0.03;0.0;0.0
9619_10.txt;3;0;0;3;141;0.02;0.0;0.0
5214_7.txt;60;4;2;66;932;0.06;0.0;0.0
8516_9.txt;2;0;0;2;164;0.01;0.0;0.0
11846_10.txt;4;1;0;5;101;0.04;0.01;0.0
9412_10.txt;0;0;1;1;85;0.0;0.0;0.01
10905_8.txt;10;0;7;17;206;0.05;0.0;0.03
7774_7.txt;30;4;0;34;441;0.07;0.01;0.0
11030_8.txt;36;3;0;39;1134;0.03;0.0;0.0
8275_10.txt;16;0;0;16;319;0.05;0.0;0.0
12220_8.txt;0;0;0;0;63;0.0;0.0;0.0
11339_10.txt;18;0;0;18;165;0.11;0.0;0.0
1247_8.txt;8;3;0;11;521;0.02;0.01;0.0
1657_9.txt;17;6;1;24;214;0.08;0.03;0.0
6848_7.txt;0;0;0;0;210;0.0;0.0;0.0
3446_7.txt;31;1;0;32;916;0.03;0.0;0.0
7979_9.txt;8;1;1;10;297;0.03;0.0;0.0
6201_9.txt;47;0;0;47;633;0.07;0.0;0.0
6318_7.txt;5;0;0;5;339;0.01;0.0;0.0
5745_8.txt;45;0;1;46;1015;0.04;0.0;0.0
68_10.txt;12;0;0;12;591;0.02;0.0;0.0
2964_8.txt;0;0;0;0;123;0.0;0.0;0.0
8517_8.txt;14;0;0;14;269;0.05;0.0;0.0
672_9.txt;5;0;0;5;159;0.03;0.0;0.0
1775_9.txt;13;0;2;15;154;0.08;0.0;0.01
10071_9.txt;0;2;0;2;252;0.0;0.01;0.0
7793_10.txt;2;1;0;3;162;0.01;0.01;0.0
3130_9.txt;5;1;0;6;343;0.01;0.0;0.0
6692_9.txt;43;0;0;43;815;0.05;0.0;0.0
8816_7.txt;5;6;4;15;228;0.02;0.03;0.02
3511_8.txt;14;0;2;16;92;0.15;0.0;0.02
11586_9.txt;24;3;1;28;1120;0.02;0.0;0.0
7559_10.txt;6;0;0;6;88;0.07;0.0;0.0
2408_8.txt;20;0;4;24;226;0.09;0.0;0.02
11254_8.txt;39;1;7;47;492;0.08;0.0;0.01
6103_10.txt;7;2;0;9;169;0.04;0.01;0.0
7395_8.txt;2;2;0;4;207;0.01;0.01;0.0
115_10.txt;6;0;0;6;149;0.04;0.0;0.0
5944_9.txt;18;0;5;23;573;0.03;0.0;0.01
12231_10.txt;0;0;0;0;54;0.0;0.0;0.0
7621_10.txt;2;1;0;3;822;0.0;0.0;0.0
5742_10.txt;7;0;0;7;102;0.07;0.0;0.0
12437_7.txt;9;0;0;9;333;0.03;0.0;0.0
11330_8.txt;2;1;0;3;173;0.01;0.01;0.0
6329_10.txt;1;1;0;2;261;0.0;0.0;0.0
2662_10.txt;90;3;4;97;1937;0.05;0.0;0.0
4079_9.txt;4;1;2;7;307;0.01;0.0;0.01
8344_10.txt;8;0;0;8;179;0.04;0.0;0.0
4919_7.txt;4;3;0;7;268;0.01;0.01;0.0
5755_7.txt;12;1;1;14;281;0.04;0.0;0.0
3308_8.txt;2;7;4;13;461;0.0;0.02;0.01
12331_8.txt;2;0;1;3;161;0.01;0.0;0.01
3863_7.txt;9;2;0;11;179;0.05;0.01;0.0
2889_10.txt;4;0;0;4;154;0.03;0.0;0.0
5872_9.txt;8;0;0;8;211;0.04;0.0;0.0
6001_7.txt;7;3;1;11;211;0.03;0.01;0.0
5641_7.txt;6;0;0;6;200;0.03;0.0;0.0
11439_8.txt;14;0;9;23;347;0.04;0.0;0.03
4968_10.txt;3;0;0;3;130;0.02;0.0;0.0
8794_9.txt;8;8;2;18;221;0.04;0.04;0.01
11805_10.txt;1;0;0;1;127;0.01;0.0;0.0
5769_9.txt;3;0;0;3;183;0.02;0.0;0.0
5692_7.txt;13;0;2;15;221;0.06;0.0;0.01
1864_10.txt;6;0;0;6;138;0.04;0.0;0.0
6423_7.txt;23;1;0;24;256;0.09;0.0;0.0
5502_10.txt;2;1;0;3;138;0.01;0.01;0.0
11314_8.txt;11;3;0;14;407;0.03;0.01;0.0
10578_7.txt;10;0;2;12;261;0.04;0.0;0.01
2630_8.txt;3;1;0;4;146;0.02;0.01;0.0
2723_7.txt;13;1;0;14;165;0.08;0.01;0.0
9587_10.txt;4;2;2;8;178;0.02;0.01;0.01
11576_7.txt;8;1;0;9;176;0.05;0.01;0.0
2422_9.txt;12;0;0;12;179;0.07;0.0;0.0
8524_10.txt;8;0;0;8;162;0.05;0.0;0.0
10840_9.txt;26;0;2;28;441;0.06;0.0;0.0
3076_8.txt;19;0;2;21;422;0.05;0.0;0.0
12081_8.txt;16;1;0;17;286;0.06;0.0;0.0
674_10.txt;1;0;0;1;422;0.0;0.0;0.0
302_10.txt;6;0;0;6;91;0.07;0.0;0.0
3510_7.txt;0;1;0;1;219;0.0;0.0;0.0
6931_8.txt;11;0;0;11;160;0.07;0.0;0.0
9718_7.txt;9;0;0;9;297;0.03;0.0;0.0
9561_8.txt;11;1;1;13;232;0.05;0.0;0.0
5352_7.txt;6;0;1;7;380;0.02;0.0;0.0
5762_8.txt;2;0;0;2;238;0.01;0.0;0.0
3449_8.txt;52;3;10;65;758;0.07;0.0;0.01
7103_7.txt;4;1;0;5;124;0.03;0.01;0.0
2901_7.txt;20;1;6;27;233;0.09;0.0;0.03
3964_7.txt;1;0;1;2;128;0.01;0.0;0.01
1903_10.txt;6;0;0;6;63;0.1;0.0;0.0
6629_10.txt;0;0;0;0;131;0.0;0.0;0.0
12419_10.txt;4;4;0;8;234;0.02;0.02;0.0
1662_7.txt;9;0;0;9;201;0.04;0.0;0.0
779_10.txt;22;9;0;31;295;0.07;0.03;0.0
771_7.txt;3;1;2;6;238;0.01;0.0;0.01
6392_10.txt;6;0;0;6;328;0.02;0.0;0.0
4635_7.txt;32;13;0;45;707;0.05;0.02;0.0
1809_10.txt;6;0;4;10;158;0.04;0.0;0.03
8041_7.txt;11;1;0;12;260;0.04;0.0;0.0
10347_9.txt;14;0;0;14;292;0.05;0.0;0.0
11877_10.txt;8;5;0;13;148;0.05;0.03;0.0
10698_9.txt;5;1;9;15;327;0.02;0.0;0.03
11248_10.txt;3;2;4;9;304;0.01;0.01;0.01
8103_10.txt;23;1;0;24;564;0.04;0.0;0.0
7215_7.txt;35;8;3;46;746;0.05;0.01;0.0
2427_10.txt;13;2;0;15;189;0.07;0.01;0.0
9355_7.txt;33;3;0;36;660;0.05;0.0;0.0
96_10.txt;4;0;1;5;193;0.02;0.0;0.01
11208_8.txt;3;0;3;6;266;0.01;0.0;0.01
527_9.txt;29;0;0;29;850;0.03;0.0;0.0
4231_7.txt;14;1;0;15;364;0.04;0.0;0.0
8375_8.txt;0;0;0;0;86;0.0;0.0;0.0
4151_10.txt;38;0;0;38;506;0.08;0.0;0.0
7394_9.txt;2;1;0;3;136;0.01;0.01;0.0
3756_8.txt;6;0;0;6;148;0.04;0.0;0.0
4189_8.txt;15;0;0;15;223;0.07;0.0;0.0
11044_7.txt;8;5;0;13;450;0.02;0.01;0.0
1557_10.txt;0;0;0;0;298;0.0;0.0;0.0
8005_9.txt;1;0;2;3;287;0.0;0.0;0.01
12160_10.txt;11;2;0;13;198;0.06;0.01;0.0
11452_8.txt;16;4;0;20;544;0.03;0.01;0.0
3904_10.txt;1;0;0;1;154;0.01;0.0;0.0
84_10.txt;0;0;0;0;225;0.0;0.0;0.0
2963_8.txt;0;0;0;0;47;0.0;0.0;0.0
494_9.txt;2;0;0;2;173;0.01;0.0;0.0
9010_7.txt;12;0;0;12;169;0.07;0.0;0.0
1467_9.txt;17;5;10;32;381;0.04;0.01;0.03
8682_7.txt;15;0;0;15;184;0.08;0.0;0.0
2004_10.txt;8;0;0;8;274;0.03;0.0;0.0
6187_9.txt;11;2;1;14;261;0.04;0.01;0.0
9138_10.txt;1;0;0;1;128;0.01;0.0;0.0
7780_8.txt;32;4;0;36;420;0.08;0.01;0.0
4974_10.txt;2;1;0;3;137;0.01;0.01;0.0
1430_9.txt;0;2;0;2;173;0.0;0.01;0.0
2341_8.txt;2;0;0;2;180;0.01;0.0;0.0
7524_9.txt;4;2;0;6;195;0.02;0.01;0.0
4584_10.txt;1;1;0;2;167;0.01;0.01;0.0
3980_10.txt;3;4;0;7;175;0.02;0.02;0.0
8050_10.txt;6;0;0;6;136;0.04;0.0;0.0
313_10.txt;0;4;2;6;184;0.0;0.02;0.01
6378_8.txt;8;0;0;8;132;0.06;0.0;0.0
3120_8.txt;17;0;1;18;241;0.07;0.0;0.0
12495_7.txt;0;0;0;0;214;0.0;0.0;0.0
11207_10.txt;0;0;1;1;88;0.0;0.0;0.01
11015_9.txt;14;1;0;15;149;0.09;0.01;0.0
1130_10.txt;11;0;0;11;135;0.08;0.0;0.0
721_10.txt;4;0;3;7;223;0.02;0.0;0.01
1792_10.txt;0;0;0;0;190;0.0;0.0;0.0
5051_7.txt;47;5;2;54;916;0.05;0.01;0.0
332_10.txt;4;0;0;4;113;0.04;0.0;0.0
6350_8.txt;2;0;0;2;123;0.02;0.0;0.0
12237_10.txt;4;3;2;9;162;0.02;0.02;0.01
2377_10.txt;6;0;0;6;164;0.04;0.0;0.0
1605_10.txt;11;2;1;14;112;0.1;0.02;0.01
12463_8.txt;12;2;0;14;215;0.06;0.01;0.0
6248_7.txt;0;1;0;1;334;0.0;0.0;0.0
4318_10.txt;0;2;0;2;186;0.0;0.01;0.0
11197_8.txt;18;0;0;18;261;0.07;0.0;0.0
2538_10.txt;24;1;0;25;261;0.09;0.0;0.0
829_7.txt;7;1;0;8;142;0.05;0.01;0.0
9789_10.txt;4;0;0;4;138;0.03;0.0;0.0
11628_10.txt;16;2;0;18;374;0.04;0.01;0.0
39_9.txt;6;0;0;6;146;0.04;0.0;0.0
792_8.txt;1;0;0;1;65;0.02;0.0;0.0
992_7.txt;5;0;0;5;101;0.05;0.0;0.0
4118_10.txt;22;3;0;25;962;0.02;0.0;0.0
9986_9.txt;4;0;0;4;126;0.03;0.0;0.0
1339_9.txt;46;2;5;53;496;0.09;0.0;0.01
3145_10.txt;24;1;0;25;680;0.04;0.0;0.0
9777_8.txt;2;1;0;3;102;0.02;0.01;0.0
2194_10.txt;0;2;0;2;47;0.0;0.04;0.0
12219_10.txt;0;3;0;3;878;0.0;0.0;0.0
2465_10.txt;28;0;1;29;717;0.04;0.0;0.0
5033_10.txt;3;0;0;3;145;0.02;0.0;0.0
6264_7.txt;6;2;0;8;318;0.02;0.01;0.0
12033_8.txt;3;0;0;3;239;0.01;0.0;0.0
10700_8.txt;5;0;0;5;115;0.04;0.0;0.0
11747_8.txt;0;0;0;0;158;0.0;0.0;0.0
9905_10.txt;11;2;0;13;324;0.03;0.01;0.0
2945_10.txt;4;0;1;5;169;0.02;0.0;0.01
10149_9.txt;2;0;0;2;102;0.02;0.0;0.0
7930_7.txt;1;0;0;1;319;0.0;0.0;0.0
11826_10.txt;10;0;3;13;328;0.03;0.0;0.01
10762_10.txt;0;1;0;1;529;0.0;0.0;0.0
4343_9.txt;6;0;0;6;172;0.03;0.0;0.0
5780_10.txt;8;0;0;8;131;0.06;0.0;0.0
9874_8.txt;7;1;0;8;124;0.06;0.01;0.0
4311_9.txt;12;0;1;13;324;0.04;0.0;0.0
4771_10.txt;7;0;0;7;120;0.06;0.0;0.0
6634_10.txt;3;0;0;3;165;0.02;0.0;0.0
8264_9.txt;0;0;1;1;175;0.0;0.0;0.01
4877_9.txt;0;1;0;1;172;0.0;0.01;0.0
6907_8.txt;19;1;2;22;202;0.09;0.0;0.01
1334_8.txt;2;0;0;2;113;0.02;0.0;0.0
680_8.txt;13;2;0;15;193;0.07;0.01;0.0
1834_8.txt;14;0;2;16;133;0.11;0.0;0.02
5326_10.txt;20;3;1;24;353;0.06;0.01;0.0
6429_7.txt;0;0;0;0;119;0.0;0.0;0.0
2440_10.txt;10;3;4;17;189;0.05;0.02;0.02
9942_7.txt;0;1;0;1;119;0.0;0.01;0.0
4565_8.txt;57;2;0;59;956;0.06;0.0;0.0
2272_7.txt;10;0;0;10;115;0.09;0.0;0.0
11522_8.txt;8;0;2;10;126;0.06;0.0;0.02
1944_8.txt;0;1;0;1;200;0.0;0.01;0.0
11160_9.txt;4;1;0;5;97;0.04;0.01;0.0
10109_10.txt;20;0;0;20;124;0.16;0.0;0.0
7322_10.txt;20;0;0;20;301;0.07;0.0;0.0
2778_8.txt;16;1;0;17;311;0.05;0.0;0.0
8115_10.txt;9;0;0;9;900;0.01;0.0;0.0
2716_10.txt;11;2;0;13;114;0.1;0.02;0.0
9020_7.txt;7;0;2;9;132;0.05;0.0;0.02
2596_10.txt;7;0;0;7;61;0.11;0.0;0.0
6272_7.txt;0;0;1;1;81;0.0;0.0;0.01
7735_10.txt;6;0;0;6;102;0.06;0.0;0.0
3087_10.txt;0;0;3;3;141;0.0;0.0;0.02
4352_10.txt;10;0;0;10;189;0.05;0.0;0.0
11533_8.txt;4;0;0;4;284;0.01;0.0;0.0
10133_7.txt;0;0;0;0;124;0.0;0.0;0.0
4175_8.txt;4;0;0;4;275;0.01;0.0;0.0
2312_9.txt;0;0;0;0;124;0.0;0.0;0.0
7749_8.txt;20;2;0;22;193;0.1;0.01;0.0
3017_7.txt;11;0;4;15;249;0.04;0.0;0.02
7838_8.txt;9;0;0;9;223;0.04;0.0;0.0
11072_8.txt;2;0;0;2;149;0.01;0.0;0.0
5740_10.txt;35;3;0;38;593;0.06;0.01;0.0
10701_10.txt;6;3;0;9;145;0.04;0.02;0.0
5091_8.txt;10;0;0;10;176;0.06;0.0;0.0
8525_10.txt;3;0;0;3;171;0.02;0.0;0.0
4779_10.txt;6;3;0;9;362;0.02;0.01;0.0
9844_8.txt;0;0;0;0;103;0.0;0.0;0.0
8437_10.txt;1;0;0;1;73;0.01;0.0;0.0
3479_9.txt;14;0;0;14;154;0.09;0.0;0.0
737_8.txt;12;0;1;13;255;0.05;0.0;0.0
11663_8.txt;28;3;0;31;792;0.04;0.0;0.0
8839_8.txt;14;0;0;14;324;0.04;0.0;0.0
808_9.txt;6;0;0;6;197;0.03;0.0;0.0
760_7.txt;0;0;0;0;128;0.0;0.0;0.0
11361_10.txt;3;0;0;3;100;0.03;0.0;0.0
1906_10.txt;11;0;0;11;357;0.03;0.0;0.0
5320_10.txt;1;0;0;1;133;0.01;0.0;0.0
7113_8.txt;0;4;8;12;197;0.0;0.02;0.04
8547_10.txt;1;0;0;1;176;0.01;0.0;0.0
2397_9.txt;7;11;0;18;254;0.03;0.04;0.0
9872_10.txt;0;0;0;0;99;0.0;0.0;0.0
9101_9.txt;2;2;3;7;435;0.0;0.0;0.01
6885_9.txt;0;0;0;0;185;0.0;0.0;0.0
2987_10.txt;2;0;0;2;92;0.02;0.0;0.0
2466_9.txt;2;0;0;2;142;0.01;0.0;0.0
6306_10.txt;0;0;0;0;145;0.0;0.0;0.0
8655_9.txt;6;0;0;6;213;0.03;0.0;0.0
2688_8.txt;0;0;0;0;105;0.0;0.0;0.0
839_7.txt;7;0;0;7;181;0.04;0.0;0.0
6028_9.txt;7;0;0;7;334;0.02;0.0;0.0
4718_7.txt;2;1;1;4;159;0.01;0.01;0.01
9676_10.txt;8;0;0;8;171;0.05;0.0;0.0
11114_10.txt;11;1;2;14;487;0.02;0.0;0.0
710_9.txt;5;0;0;5;231;0.02;0.0;0.0
11604_8.txt;17;3;0;20;356;0.05;0.01;0.0
7889_10.txt;7;0;0;7;206;0.03;0.0;0.0
4120_9.txt;5;1;0;6;242;0.02;0.0;0.0
1060_10.txt;5;2;3;10;145;0.03;0.01;0.02
219_8.txt;12;0;0;12;209;0.06;0.0;0.0
8164_8.txt;0;0;0;0;105;0.0;0.0;0.0
7811_7.txt;25;3;0;28;304;0.08;0.01;0.0
7718_10.txt;17;2;2;21;593;0.03;0.0;0.0
5261_10.txt;4;1;0;5;137;0.03;0.01;0.0
9273_7.txt;1;1;0;2;195;0.01;0.01;0.0
1074_10.txt;0;0;0;0;61;0.0;0.0;0.0
8404_10.txt;2;0;0;2;127;0.02;0.0;0.0
10047_10.txt;0;0;0;0;209;0.0;0.0;0.0
7925_7.txt;3;0;0;3;89;0.03;0.0;0.0
384_8.txt;29;1;0;30;187;0.16;0.01;0.0
1884_8.txt;25;0;0;25;283;0.09;0.0;0.0
12152_9.txt;2;0;2;4;166;0.01;0.0;0.01
1131_7.txt;10;0;0;10;170;0.06;0.0;0.0
7458_10.txt;14;0;0;14;147;0.1;0.0;0.0
9564_10.txt;3;0;0;3;181;0.02;0.0;0.0
9924_9.txt;1;0;0;1;393;0.0;0.0;0.0
2710_7.txt;10;2;1;13;249;0.04;0.01;0.0
3959_9.txt;1;0;0;1;61;0.02;0.0;0.0
947_10.txt;13;0;0;13;179;0.07;0.0;0.0
1770_10.txt;44;2;2;48;1052;0.04;0.0;0.0
9940_9.txt;0;0;0;0;146;0.0;0.0;0.0
1922_9.txt;56;1;0;57;512;0.11;0.0;0.0
5178_10.txt;10;0;0;10;197;0.05;0.0;0.0
9751_7.txt;35;7;10;52;734;0.05;0.01;0.01
3969_8.txt;6;0;0;6;133;0.05;0.0;0.0
6097_10.txt;3;0;2;5;148;0.02;0.0;0.01
10258_10.txt;7;5;3;15;520;0.01;0.01;0.01
6091_7.txt;5;0;0;5;254;0.02;0.0;0.0
3864_7.txt;64;2;0;66;474;0.14;0.0;0.0
2717_10.txt;2;0;0;2;161;0.01;0.0;0.0
6082_9.txt;11;0;0;11;184;0.06;0.0;0.0
12165_10.txt;2;1;0;3;297;0.01;0.0;0.0
10016_8.txt;3;0;0;3;141;0.02;0.0;0.0
2047_10.txt;0;0;2;2;209;0.0;0.0;0.01
53_10.txt;13;0;1;14;193;0.07;0.0;0.01
11972_10.txt;0;0;0;0;216;0.0;0.0;0.0
5520_9.txt;5;5;2;12;503;0.01;0.01;0.0
9037_8.txt;14;3;0;17;768;0.02;0.0;0.0
11430_8.txt;0;1;0;1;138;0.0;0.01;0.0
7116_9.txt;15;2;0;17;804;0.02;0.0;0.0
9337_10.txt;0;4;3;7;152;0.0;0.03;0.02
10656_7.txt;17;1;0;18;188;0.09;0.01;0.0
10884_8.txt;4;1;0;5;415;0.01;0.0;0.0
2461_10.txt;26;2;3;31;334;0.08;0.01;0.01
3456_9.txt;13;0;3;16;232;0.06;0.0;0.01
2542_10.txt;14;2;0;16;170;0.08;0.01;0.0
4022_8.txt;6;0;0;6;139;0.04;0.0;0.0
6835_10.txt;17;3;0;20;547;0.03;0.01;0.0
8009_9.txt;9;4;0;13;350;0.03;0.01;0.0
9900_10.txt;9;0;0;9;353;0.03;0.0;0.0
11992_10.txt;0;0;0;0;139;0.0;0.0;0.0
9572_8.txt;12;7;0;19;597;0.02;0.01;0.0
1954_10.txt;2;0;0;2;226;0.01;0.0;0.0
10135_7.txt;4;0;0;4;153;0.03;0.0;0.0
8360_9.txt;5;0;0;5;132;0.04;0.0;0.0
2088_8.txt;16;0;0;16;280;0.06;0.0;0.0
4614_7.txt;29;0;0;29;276;0.11;0.0;0.0
469_7.txt;2;0;0;2;66;0.03;0.0;0.0
5806_7.txt;0;0;0;0;81;0.0;0.0;0.0
5043_7.txt;9;2;3;14;153;0.06;0.01;0.02
12075_7.txt;15;2;0;17;245;0.06;0.01;0.0
7183_7.txt;17;1;4;22;351;0.05;0.0;0.01
3378_7.txt;2;0;0;2;133;0.02;0.0;0.0
5816_10.txt;5;0;0;5;212;0.02;0.0;0.0
8591_7.txt;0;1;2;3;153;0.0;0.01;0.01
2985_8.txt;8;1;0;9;229;0.03;0.0;0.0
11786_8.txt;5;0;0;5;194;0.03;0.0;0.0
6659_10.txt;7;2;0;9;223;0.03;0.01;0.0
11268_8.txt;15;0;0;15;227;0.07;0.0;0.0
11840_10.txt;1;0;1;2;455;0.0;0.0;0.0
7710_8.txt;41;7;9;57;893;0.05;0.01;0.01
716_10.txt;1;0;0;1;64;0.02;0.0;0.0
895_10.txt;0;0;0;0;152;0.0;0.0;0.0
8193_10.txt;53;10;1;64;1109;0.05;0.01;0.0
10106_8.txt;8;0;0;8;302;0.03;0.0;0.0
12321_10.txt;30;3;3;36;544;0.06;0.01;0.01
2301_10.txt;0;0;0;0;148;0.0;0.0;0.0
1438_7.txt;9;0;1;10;114;0.08;0.0;0.01
5322_10.txt;5;0;0;5;132;0.04;0.0;0.0
6171_8.txt;4;2;2;8;270;0.01;0.01;0.01
4492_10.txt;11;0;0;11;317;0.03;0.0;0.0
5484_10.txt;16;5;3;24;210;0.08;0.02;0.01
957_10.txt;0;0;0;0;55;0.0;0.0;0.0
12136_9.txt;35;2;4;41;570;0.06;0.0;0.01
2486_10.txt;5;0;0;5;208;0.02;0.0;0.0
10320_7.txt;14;2;1;17;302;0.05;0.01;0.0
12239_10.txt;0;0;0;0;165;0.0;0.0;0.0
8597_9.txt;12;0;2;14;360;0.03;0.0;0.01
6942_10.txt;19;1;0;20;302;0.06;0.0;0.0
3132_9.txt;9;0;3;12;227;0.04;0.0;0.01
8016_10.txt;0;0;1;1;162;0.0;0.0;0.01
6660_8.txt;10;1;0;11;150;0.07;0.01;0.0
1128_10.txt;5;0;1;6;124;0.04;0.0;0.01
3149_8.txt;27;2;4;33;472;0.06;0.0;0.01
8931_9.txt;8;0;0;8;345;0.02;0.0;0.0
4573_10.txt;11;1;0;12;333;0.03;0.0;0.0
2610_9.txt;18;2;4;24;282;0.06;0.01;0.01
7235_8.txt;6;0;0;6;193;0.03;0.0;0.0
7696_8.txt;25;0;2;27;333;0.08;0.0;0.01
512_10.txt;0;1;0;1;202;0.0;0.0;0.0
2156_10.txt;1;1;0;2;209;0.0;0.0;0.0
2818_7.txt;10;1;0;11;516;0.02;0.0;0.0
8422_10.txt;9;2;0;11;183;0.05;0.01;0.0
1337_7.txt;19;1;4;24;392;0.05;0.0;0.01
511_10.txt;12;0;0;12;160;0.07;0.0;0.0
7451_9.txt;16;1;0;17;182;0.09;0.01;0.0
11773_8.txt;0;0;0;0;150;0.0;0.0;0.0
2811_10.txt;0;0;0;0;197;0.0;0.0;0.0
7281_10.txt;7;0;0;7;283;0.02;0.0;0.0
9576_9.txt;2;0;0;2;120;0.02;0.0;0.0
5673_9.txt;8;0;0;8;193;0.04;0.0;0.0
8698_10.txt;18;2;0;20;160;0.11;0.01;0.0
8866_9.txt;2;0;2;4;152;0.01;0.0;0.01
3336_7.txt;29;0;27;56;1102;0.03;0.0;0.02
4729_10.txt;4;2;2;8;169;0.02;0.01;0.01
2029_8.txt;2;0;0;2;147;0.01;0.0;0.0
3762_8.txt;4;2;0;6;206;0.02;0.01;0.0
10030_10.txt;7;0;0;7;517;0.01;0.0;0.0
1243_9.txt;15;3;0;18;219;0.07;0.01;0.0
2442_10.txt;0;3;1;4;134;0.0;0.02;0.01
3187_7.txt;8;4;0;12;258;0.03;0.02;0.0
427_10.txt;0;1;0;1;75;0.0;0.01;0.0
11409_9.txt;12;0;0;12;115;0.1;0.0;0.0
3575_10.txt;28;0;1;29;374;0.07;0.0;0.0
7960_10.txt;7;2;2;11;288;0.02;0.01;0.01
9965_10.txt;0;4;0;4;213;0.0;0.02;0.0
8767_10.txt;4;1;0;5;213;0.02;0.0;0.0
6855_10.txt;0;0;0;0;60;0.0;0.0;0.0
5031_10.txt;1;0;0;1;122;0.01;0.0;0.0
9910_10.txt;2;0;0;2;53;0.04;0.0;0.0
5585_7.txt;4;0;0;4;286;0.01;0.0;0.0
9953_10.txt;1;0;0;1;51;0.02;0.0;0.0
942_10.txt;3;2;0;5;88;0.03;0.02;0.0
5671_9.txt;8;0;0;8;136;0.06;0.0;0.0
2462_10.txt;22;1;0;23;563;0.04;0.0;0.0
1793_9.txt;4;0;0;4;148;0.03;0.0;0.0
4401_9.txt;10;0;2;12;152;0.07;0.0;0.01
608_8.txt;7;0;0;7;172;0.04;0.0;0.0
9663_10.txt;0;0;0;0;42;0.0;0.0;0.0
9162_10.txt;11;1;1;13;199;0.06;0.01;0.01
2409_9.txt;9;0;0;9;170;0.05;0.0;0.0
7953_9.txt;19;0;0;19;202;0.09;0.0;0.0
7362_10.txt;5;1;0;6;189;0.03;0.01;0.0
8166_10.txt;2;0;0;2;141;0.01;0.0;0.0
7474_9.txt;6;0;0;6;188;0.03;0.0;0.0
5631_8.txt;10;1;0;11;177;0.06;0.01;0.0
7212_9.txt;7;1;0;8;353;0.02;0.0;0.0
1092_10.txt;12;8;0;20;560;0.02;0.01;0.0
8744_7.txt;0;4;2;6;114;0.0;0.04;0.02
5164_10.txt;3;8;3;14;242;0.01;0.03;0.01
8313_10.txt;0;0;0;0;148;0.0;0.0;0.0
11191_10.txt;13;0;1;14;166;0.08;0.0;0.01
2950_10.txt;13;0;0;13;197;0.07;0.0;0.0
1488_10.txt;0;1;0;1;99;0.0;0.01;0.0
7415_8.txt;0;0;1;1;175;0.0;0.0;0.01
11034_9.txt;2;0;0;2;74;0.03;0.0;0.0
7009_10.txt;1;1;0;2;204;0.0;0.0;0.0
8120_7.txt;2;1;0;3;218;0.01;0.0;0.0
11054_7.txt;0;0;0;0;156;0.0;0.0;0.0
11739_8.txt;23;5;3;31;419;0.05;0.01;0.01
12280_9.txt;6;0;0;6;248;0.02;0.0;0.0
11274_9.txt;8;1;0;9;442;0.02;0.0;0.0
6920_8.txt;2;0;0;2;43;0.05;0.0;0.0
11488_10.txt;10;1;4;15;468;0.02;0.0;0.01
6456_10.txt;4;2;0;6;496;0.01;0.0;0.0
2015_8.txt;3;1;0;4;151;0.02;0.01;0.0
2213_9.txt;9;0;0;9;135;0.07;0.0;0.0
3097_9.txt;2;0;0;2;144;0.01;0.0;0.0
4497_7.txt;6;0;2;8;206;0.03;0.0;0.01
7419_10.txt;0;5;0;5;241;0.0;0.02;0.0
1659_7.txt;0;0;0;0;110;0.0;0.0;0.0
3692_10.txt;0;3;0;3;380;0.0;0.01;0.0
8875_9.txt;4;0;0;4;56;0.07;0.0;0.0
9790_9.txt;18;2;0;20;419;0.04;0.0;0.0
2421_9.txt;12;0;0;12;474;0.03;0.0;0.0
11763_7.txt;10;1;0;11;149;0.07;0.01;0.0
6418_10.txt;2;0;0;2;186;0.01;0.0;0.0
7730_7.txt;2;1;0;3;221;0.01;0.0;0.0
5475_8.txt;27;5;7;39;561;0.05;0.01;0.01
8056_8.txt;19;1;0;20;195;0.1;0.01;0.0
4587_10.txt;4;0;0;4;166;0.02;0.0;0.0
10184_9.txt;41;8;2;51;708;0.06;0.01;0.0
388_8.txt;2;8;0;10;200;0.01;0.04;0.0
2491_8.txt;1;0;0;1;281;0.0;0.0;0.0
7203_9.txt;0;0;0;0;52;0.0;0.0;0.0
7883_10.txt;4;0;0;4;137;0.03;0.0;0.0
12448_10.txt;5;1;0;6;404;0.01;0.0;0.0
4773_10.txt;3;0;0;3;108;0.03;0.0;0.0
370_10.txt;12;0;1;13;132;0.09;0.0;0.01
552_8.txt;26;3;1;30;1064;0.02;0.0;0.0
12390_8.txt;17;2;2;21;199;0.09;0.01;0.01
1236_7.txt;6;1;0;7;113;0.05;0.01;0.0
7700_10.txt;2;0;0;2;261;0.01;0.0;0.0
335_10.txt;0;2;0;2;221;0.0;0.01;0.0
11052_9.txt;0;0;0;0;270;0.0;0.0;0.0
10237_10.txt;13;2;7;22;465;0.03;0.0;0.02
891_10.txt;2;0;0;2;65;0.03;0.0;0.0
10796_9.txt;4;0;7;11;130;0.03;0.0;0.05
6389_9.txt;0;0;0;0;149;0.0;0.0;0.0
1711_8.txt;25;3;0;28;426;0.06;0.01;0.0
6796_8.txt;15;0;6;21;341;0.04;0.0;0.02
3099_10.txt;2;1;4;7;122;0.02;0.01;0.03
4139_8.txt;1;2;0;3;127;0.01;0.02;0.0
698_7.txt;9;0;0;9;198;0.05;0.0;0.0
11743_7.txt;4;0;0;4;167;0.02;0.0;0.0
4610_10.txt;2;2;0;4;250;0.01;0.01;0.0
663_8.txt;5;6;1;12;156;0.03;0.04;0.01
22_8.txt;2;0;0;2;140;0.01;0.0;0.0
4675_9.txt;7;0;0;7;250;0.03;0.0;0.0
444_10.txt;28;1;1;30;304;0.09;0.0;0.0
5510_10.txt;17;14;0;31;612;0.03;0.02;0.0
10272_10.txt;1;0;0;1;132;0.01;0.0;0.0
30_7.txt;10;0;0;10;145;0.07;0.0;0.0
7892_7.txt;5;0;0;5;197;0.03;0.0;0.0
5056_8.txt;10;2;0;12;171;0.06;0.01;0.0
1997_9.txt;26;3;1;30;614;0.04;0.0;0.0
11997_10.txt;0;0;0;0;34;0.0;0.0;0.0
5487_10.txt;0;0;0;0;123;0.0;0.0;0.0
10273_8.txt;6;0;3;9;430;0.01;0.0;0.01
706_10.txt;3;0;0;3;141;0.02;0.0;0.0
2154_10.txt;1;0;0;1;166;0.01;0.0;0.0
3495_7.txt;0;0;0;0;38;0.0;0.0;0.0
3879_8.txt;6;0;0;6;123;0.05;0.0;0.0
9072_9.txt;1;0;0;1;360;0.0;0.0;0.0
12438_8.txt;2;0;0;2;146;0.01;0.0;0.0
7351_10.txt;14;0;0;14;124;0.11;0.0;0.0
746_10.txt;4;0;2;6;212;0.02;0.0;0.01
1506_7.txt;1;0;0;1;362;0.0;0.0;0.0
10579_10.txt;30;6;4;40;543;0.06;0.01;0.01
9147_10.txt;13;1;0;14;364;0.04;0.0;0.0
1971_9.txt;1;0;0;1;137;0.01;0.0;0.0
7686_10.txt;11;6;0;17;540;0.02;0.01;0.0
3967_7.txt;4;0;2;6;181;0.02;0.0;0.01
2021_8.txt;10;0;2;12;400;0.03;0.0;0.01
10927_10.txt;4;1;4;9;124;0.03;0.01;0.03
5547_8.txt;8;1;0;9;166;0.05;0.01;0.0
7461_10.txt;0;0;0;0;74;0.0;0.0;0.0
2266_8.txt;34;6;1;41;932;0.04;0.01;0.0
4660_7.txt;3;2;0;5;224;0.01;0.01;0.0
10759_9.txt;3;7;0;10;593;0.01;0.01;0.0
9512_8.txt;3;0;0;3;186;0.02;0.0;0.0
5398_8.txt;1;0;0;1;44;0.02;0.0;0.0
6648_7.txt;13;6;0;19;651;0.02;0.01;0.0
9420_8.txt;9;0;2;11;383;0.02;0.0;0.01
2311_10.txt;4;0;0;4;118;0.03;0.0;0.0
2898_9.txt;2;0;0;2;130;0.02;0.0;0.0
679_10.txt;14;1;0;15;242;0.06;0.0;0.0
5922_8.txt;3;0;1;4;145;0.02;0.0;0.01
3010_8.txt;41;0;6;47;338;0.12;0.0;0.02
6870_8.txt;0;0;0;0;136;0.0;0.0;0.0
9056_8.txt;0;0;0;0;137;0.0;0.0;0.0
7089_9.txt;15;4;1;20;447;0.03;0.01;0.0
12370_8.txt;42;4;0;46;583;0.07;0.01;0.0
2027_10.txt;12;2;0;14;276;0.04;0.01;0.0
6542_8.txt;8;0;0;8;128;0.06;0.0;0.0
182_10.txt;4;0;2;6;204;0.02;0.0;0.01
3746_10.txt;5;0;2;7;134;0.04;0.0;0.01
11796_9.txt;22;1;0;23;198;0.11;0.01;0.0
8514_7.txt;0;0;0;0;105;0.0;0.0;0.0
9253_10.txt;5;0;0;5;168;0.03;0.0;0.0
4156_10.txt;2;0;0;2;156;0.01;0.0;0.0
7678_10.txt;5;3;0;8;252;0.02;0.01;0.0
1174_10.txt;0;2;0;2;128;0.0;0.02;0.0
311_9.txt;24;0;0;24;560;0.04;0.0;0.0
1684_10.txt;5;0;0;5;170;0.03;0.0;0.0
11698_10.txt;0;0;0;0;142;0.0;0.0;0.0
8274_10.txt;0;0;0;0;123;0.0;0.0;0.0
8713_10.txt;2;0;0;2;59;0.03;0.0;0.0
56_10.txt;6;0;0;6;186;0.03;0.0;0.0
8798_8.txt;8;5;4;17;578;0.01;0.01;0.01
4780_9.txt;0;0;0;0;111;0.0;0.0;0.0
2611_9.txt;0;1;2;3;119;0.0;0.01;0.02
2001_9.txt;5;16;1;22;265;0.02;0.06;0.0
9228_10.txt;29;3;0;32;809;0.04;0.0;0.0
3882_10.txt;0;0;0;0;80;0.0;0.0;0.0
9543_7.txt;1;0;0;1;259;0.0;0.0;0.0
1377_7.txt;0;0;0;0;155;0.0;0.0;0.0
9622_10.txt;2;0;1;3;139;0.01;0.0;0.01
2498_7.txt;12;1;0;13;338;0.04;0.0;0.0
6557_10.txt;2;2;0;4;198;0.01;0.01;0.0
1898_9.txt;16;0;0;16;140;0.11;0.0;0.0
316_10.txt;5;2;0;7;188;0.03;0.01;0.0
11089_10.txt;4;0;0;4;31;0.13;0.0;0.0
5374_8.txt;19;1;0;20;173;0.11;0.01;0.0
6711_10.txt;21;3;0;24;819;0.03;0.0;0.0
566_8.txt;29;3;2;34;314;0.09;0.01;0.01
7038_9.txt;7;2;0;9;159;0.04;0.01;0.0
7376_8.txt;4;0;0;4;88;0.05;0.0;0.0
11049_8.txt;22;6;0;28;850;0.03;0.01;0.0
10140_8.txt;15;0;4;19;450;0.03;0.0;0.01
4035_10.txt;2;2;0;4;227;0.01;0.01;0.0
7471_10.txt;8;0;0;8;239;0.03;0.0;0.0
4369_9.txt;6;1;0;7;225;0.03;0.0;0.0
5000_10.txt;0;1;0;1;210;0.0;0.0;0.0
2067_9.txt;10;0;0;10;149;0.07;0.0;0.0
7556_8.txt;0;0;0;0;136;0.0;0.0;0.0
8472_10.txt;0;0;0;0;138;0.0;0.0;0.0
8838_9.txt;12;0;0;12;180;0.07;0.0;0.0
4665_10.txt;3;0;0;3;57;0.05;0.0;0.0
3596_8.txt;8;0;0;8;275;0.03;0.0;0.0
8923_8.txt;6;0;0;6;147;0.04;0.0;0.0
2261_10.txt;2;0;0;2;219;0.01;0.0;0.0
2231_10.txt;0;4;0;4;489;0.0;0.01;0.0
1552_8.txt;0;0;0;0;45;0.0;0.0;0.0
156_8.txt;13;0;0;13;516;0.03;0.0;0.0
8142_10.txt;0;0;0;0;95;0.0;0.0;0.0
7430_10.txt;2;2;0;4;155;0.01;0.01;0.0
3474_10.txt;10;1;0;11;78;0.13;0.01;0.0
1495_9.txt;52;0;1;53;857;0.06;0.0;0.0
6962_7.txt;9;0;0;9;322;0.03;0.0;0.0
1517_7.txt;39;1;2;42;575;0.07;0.0;0.0
7097_9.txt;14;0;0;14;495;0.03;0.0;0.0
10555_8.txt;32;0;0;32;1346;0.02;0.0;0.0
9266_9.txt;8;7;0;15;370;0.02;0.02;0.0
8843_7.txt;5;0;2;7;155;0.03;0.0;0.01
8234_7.txt;2;0;0;2;145;0.01;0.0;0.0
2373_7.txt;5;2;4;11;692;0.01;0.0;0.01
5580_7.txt;12;0;0;12;487;0.02;0.0;0.0
4063_8.txt;18;3;1;22;452;0.04;0.01;0.0
10769_10.txt;15;1;0;16;147;0.1;0.01;0.0
9364_9.txt;43;1;3;47;1088;0.04;0.0;0.0
8936_8.txt;5;0;0;5;151;0.03;0.0;0.0
11462_10.txt;3;0;6;9;368;0.01;0.0;0.02
10804_10.txt;5;1;5;11;233;0.02;0.0;0.02
11319_8.txt;39;4;2;45;709;0.06;0.01;0.0
3658_10.txt;2;1;0;3;163;0.01;0.01;0.0
5851_10.txt;22;0;3;25;443;0.05;0.0;0.01
9315_7.txt;6;0;0;6;147;0.04;0.0;0.0
5992_7.txt;0;0;0;0;217;0.0;0.0;0.0
3254_9.txt;0;0;0;0;47;0.0;0.0;0.0
4230_10.txt;11;0;0;11;137;0.08;0.0;0.0
7042_10.txt;14;6;0;20;822;0.02;0.01;0.0
10869_7.txt;19;0;6;25;164;0.12;0.0;0.04
4489_9.txt;0;0;0;0;148;0.0;0.0;0.0
8541_10.txt;10;0;0;10;168;0.06;0.0;0.0
5396_9.txt;0;0;0;0;123;0.0;0.0;0.0
6324_8.txt;8;0;3;11;182;0.04;0.0;0.02
11508_8.txt;20;0;3;23;212;0.09;0.0;0.01
450_10.txt;2;3;0;5;176;0.01;0.02;0.0
11678_8.txt;19;1;0;20;102;0.19;0.01;0.0
1462_9.txt;4;7;2;13;146;0.03;0.05;0.01
6450_10.txt;8;0;0;8;133;0.06;0.0;0.0
7506_7.txt;18;5;11;34;1028;0.02;0.0;0.01
10095_7.txt;5;0;0;5;186;0.03;0.0;0.0
9899_7.txt;10;1;4;15;601;0.02;0.0;0.01
7136_10.txt;2;0;0;2;72;0.03;0.0;0.0
11129_10.txt;25;7;0;32;668;0.04;0.01;0.0
9738_8.txt;2;0;0;2;146;0.01;0.0;0.0
5716_8.txt;0;0;0;0;240;0.0;0.0;0.0
11640_9.txt;8;4;0;12;199;0.04;0.02;0.0
9598_10.txt;6;3;4;13;221;0.03;0.01;0.02
5961_10.txt;7;0;3;10;131;0.05;0.0;0.02
3081_9.txt;0;0;0;0;139;0.0;0.0;0.0
3563_8.txt;32;3;5;40;618;0.05;0.0;0.01
8324_8.txt;8;0;0;8;72;0.11;0.0;0.0
11498_7.txt;27;1;2;30;873;0.03;0.0;0.0
7402_8.txt;0;0;0;0;69;0.0;0.0;0.0
12250_10.txt;16;1;0;17;152;0.11;0.01;0.0
10777_9.txt;0;3;0;3;257;0.0;0.01;0.0
3735_10.txt;1;1;0;2;235;0.0;0.0;0.0
4292_7.txt;2;0;0;2;199;0.01;0.0;0.0
4100_10.txt;11;0;0;11;209;0.05;0.0;0.0
378_8.txt;21;0;0;21;327;0.06;0.0;0.0
3737_9.txt;8;1;0;9;250;0.03;0.0;0.0
191_9.txt;42;4;0;46;565;0.07;0.01;0.0
10983_10.txt;10;6;0;16;164;0.06;0.04;0.0
1454_7.txt;16;0;0;16;276;0.06;0.0;0.0
7176_10.txt;2;0;0;2;166;0.01;0.0;0.0
4979_10.txt;0;0;0;0;318;0.0;0.0;0.0
6391_8.txt;2;0;0;2;171;0.01;0.0;0.0
3190_7.txt;6;1;9;16;274;0.02;0.0;0.03
2484_10.txt;24;1;0;25;268;0.09;0.0;0.0
2196_8.txt;35;5;0;40;324;0.11;0.02;0.0
1332_8.txt;30;4;13;47;347;0.09;0.01;0.04
4795_9.txt;11;2;0;13;405;0.03;0.0;0.0
358_10.txt;6;1;0;7;145;0.04;0.01;0.0
1378_9.txt;12;1;2;15;255;0.05;0.0;0.01
9719_7.txt;14;0;0;14;178;0.08;0.0;0.0
8868_10.txt;2;0;0;2;121;0.02;0.0;0.0
5542_9.txt;10;0;3;13;175;0.06;0.0;0.02
4336_10.txt;9;0;0;9;126;0.07;0.0;0.0
5525_8.txt;4;0;0;4;160;0.03;0.0;0.0
12405_10.txt;0;0;0;0;121;0.0;0.0;0.0
11382_8.txt;15;6;3;24;803;0.02;0.01;0.0
12271_7.txt;4;0;0;4;340;0.01;0.0;0.0
702_10.txt;2;1;0;3;474;0.0;0.0;0.0
8792_8.txt;5;5;3;13;217;0.02;0.02;0.01
114_10.txt;0;2;0;2;62;0.0;0.03;0.0
4307_10.txt;21;2;0;23;213;0.1;0.01;0.0
10404_9.txt;0;5;0;5;87;0.0;0.06;0.0
584_8.txt;0;0;0;0;75;0.0;0.0;0.0
4616_10.txt;0;2;0;2;278;0.0;0.01;0.0
9322_8.txt;2;0;0;2;156;0.01;0.0;0.0
8326_7.txt;32;0;6;38;217;0.15;0.0;0.03
5273_7.txt;13;0;2;15;226;0.06;0.0;0.01
1109_7.txt;3;0;3;6;238;0.01;0.0;0.01
8099_7.txt;24;7;3;34;615;0.04;0.01;0.0
12411_7.txt;23;0;0;23;584;0.04;0.0;0.0
6435_7.txt;0;0;0;0;209;0.0;0.0;0.0
2699_10.txt;0;5;1;6;234;0.0;0.02;0.0
794_8.txt;3;0;3;6;154;0.02;0.0;0.02
10265_9.txt;6;0;0;6;78;0.08;0.0;0.0
1507_8.txt;43;0;2;45;675;0.06;0.0;0.0
7831_8.txt;15;0;0;15;144;0.1;0.0;0.0
8813_9.txt;0;1;0;1;186;0.0;0.01;0.0
11469_10.txt;0;0;1;1;271;0.0;0.0;0.0
10373_7.txt;7;1;0;8;190;0.04;0.01;0.0
3183_9.txt;27;0;0;27;689;0.04;0.0;0.0
8692_10.txt;0;1;1;2;166;0.0;0.01;0.01
157_9.txt;6;2;0;8;543;0.01;0.0;0.0
4302_8.txt;4;0;0;4;86;0.05;0.0;0.0
2327_10.txt;24;1;1;26;363;0.07;0.0;0.0
4860_10.txt;44;1;3;48;347;0.13;0.0;0.01
10926_9.txt;2;0;0;2;136;0.01;0.0;0.0
8715_10.txt;0;0;0;0;80;0.0;0.0;0.0
6852_8.txt;31;3;5;39;766;0.04;0.0;0.01
11630_8.txt;8;2;0;10;238;0.03;0.01;0.0
8074_10.txt;15;1;3;19;369;0.04;0.0;0.01
10159_7.txt;2;0;0;2;130;0.02;0.0;0.0
7371_7.txt;0;0;0;0;68;0.0;0.0;0.0
11391_8.txt;18;4;0;22;307;0.06;0.01;0.0
11112_7.txt;20;2;0;22;193;0.1;0.01;0.0
3442_10.txt;2;0;0;2;114;0.02;0.0;0.0
6087_9.txt;4;0;0;4;153;0.03;0.0;0.0
1047_8.txt;16;0;0;16;304;0.05;0.0;0.0
9130_9.txt;4;1;0;5;576;0.01;0.0;0.0
11836_10.txt;1;1;8;10;271;0.0;0.0;0.03
3779_8.txt;2;0;0;2;99;0.02;0.0;0.0
3839_7.txt;8;1;0;9;179;0.04;0.01;0.0
4409_10.txt;0;3;0;3;190;0.0;0.02;0.0
5139_9.txt;1;0;0;1;38;0.03;0.0;0.0
4325_10.txt;2;3;3;8;138;0.01;0.02;0.02
4764_10.txt;7;0;0;7;203;0.03;0.0;0.0
6976_9.txt;0;3;4;7;164;0.0;0.02;0.02
8631_7.txt;43;3;3;49;823;0.05;0.0;0.0
2608_10.txt;7;0;0;7;213;0.03;0.0;0.0
4138_10.txt;10;6;0;16;197;0.05;0.03;0.0
1600_7.txt;1;0;0;1;73;0.01;0.0;0.0
3379_7.txt;16;2;0;18;133;0.12;0.02;0.0
11218_9.txt;4;1;0;5;328;0.01;0.0;0.0
11098_10.txt;20;0;0;20;143;0.14;0.0;0.0
2857_9.txt;12;0;0;12;186;0.06;0.0;0.0
3598_10.txt;7;0;0;7;121;0.06;0.0;0.0
6368_7.txt;0;0;3;3;106;0.0;0.0;0.03
8604_10.txt;1;0;0;1;94;0.01;0.0;0.0
5857_10.txt;2;0;1;3;168;0.01;0.0;0.01
5854_8.txt;2;1;1;4;258;0.01;0.0;0.0
3153_10.txt;5;0;0;5;222;0.02;0.0;0.0
11095_7.txt;20;0;0;20;195;0.1;0.0;0.0
7219_7.txt;13;7;0;20;304;0.04;0.02;0.0
4163_9.txt;4;0;0;4;141;0.03;0.0;0.0
5097_8.txt;9;2;0;11;287;0.03;0.01;0.0
1936_10.txt;4;0;1;5;246;0.02;0.0;0.0
8988_10.txt;18;0;0;18;313;0.06;0.0;0.0
10387_7.txt;22;0;0;22;315;0.07;0.0;0.0
5746_9.txt;9;0;0;9;145;0.06;0.0;0.0
2556_8.txt;7;0;1;8;235;0.03;0.0;0.0
12312_10.txt;4;0;0;4;88;0.05;0.0;0.0
8250_8.txt;19;0;1;20;379;0.05;0.0;0.0
7785_9.txt;1;0;0;1;156;0.01;0.0;0.0
6608_7.txt;1;2;0;3;127;0.01;0.02;0.0
11546_9.txt;8;1;0;9;134;0.06;0.01;0.0
7589_8.txt;16;0;2;18;448;0.04;0.0;0.0
9690_10.txt;9;2;0;11;280;0.03;0.01;0.0
1710_7.txt;5;0;0;5;437;0.01;0.0;0.0
5549_8.txt;8;6;0;14;248;0.03;0.02;0.0
6426_8.txt;8;0;0;8;146;0.05;0.0;0.0
11164_8.txt;5;3;0;8;110;0.05;0.03;0.0
8997_10.txt;1;0;0;1;458;0.0;0.0;0.0
8227_7.txt;14;0;0;14;157;0.09;0.0;0.0
8964_8.txt;19;0;0;19;243;0.08;0.0;0.0
3965_8.txt;17;0;0;17;195;0.09;0.0;0.0
5087_7.txt;0;0;0;0;150;0.0;0.0;0.0
4611_10.txt;29;5;1;35;453;0.06;0.01;0.0
8947_9.txt;11;1;0;12;87;0.13;0.01;0.0
10822_10.txt;6;1;0;7;223;0.03;0.0;0.0
9398_9.txt;9;0;0;9;284;0.03;0.0;0.0
8438_10.txt;0;0;1;1;124;0.0;0.0;0.01
6270_8.txt;0;0;6;6;40;0.0;0.0;0.15
4802_8.txt;2;1;0;3;328;0.01;0.0;0.0
6376_10.txt;0;0;1;1;114;0.0;0.0;0.01
5571_10.txt;2;0;0;2;218;0.01;0.0;0.0
1741_9.txt;0;1;0;1;234;0.0;0.0;0.0
2136_9.txt;0;0;0;0;46;0.0;0.0;0.0
7424_10.txt;7;0;0;7;431;0.02;0.0;0.0
1302_10.txt;4;0;0;4;207;0.02;0.0;0.0
11389_7.txt;19;6;1;26;261;0.07;0.02;0.0
6410_10.txt;7;0;1;8;142;0.05;0.0;0.01
4340_8.txt;7;2;0;9;162;0.04;0.01;0.0
1707_10.txt;4;0;0;4;97;0.04;0.0;0.0
6081_9.txt;16;1;0;17;344;0.05;0.0;0.0
9291_7.txt;4;3;1;8;138;0.03;0.02;0.01
9583_8.txt;3;1;0;4;406;0.01;0.0;0.0
11322_9.txt;6;0;0;6;244;0.02;0.0;0.0
11071_10.txt;6;2;0;8;232;0.03;0.01;0.0
8143_10.txt;0;0;0;0;67;0.0;0.0;0.0
1268_7.txt;17;5;0;22;346;0.05;0.01;0.0
6168_10.txt;4;0;0;4;70;0.06;0.0;0.0
6093_8.txt;6;0;0;6;356;0.02;0.0;0.0
3515_7.txt;2;0;0;2;166;0.01;0.0;0.0
8828_10.txt;2;0;0;2;150;0.01;0.0;0.0
10752_10.txt;1;0;0;1;281;0.0;0.0;0.0
8728_7.txt;7;2;6;15;602;0.01;0.0;0.01
606_10.txt;3;0;0;3;153;0.02;0.0;0.0
2924_10.txt;6;0;0;6;126;0.05;0.0;0.0
10214_10.txt;0;1;0;1;251;0.0;0.0;0.0
5240_7.txt;2;1;0;3;149;0.01;0.01;0.0
4133_7.txt;2;2;0;4;285;0.01;0.01;0.0
7851_8.txt;5;1;0;6;173;0.03;0.01;0.0
5529_7.txt;0;3;0;3;210;0.0;0.01;0.0
3396_7.txt;2;0;0;2;140;0.01;0.0;0.0
4191_10.txt;21;7;0;28;424;0.05;0.02;0.0
1983_10.txt;11;0;0;11;211;0.05;0.0;0.0
9886_10.txt;1;6;0;7;140;0.01;0.04;0.0
9766_9.txt;14;2;6;22;765;0.02;0.0;0.01
10811_7.txt;7;0;0;7;143;0.05;0.0;0.0
11176_9.txt;6;0;0;6;383;0.02;0.0;0.0
483_8.txt;4;1;0;5;169;0.02;0.01;0.0
3217_8.txt;2;0;0;2;240;0.01;0.0;0.0
356_10.txt;0;0;0;0;136;0.0;0.0;0.0
3536_10.txt;0;0;2;2;138;0.0;0.0;0.01
2037_8.txt;4;2;4;10;191;0.02;0.01;0.02
4627_7.txt;3;5;0;8;397;0.01;0.01;0.0
3918_10.txt;26;0;1;27;394;0.07;0.0;0.0
7274_10.txt;18;2;0;20;293;0.06;0.01;0.0
306_10.txt;1;1;0;2;104;0.01;0.01;0.0
6694_10.txt;2;0;1;3;156;0.01;0.0;0.01
11239_8.txt;0;0;6;6;203;0.0;0.0;0.03
6399_7.txt;5;0;0;5;95;0.05;0.0;0.0
1485_10.txt;0;0;0;0;141;0.0;0.0;0.0
12078_8.txt;22;5;5;32;413;0.05;0.01;0.01
7387_7.txt;8;2;0;10;243;0.03;0.01;0.0
6953_7.txt;6;0;0;6;196;0.03;0.0;0.0
1364_8.txt;13;8;0;21;181;0.07;0.04;0.0
9471_7.txt;12;0;0;12;273;0.04;0.0;0.0
10177_9.txt;26;2;1;29;463;0.06;0.0;0.0
9804_10.txt;23;1;2;26;324;0.07;0.0;0.01
5918_9.txt;5;0;1;6;107;0.05;0.0;0.01
398_10.txt;0;0;0;0;78;0.0;0.0;0.0
11988_8.txt;0;0;0;0;153;0.0;0.0;0.0
193_7.txt;100;7;7;114;892;0.11;0.01;0.01
3326_8.txt;19;7;17;43;497;0.04;0.01;0.03
3930_9.txt;15;0;7;22;263;0.06;0.0;0.03
810_10.txt;22;0;16;38;656;0.03;0.0;0.02
7983_9.txt;5;0;2;7;241;0.02;0.0;0.01
632_10.txt;12;0;0;12;535;0.02;0.0;0.0
6817_10.txt;5;0;0;5;167;0.03;0.0;0.0
11037_8.txt;1;0;0;1;215;0.0;0.0;0.0
5701_8.txt;49;5;2;56;649;0.08;0.01;0.0
12044_7.txt;2;0;0;2;224;0.01;0.0;0.0
11922_10.txt;2;0;1;3;62;0.03;0.0;0.02
4642_10.txt;2;2;0;4;357;0.01;0.01;0.0
2293_7.txt;5;0;0;5;212;0.02;0.0;0.0
11853_7.txt;2;0;10;12;208;0.01;0.0;0.05
3602_7.txt;4;0;0;4;323;0.01;0.0;0.0
7386_7.txt;18;3;0;21;299;0.06;0.01;0.0
8210_7.txt;5;0;0;5;68;0.07;0.0;0.0
5505_10.txt;1;4;0;5;243;0.0;0.02;0.0
10633_9.txt;0;0;5;5;161;0.0;0.0;0.03
8126_7.txt;21;5;0;26;1015;0.02;0.0;0.0
4407_8.txt;0;2;0;2;138;0.0;0.01;0.0
10613_8.txt;16;5;3;24;372;0.04;0.01;0.01
8302_8.txt;17;2;1;20;216;0.08;0.01;0.0
133_10.txt;6;4;1;11;521;0.01;0.01;0.0
4907_8.txt;23;1;0;24;282;0.08;0.0;0.0
6777_8.txt;15;0;0;15;445;0.03;0.0;0.0
4056_7.txt;8;4;3;15;273;0.03;0.01;0.01
5414_10.txt;33;2;7;42;299;0.11;0.01;0.02
882_8.txt;0;1;0;1;148;0.0;0.01;0.0
9054_9.txt;9;0;0;9;427;0.02;0.0;0.0
5308_10.txt;2;1;0;3;49;0.04;0.02;0.0
4031_10.txt;5;2;0;7;221;0.02;0.01;0.0
11297_7.txt;16;2;2;20;641;0.02;0.0;0.0
1635_7.txt;4;4;0;8;247;0.02;0.02;0.0
5658_10.txt;9;1;3;13;244;0.04;0.0;0.01
8867_10.txt;11;0;1;12;118;0.09;0.0;0.01
6074_7.txt;8;2;0;10;102;0.08;0.02;0.0
5640_7.txt;4;1;2;7;156;0.03;0.01;0.01
9673_7.txt;11;1;2;14;257;0.04;0.0;0.01
60_8.txt;20;0;0;20;635;0.03;0.0;0.0
2345_9.txt;0;0;0;0;115;0.0;0.0;0.0
1272_7.txt;1;0;0;1;83;0.01;0.0;0.0
438_9.txt;0;2;0;2;189;0.0;0.01;0.0
7414_8.txt;0;0;0;0;80;0.0;0.0;0.0
144_8.txt;10;3;0;13;1055;0.01;0.0;0.0
4450_9.txt;0;0;0;0;158;0.0;0.0;0.0
3634_8.txt;2;0;0;2;81;0.02;0.0;0.0
8667_7.txt;21;0;1;22;414;0.05;0.0;0.0
1875_10.txt;3;1;0;4;222;0.01;0.0;0.0
8029_10.txt;5;1;3;9;235;0.02;0.0;0.01
9033_9.txt;8;0;0;8;160;0.05;0.0;0.0
7146_10.txt;3;0;1;4;69;0.04;0.0;0.01
7027_7.txt;30;1;1;32;267;0.11;0.0;0.0
10115_10.txt;2;0;3;5;121;0.02;0.0;0.02
11729_10.txt;0;0;0;0;65;0.0;0.0;0.0
3498_10.txt;2;0;0;2;62;0.03;0.0;0.0
12066_8.txt;42;6;4;52;937;0.04;0.01;0.0
1394_8.txt;13;1;0;14;577;0.02;0.0;0.0
1245_7.txt;9;0;3;12;240;0.04;0.0;0.01
8688_8.txt;16;0;0;16;330;0.05;0.0;0.0
707_8.txt;0;0;0;0;84;0.0;0.0;0.0
4629_10.txt;0;1;4;5;401;0.0;0.0;0.01
4197_8.txt;29;11;5;45;649;0.04;0.02;0.01
5636_10.txt;7;3;0;10;149;0.05;0.02;0.0
12062_10.txt;0;0;0;0;132;0.0;0.0;0.0
9709_10.txt;2;0;2;4;144;0.01;0.0;0.01
11560_9.txt;5;0;0;5;41;0.12;0.0;0.0
7871_9.txt;12;0;0;12;202;0.06;0.0;0.0
2499_10.txt;2;2;1;5;135;0.01;0.01;0.01
989_9.txt;2;0;0;2;126;0.02;0.0;0.0
9513_10.txt;11;0;0;11;120;0.09;0.0;0.0
3011_7.txt;26;1;0;27;248;0.1;0.0;0.0
9960_7.txt;0;0;0;0;246;0.0;0.0;0.0
8553_7.txt;0;0;0;0;151;0.0;0.0;0.0
10597_9.txt;0;2;2;4;191;0.0;0.01;0.01
3318_9.txt;8;3;5;16;241;0.03;0.01;0.02
2436_10.txt;0;0;0;0;165;0.0;0.0;0.0
9827_10.txt;5;0;0;5;42;0.12;0.0;0.0
17_9.txt;13;1;1;15;1031;0.01;0.0;0.0
7129_10.txt;5;2;4;11;319;0.02;0.01;0.01
8383_7.txt;16;0;0;16;409;0.04;0.0;0.0
12119_7.txt;32;0;0;32;476;0.07;0.0;0.0
6647_8.txt;16;0;0;16;136;0.12;0.0;0.0
3267_8.txt;5;0;0;5;58;0.09;0.0;0.0
11736_9.txt;12;4;0;16;321;0.04;0.01;0.0
8277_10.txt;0;0;2;2;66;0.0;0.0;0.03
6735_9.txt;18;7;4;29;421;0.04;0.02;0.01
9652_7.txt;9;1;0;10;761;0.01;0.0;0.0
128_7.txt;6;1;0;7;298;0.02;0.0;0.0
7463_10.txt;3;0;1;4;368;0.01;0.0;0.0
617_7.txt;17;1;0;18;275;0.06;0.0;0.0
6238_9.txt;1;1;0;2;94;0.01;0.01;0.0
7226_8.txt;8;0;0;8;106;0.08;0.0;0.0
11844_10.txt;0;2;0;2;235;0.0;0.01;0.0
5843_10.txt;5;0;1;6;160;0.03;0.0;0.01
10447_10.txt;0;0;0;0;260;0.0;0.0;0.0
12378_8.txt;13;0;0;13;287;0.05;0.0;0.0
1113_10.txt;21;2;0;23;280;0.07;0.01;0.0
8042_7.txt;34;2;2;38;491;0.07;0.0;0.0
10078_8.txt;5;0;2;7;320;0.02;0.0;0.01
9944_9.txt;0;0;0;0;203;0.0;0.0;0.0
1436_10.txt;19;5;3;27;215;0.09;0.02;0.01
2698_8.txt;2;0;0;2;38;0.05;0.0;0.0
1297_8.txt;2;0;0;2;138;0.01;0.0;0.0
5496_9.txt;3;7;0;10;341;0.01;0.02;0.0
9515_10.txt;8;0;1;9;301;0.03;0.0;0.0
10053_8.txt;4;0;1;5;316;0.01;0.0;0.0
6385_10.txt;0;0;3;3;120;0.0;0.0;0.03
5871_9.txt;9;0;0;9;127;0.07;0.0;0.0
8335_8.txt;15;1;1;17;148;0.1;0.01;0.01
4045_10.txt;1;0;1;2;179;0.01;0.0;0.01
3736_8.txt;31;0;1;32;1036;0.03;0.0;0.0
3419_10.txt;0;5;0;5;250;0.0;0.02;0.0
9133_9.txt;5;0;0;5;214;0.02;0.0;0.0
11726_9.txt;0;1;0;1;186;0.0;0.01;0.0
5315_9.txt;0;0;0;0;159;0.0;0.0;0.0
364_10.txt;15;1;2;18;345;0.04;0.0;0.01
5654_8.txt;2;0;1;3;143;0.01;0.0;0.01
10625_7.txt;5;2;0;7;323;0.02;0.01;0.0
6218_7.txt;13;0;2;15;134;0.1;0.0;0.01
3537_10.txt;9;0;0;9;180;0.05;0.0;0.0
4822_9.txt;33;3;1;37;682;0.05;0.0;0.0
7993_10.txt;0;7;0;7;195;0.0;0.04;0.0
559_8.txt;11;2;0;13;197;0.06;0.01;0.0
7312_10.txt;9;0;0;9;234;0.04;0.0;0.0
9254_7.txt;5;0;0;5;166;0.03;0.0;0.0
7662_10.txt;0;0;0;0;367;0.0;0.0;0.0
116_10.txt;8;0;0;8;274;0.03;0.0;0.0
8746_10.txt;0;1;0;1;54;0.0;0.02;0.0
5593_10.txt;2;0;0;2;128;0.02;0.0;0.0
5410_7.txt;23;2;1;26;577;0.04;0.0;0.0
7802_10.txt;4;5;0;9;98;0.04;0.05;0.0
10267_8.txt;3;0;0;3;154;0.02;0.0;0.0
523_10.txt;16;0;0;16;207;0.08;0.0;0.0
9477_9.txt;2;1;2;5;160;0.01;0.01;0.01
1607_9.txt;10;0;0;10;209;0.05;0.0;0.0
6257_10.txt;2;3;0;5;186;0.01;0.02;0.0
3327_10.txt;2;0;0;2;253;0.01;0.0;0.0
317_10.txt;2;1;4;7;165;0.01;0.01;0.02
1683_7.txt;5;0;0;5;299;0.02;0.0;0.0
8885_10.txt;4;0;0;4;69;0.06;0.0;0.0
11982_7.txt;14;0;4;18;231;0.06;0.0;0.02
2167_10.txt;0;0;0;0;160;0.0;0.0;0.0
7190_9.txt;8;2;0;10;192;0.04;0.01;0.0
3088_8.txt;6;0;3;9;166;0.04;0.0;0.02
1569_10.txt;7;0;2;9;146;0.05;0.0;0.01
5761_8.txt;2;0;0;2;169;0.01;0.0;0.0
5794_10.txt;1;0;0;1;47;0.02;0.0;0.0
7242_7.txt;6;1;0;7;154;0.04;0.01;0.0
10120_7.txt;13;5;3;21;361;0.04;0.01;0.01
11594_10.txt;1;0;0;1;156;0.01;0.0;0.0
1532_10.txt;19;1;0;20;191;0.1;0.01;0.0
10336_8.txt;4;2;1;7;203;0.02;0.01;0.0
6508_7.txt;3;0;0;3;172;0.02;0.0;0.0
867_8.txt;2;1;0;3;139;0.01;0.01;0.0
3818_8.txt;20;3;0;23;624;0.03;0.0;0.0
12196_10.txt;3;5;0;8;303;0.01;0.02;0.0
4985_10.txt;7;2;2;11;526;0.01;0.0;0.0
11497_10.txt;1;0;0;1;122;0.01;0.0;0.0
3005_8.txt;12;0;4;16;345;0.03;0.0;0.01
12498_10.txt;6;3;0;9;74;0.08;0.04;0.0
66_8.txt;24;0;0;24;448;0.05;0.0;0.0
9453_8.txt;10;0;0;10;251;0.04;0.0;0.0
9920_7.txt;18;4;0;22;788;0.02;0.01;0.0
3033_8.txt;4;1;0;5;66;0.06;0.02;0.0
7532_7.txt;17;4;2;23;928;0.02;0.0;0.0
7944_9.txt;1;0;0;1;299;0.0;0.0;0.0
8351_9.txt;3;1;0;4;316;0.01;0.0;0.0
12431_8.txt;5;0;3;8;117;0.04;0.0;0.03
5180_9.txt;2;4;0;6;290;0.01;0.01;0.0
1241_7.txt;6;2;0;8;331;0.02;0.01;0.0
8390_8.txt;2;0;0;2;89;0.02;0.0;0.0
8979_10.txt;0;0;0;0;210;0.0;0.0;0.0
5926_7.txt;18;0;0;18;330;0.05;0.0;0.0
4161_8.txt;38;1;0;39;1100;0.03;0.0;0.0
12418_10.txt;2;0;0;2;152;0.01;0.0;0.0
10122_7.txt;1;0;0;1;152;0.01;0.0;0.0
10742_9.txt;1;1;0;2;162;0.01;0.01;0.0
8021_7.txt;23;4;0;27;377;0.06;0.01;0.0
2955_10.txt;19;1;0;20;363;0.05;0.0;0.0
9679_10.txt;0;0;0;0;67;0.0;0.0;0.0
7951_10.txt;0;0;0;0;155;0.0;0.0;0.0
4210_9.txt;12;0;0;12;160;0.07;0.0;0.0
12342_8.txt;4;5;0;9;468;0.01;0.01;0.0
2978_10.txt;6;1;0;7;169;0.04;0.01;0.0
8704_9.txt;1;2;0;3;251;0.0;0.01;0.0
273_9.txt;9;0;0;9;182;0.05;0.0;0.0
3152_9.txt;0;0;0;0;128;0.0;0.0;0.0
12440_7.txt;10;2;0;12;395;0.03;0.01;0.0
7980_10.txt;12;1;0;13;261;0.05;0.0;0.0
11068_9.txt;36;2;0;38;773;0.05;0.0;0.0
843_10.txt;2;1;2;5;182;0.01;0.01;0.01
1002_7.txt;1;1;0;2;188;0.01;0.01;0.0
1593_10.txt;12;0;0;12;221;0.05;0.0;0.0
8844_10.txt;32;4;1;37;826;0.04;0.0;0.0
4096_10.txt;0;0;0;0;338;0.0;0.0;0.0
10244_7.txt;23;0;3;26;220;0.1;0.0;0.01
2480_8.txt;18;3;1;22;465;0.04;0.01;0.0
5974_7.txt;10;0;0;10;474;0.02;0.0;0.0
12241_10.txt;20;3;0;23;615;0.03;0.0;0.0
4077_10.txt;0;1;0;1;197;0.0;0.01;0.0
4470_8.txt;8;0;0;8;147;0.05;0.0;0.0
154_8.txt;25;1;0;26;332;0.08;0.0;0.0
3944_8.txt;2;0;0;2;143;0.01;0.0;0.0
11084_10.txt;0;1;3;4;152;0.0;0.01;0.02
4178_10.txt;0;6;0;6;125;0.0;0.05;0.0
4529_8.txt;15;1;0;16;340;0.04;0.0;0.0
10747_10.txt;11;6;1;18;255;0.04;0.02;0.0
10493_9.txt;1;0;0;1;82;0.01;0.0;0.0
4168_7.txt;8;0;1;9;112;0.07;0.0;0.01
253_7.txt;32;7;0;39;842;0.04;0.01;0.0
3220_10.txt;3;1;0;4;146;0.02;0.01;0.0
9242_10.txt;3;1;4;8;310;0.01;0.0;0.01
8961_9.txt;11;1;3;15;314;0.04;0.0;0.01
5809_10.txt;2;0;0;2;70;0.03;0.0;0.0
9450_10.txt;23;4;0;27;284;0.08;0.01;0.0
4523_10.txt;8;0;0;8;127;0.06;0.0;0.0
10263_10.txt;11;0;0;11;311;0.04;0.0;0.0
8299_7.txt;30;2;6;38;305;0.1;0.01;0.02
4212_10.txt;12;2;0;14;149;0.08;0.01;0.0
2454_10.txt;1;3;1;5;148;0.01;0.02;0.01
5256_10.txt;2;0;0;2;143;0.01;0.0;0.0
10620_10.txt;1;0;0;1;216;0.0;0.0;0.0
1980_10.txt;18;0;0;18;197;0.09;0.0;0.0
48_7.txt;0;1;0;1;164;0.0;0.01;0.0
4338_10.txt;8;0;0;8;141;0.06;0.0;0.0
12087_10.txt;6;1;1;8;160;0.04;0.01;0.01
3696_7.txt;0;2;0;2;404;0.0;0.0;0.0
8015_10.txt;2;0;0;2;83;0.02;0.0;0.0
4651_7.txt;0;2;0;2;85;0.0;0.02;0.0
3199_10.txt;18;0;3;21;267;0.07;0.0;0.01
6475_10.txt;0;0;0;0;153;0.0;0.0;0.0
6209_8.txt;11;0;0;11;276;0.04;0.0;0.0
10645_8.txt;12;21;6;39;357;0.03;0.06;0.02
4904_10.txt;2;0;0;2;143;0.01;0.0;0.0
3117_8.txt;9;0;3;12;303;0.03;0.0;0.01
5427_10.txt;8;1;1;10;174;0.05;0.01;0.01
12263_10.txt;2;0;0;2;128;0.02;0.0;0.0
596_7.txt;27;4;0;31;357;0.08;0.01;0.0
12345_10.txt;3;1;0;4;191;0.02;0.01;0.0
1165_7.txt;5;0;3;8;293;0.02;0.0;0.01
10569_10.txt;1;0;0;1;168;0.01;0.0;0.0
2273_9.txt;14;3;0;17;616;0.02;0.0;0.0
5204_8.txt;4;3;0;7;320;0.01;0.01;0.0
4416_9.txt;2;3;0;5;170;0.01;0.02;0.0
10257_8.txt;0;0;0;0;98;0.0;0.0;0.0
628_9.txt;2;0;0;2;134;0.01;0.0;0.0
11976_10.txt;5;0;0;5;147;0.03;0.0;0.0
4195_9.txt;28;0;0;28;784;0.04;0.0;0.0
694_9.txt;7;3;0;10;186;0.04;0.02;0.0
11051_8.txt;39;1;0;40;740;0.05;0.0;0.0
8416_7.txt;76;6;0;82;1159;0.07;0.01;0.0
176_7.txt;4;0;0;4;170;0.02;0.0;0.0
2604_8.txt;0;0;0;0;115;0.0;0.0;0.0
7035_8.txt;9;1;0;10;117;0.08;0.01;0.0
6233_9.txt;42;0;6;48;384;0.11;0.0;0.02
6286_8.txt;2;0;0;2;192;0.01;0.0;0.0
9055_10.txt;0;0;0;0;175;0.0;0.0;0.0
8218_7.txt;4;0;0;4;113;0.04;0.0;0.0
10276_10.txt;3;0;0;3;151;0.02;0.0;0.0
8441_10.txt;1;0;0;1;96;0.01;0.0;0.0
3285_10.txt;18;0;0;18;562;0.03;0.0;0.0
5887_7.txt;7;0;2;9;154;0.05;0.0;0.01
405_10.txt;4;0;0;4;107;0.04;0.0;0.0
6382_7.txt;0;0;0;0;135;0.0;0.0;0.0
9527_10.txt;7;0;0;7;160;0.04;0.0;0.0
10658_10.txt;3;3;0;6;139;0.02;0.02;0.0
568_7.txt;19;4;0;23;231;0.08;0.02;0.0
5697_8.txt;4;1;0;5;118;0.03;0.01;0.0
163_10.txt;2;0;0;2;77;0.03;0.0;0.0
5858_8.txt;4;2;0;6;502;0.01;0.0;0.0
1476_10.txt;15;0;0;15;155;0.1;0.0;0.0
7624_7.txt;6;0;0;6;287;0.02;0.0;0.0
295_10.txt;9;1;0;10;167;0.05;0.01;0.0
12338_10.txt;18;0;0;18;123;0.15;0.0;0.0
8769_7.txt;16;0;0;16;174;0.09;0.0;0.0
7940_7.txt;10;0;0;10;444;0.02;0.0;0.0
8753_8.txt;2;0;0;2;158;0.01;0.0;0.0
5814_8.txt;8;0;9;17;473;0.02;0.0;0.02
5018_8.txt;1;0;0;1;133;0.01;0.0;0.0
2769_10.txt;33;1;0;34;508;0.06;0.0;0.0
3039_8.txt;35;15;8;58;621;0.06;0.02;0.01
8327_9.txt;7;0;2;9;153;0.05;0.0;0.01
9414_9.txt;2;1;2;5;265;0.01;0.0;0.01
3726_7.txt;5;0;0;5;188;0.03;0.0;0.0
3883_10.txt;3;0;1;4;73;0.04;0.0;0.01
7280_10.txt;0;0;0;0;170;0.0;0.0;0.0
6782_9.txt;27;1;0;28;441;0.06;0.0;0.0
6232_10.txt;37;0;4;41;357;0.1;0.0;0.01
894_9.txt;9;1;0;10;274;0.03;0.0;0.0
215_8.txt;11;0;0;11;114;0.1;0.0;0.0
4922_7.txt;15;2;5;22;409;0.04;0.0;0.01
7764_9.txt;43;1;2;46;354;0.12;0.0;0.01
7773_10.txt;17;2;0;19;260;0.07;0.01;0.0
2414_10.txt;5;0;0;5;145;0.03;0.0;0.0
5923_7.txt;8;0;0;8;146;0.05;0.0;0.0
6163_10.txt;0;0;0;0;165;0.0;0.0;0.0
6939_9.txt;25;0;1;26;231;0.11;0.0;0.0
758_9.txt;9;0;0;9;196;0.05;0.0;0.0
5174_10.txt;2;0;0;2;97;0.02;0.0;0.0
6755_7.txt;20;3;0;23;530;0.04;0.01;0.0
12318_9.txt;14;0;0;14;319;0.04;0.0;0.0
8312_10.txt;12;0;4;16;320;0.04;0.0;0.01
868_8.txt;0;2;0;2;97;0.0;0.02;0.0
10440_9.txt;0;0;0;0;265;0.0;0.0;0.0
11687_10.txt;4;0;0;4;89;0.04;0.0;0.0
1191_9.txt;19;0;0;19;154;0.12;0.0;0.0
2168_8.txt;0;0;0;0;221;0.0;0.0;0.0
6968_7.txt;1;2;5;8;300;0.0;0.01;0.02
12427_7.txt;14;0;2;16;316;0.04;0.0;0.01
3716_9.txt;1;1;1;3;136;0.01;0.01;0.01
7232_8.txt;9;0;0;9;229;0.04;0.0;0.0
8188_8.txt;0;0;0;0;141;0.0;0.0;0.0
7291_10.txt;3;0;0;3;130;0.02;0.0;0.0
4064_10.txt;2;1;0;3;100;0.02;0.01;0.0
1626_10.txt;2;0;0;2;146;0.01;0.0;0.0
6370_8.txt;0;0;2;2;176;0.0;0.0;0.01
10858_8.txt;0;1;0;1;136;0.0;0.01;0.0
12469_10.txt;1;1;0;2;168;0.01;0.01;0.0
4740_8.txt;0;4;2;6;223;0.0;0.02;0.01
12170_8.txt;31;0;5;36;952;0.03;0.0;0.01
12484_8.txt;0;0;0;0;139;0.0;0.0;0.0
1482_10.txt;4;2;0;6;393;0.01;0.01;0.0
5241_7.txt;2;1;1;4;113;0.02;0.01;0.01
8904_7.txt;9;0;0;9;548;0.02;0.0;0.0
2868_7.txt;2;1;0;3;276;0.01;0.0;0.0
8118_10.txt;3;0;0;3;188;0.02;0.0;0.0
11266_10.txt;2;0;1;3;210;0.01;0.0;0.0
3018_10.txt;2;1;0;3;130;0.02;0.01;0.0
10545_7.txt;4;0;0;4;578;0.01;0.0;0.0
8957_7.txt;21;0;0;21;167;0.13;0.0;0.0
7595_10.txt;0;0;0;0;208;0.0;0.0;0.0
7545_8.txt;0;0;0;0;136;0.0;0.0;0.0
5327_10.txt;5;2;0;7;190;0.03;0.01;0.0
6006_10.txt;0;0;0;0;89;0.0;0.0;0.0
4998_9.txt;13;2;0;15;233;0.06;0.01;0.0
3210_8.txt;9;0;0;9;144;0.06;0.0;0.0
773_7.txt;0;0;0;0;128;0.0;0.0;0.0
6610_8.txt;8;4;4;16;515;0.02;0.01;0.01
5867_9.txt;5;0;1;6;194;0.03;0.0;0.01
4770_10.txt;0;1;0;1;114;0.0;0.01;0.0
7467_10.txt;24;5;0;29;369;0.07;0.01;0.0
10009_9.txt;18;1;2;21;303;0.06;0.0;0.01
6069_8.txt;10;3;0;13;217;0.05;0.01;0.0
5869_10.txt;5;1;0;6;193;0.03;0.01;0.0
4970_8.txt;0;1;1;2;119;0.0;0.01;0.01
885_8.txt;18;2;0;20;681;0.03;0.0;0.0
12018_7.txt;32;16;0;48;515;0.06;0.03;0.0
6432_9.txt;24;0;0;24;153;0.16;0.0;0.0
9274_8.txt;2;2;0;4;329;0.01;0.01;0.0
10436_8.txt;9;5;3;17;431;0.02;0.01;0.01
5798_8.txt;10;3;0;13;156;0.06;0.02;0.0
10655_9.txt;6;0;0;6;174;0.03;0.0;0.0
436_10.txt;0;1;0;1;153;0.0;0.01;0.0
8582_9.txt;9;1;0;10;123;0.07;0.01;0.0
4098_10.txt;10;0;0;10;1545;0.01;0.0;0.0
1694_10.txt;2;0;1;3;87;0.02;0.0;0.01
3700_9.txt;7;0;2;9;84;0.08;0.0;0.02
9386_8.txt;20;13;0;33;458;0.04;0.03;0.0
11756_7.txt;3;0;0;3;137;0.02;0.0;0.0
6786_10.txt;28;1;0;29;288;0.1;0.0;0.0
5736_7.txt;9;0;0;9;687;0.01;0.0;0.0
9826_10.txt;9;1;0;10;405;0.02;0.0;0.0
4260_9.txt;5;2;0;7;203;0.02;0.01;0.0
2754_10.txt;3;0;0;3;182;0.02;0.0;0.0
9173_10.txt;2;0;0;2;180;0.01;0.0;0.0
9867_10.txt;1;0;2;3;338;0.0;0.0;0.01
9035_10.txt;3;0;2;5;140;0.02;0.0;0.01
11555_10.txt;6;0;0;6;125;0.05;0.0;0.0
10944_8.txt;6;0;0;6;127;0.05;0.0;0.0
3524_9.txt;12;5;2;19;228;0.05;0.02;0.01
5997_9.txt;0;0;0;0;252;0.0;0.0;0.0
9004_7.txt;7;0;0;7;100;0.07;0.0;0.0
4995_9.txt;16;0;0;16;315;0.05;0.0;0.0
11584_8.txt;10;8;8;26;877;0.01;0.01;0.01
1063_10.txt;3;0;0;3;56;0.05;0.0;0.0
3324_7.txt;4;0;3;7;183;0.02;0.0;0.02
10203_10.txt;1;0;0;1;171;0.01;0.0;0.0
237_10.txt;0;0;0;0;56;0.0;0.0;0.0
58_9.txt;0;0;0;0;161;0.0;0.0;0.0
9194_9.txt;3;1;0;4;148;0.02;0.01;0.0
11958_9.txt;37;10;6;53;748;0.05;0.01;0.01
6827_10.txt;0;0;0;0;150;0.0;0.0;0.0
5909_8.txt;7;0;4;11;172;0.04;0.0;0.02
8082_8.txt;1;0;0;1;85;0.01;0.0;0.0
10397_8.txt;26;15;1;42;489;0.05;0.03;0.0
9384_8.txt;36;1;0;37;491;0.07;0.0;0.0
8593_7.txt;6;0;0;6;147;0.04;0.0;0.0
8198_7.txt;3;4;0;7;105;0.03;0.04;0.0
10524_10.txt;13;2;0;15;122;0.11;0.02;0.0
2887_9.txt;2;0;2;4;177;0.01;0.0;0.01
4792_10.txt;2;1;0;3;91;0.02;0.01;0.0
5390_9.txt;17;0;0;17;202;0.08;0.0;0.0
6098_10.txt;2;0;0;2;245;0.01;0.0;0.0
5958_9.txt;1;0;0;1;190;0.01;0.0;0.0
3812_9.txt;0;0;0;0;166;0.0;0.0;0.0
6495_10.txt;2;0;0;2;163;0.01;0.0;0.0
12432_8.txt;9;0;1;10;338;0.03;0.0;0.0
426_7.txt;57;1;1;59;856;0.07;0.0;0.0
8256_9.txt;18;0;0;18;125;0.14;0.0;0.0
2993_10.txt;7;0;0;7;100;0.07;0.0;0.0
11603_10.txt;9;0;0;9;176;0.05;0.0;0.0
159_10.txt;13;2;0;15;492;0.03;0.0;0.0
1713_8.txt;10;0;0;10;218;0.05;0.0;0.0
6106_9.txt;12;0;0;12;146;0.08;0.0;0.0
8567_10.txt;8;1;1;10;162;0.05;0.01;0.01
3268_8.txt;14;0;0;14;161;0.09;0.0;0.0
463_7.txt;4;0;2;6;191;0.02;0.0;0.01
3740_9.txt;0;10;4;14;256;0.0;0.04;0.02
4838_10.txt;4;0;0;4;97;0.04;0.0;0.0
8611_8.txt;8;0;1;9;296;0.03;0.0;0.0
8488_8.txt;12;1;1;14;323;0.04;0.0;0.0
8618_8.txt;2;6;0;8;338;0.01;0.02;0.0
7570_10.txt;7;0;0;7;327;0.02;0.0;0.0
10283_10.txt;12;0;0;12;360;0.03;0.0;0.0
9079_10.txt;4;0;0;4;129;0.03;0.0;0.0
3680_9.txt;11;4;3;18;298;0.04;0.01;0.01
7160_8.txt;0;0;2;2;182;0.0;0.0;0.01
7542_10.txt;4;0;1;5;506;0.01;0.0;0.0
7723_10.txt;1;0;0;1;225;0.0;0.0;0.0
3385_9.txt;0;2;0;2;115;0.0;0.02;0.0
9478_8.txt;0;0;0;0;243;0.0;0.0;0.0
1299_10.txt;1;0;0;1;170;0.01;0.0;0.0
5046_10.txt;0;0;0;0;157;0.0;0.0;0.0
6862_10.txt;15;2;0;17;315;0.05;0.01;0.0
2202_10.txt;12;0;3;15;331;0.04;0.0;0.01
3963_7.txt;4;0;1;5;138;0.03;0.0;0.01
11801_8.txt;32;1;0;33;428;0.07;0.0;0.0
4451_9.txt;0;0;0;0;287;0.0;0.0;0.0
10893_8.txt;3;2;0;5;151;0.02;0.01;0.0
10064_10.txt;12;1;0;13;218;0.06;0.0;0.0
2669_10.txt;1;5;2;8;80;0.01;0.06;0.03
7367_7.txt;2;1;0;3;210;0.01;0.0;0.0
9970_10.txt;2;0;3;5;62;0.03;0.0;0.05
2598_10.txt;4;0;0;4;101;0.04;0.0;0.0
10355_9.txt;5;0;0;5;211;0.02;0.0;0.0
4967_10.txt;9;11;0;20;487;0.02;0.02;0.0
336_10.txt;24;7;1;32;661;0.04;0.01;0.0
1379_8.txt;41;2;0;43;784;0.05;0.0;0.0
379_10.txt;5;1;1;7;247;0.02;0.0;0.0
3741_8.txt;15;3;2;20;248;0.06;0.01;0.01
9143_10.txt;5;3;0;8;365;0.01;0.01;0.0
6803_8.txt;4;3;0;7;137;0.03;0.02;0.0
3976_10.txt;4;1;0;5;140;0.03;0.01;0.0
3139_10.txt;31;2;2;35;719;0.04;0.0;0.0
1891_8.txt;21;3;0;24;406;0.05;0.01;0.0
3618_7.txt;42;1;0;43;986;0.04;0.0;0.0
3939_7.txt;13;0;3;16;345;0.04;0.0;0.01
5394_10.txt;3;0;0;3;107;0.03;0.0;0.0
1155_10.txt;6;1;0;7;97;0.06;0.01;0.0
6774_10.txt;0;0;0;0;56;0.0;0.0;0.0
8382_7.txt;0;0;2;2;127;0.0;0.0;0.02
9474_10.txt;10;0;0;10;243;0.04;0.0;0.0
6585_10.txt;19;0;0;19;156;0.12;0.0;0.0
9627_10.txt;0;1;0;1;77;0.0;0.01;0.0
6522_10.txt;7;3;13;23;142;0.05;0.02;0.09
1658_10.txt;2;8;0;10;238;0.01;0.03;0.0
3610_10.txt;18;0;0;18;206;0.09;0.0;0.0
7349_7.txt;16;0;0;16;218;0.07;0.0;0.0
5822_10.txt;32;0;0;32;170;0.19;0.0;0.0
10028_10.txt;5;0;0;5;130;0.04;0.0;0.0
6051_9.txt;8;0;0;8;159;0.05;0.0;0.0
3491_8.txt;0;0;0;0;78;0.0;0.0;0.0
9752_10.txt;2;0;0;2;211;0.01;0.0;0.0
2255_8.txt;6;0;0;6;92;0.07;0.0;0.0
1078_8.txt;56;1;5;62;656;0.09;0.0;0.01
12168_10.txt;12;0;0;12;195;0.06;0.0;0.0
8571_7.txt;17;0;6;23;214;0.08;0.0;0.03
6847_10.txt;11;0;0;11;414;0.03;0.0;0.0
9053_10.txt;2;0;0;2;162;0.01;0.0;0.0
10326_10.txt;3;1;0;4;119;0.03;0.01;0.0
1629_10.txt;6;0;0;6;97;0.06;0.0;0.0
1305_10.txt;13;1;0;14;178;0.07;0.01;0.0
12473_10.txt;6;0;0;6;112;0.05;0.0;0.0
3201_10.txt;0;0;0;0;164;0.0;0.0;0.0
2335_10.txt;0;0;2;2;192;0.0;0.0;0.01
9977_7.txt;4;3;0;7;654;0.01;0.0;0.0
9930_8.txt;6;0;1;7;183;0.03;0.0;0.01
10011_9.txt;6;0;0;6;245;0.02;0.0;0.0
10519_9.txt;9;2;0;11;159;0.06;0.01;0.0
8686_8.txt;4;0;0;4;94;0.04;0.0;0.0
11646_10.txt;0;0;0;0;178;0.0;0.0;0.0
5590_8.txt;4;0;0;4;589;0.01;0.0;0.0
7674_10.txt;6;2;3;11;164;0.04;0.01;0.02
3587_10.txt;3;2;0;5;124;0.02;0.02;0.0
11765_8.txt;0;0;0;0;79;0.0;0.0;0.0
4284_10.txt;0;2;0;2;147;0.0;0.01;0.0
4991_10.txt;13;1;0;14;252;0.05;0.0;0.0
7537_10.txt;0;0;11;11;179;0.0;0.0;0.06
2663_10.txt;18;2;0;20;489;0.04;0.0;0.0
845_7.txt;9;0;2;11;495;0.02;0.0;0.0
8440_8.txt;0;0;0;0;247;0.0;0.0;0.0
11661_7.txt;20;2;1;23;714;0.03;0.0;0.0
27_10.txt;11;2;6;19;402;0.03;0.0;0.01
3014_8.txt;8;0;1;9;141;0.06;0.0;0.01
9297_10.txt;0;0;0;0;55;0.0;0.0;0.0
265_7.txt;25;0;0;25;419;0.06;0.0;0.0
1581_7.txt;3;5;1;9;196;0.02;0.03;0.01
8736_10.txt;2;0;5;7;339;0.01;0.0;0.01
6687_9.txt;9;0;0;9;181;0.05;0.0;0.0
9179_10.txt;8;1;0;9;138;0.06;0.01;0.0
1975_7.txt;20;1;0;21;389;0.05;0.0;0.0
3054_7.txt;13;0;0;13;186;0.07;0.0;0.0
7576_10.txt;4;1;0;5;158;0.03;0.01;0.0
1205_8.txt;4;3;0;7;222;0.02;0.01;0.0
7133_10.txt;6;0;0;6;191;0.03;0.0;0.0
9660_9.txt;0;0;0;0;286;0.0;0.0;0.0
5060_8.txt;0;0;0;0;47;0.0;0.0;0.0
10338_9.txt;7;4;0;11;311;0.02;0.01;0.0
9278_7.txt;4;0;2;6;160;0.03;0.0;0.01
3599_8.txt;0;0;0;0;129;0.0;0.0;0.0
5192_7.txt;2;0;0;2;257;0.01;0.0;0.0
4894_10.txt;4;0;1;5;160;0.03;0.0;0.01
11928_8.txt;40;1;3;44;319;0.13;0.0;0.01
11674_10.txt;2;3;0;5;150;0.01;0.02;0.0
12298_8.txt;65;3;0;68;734;0.09;0.0;0.0
4739_7.txt;7;0;0;7;147;0.05;0.0;0.0
1166_8.txt;35;0;2;37;259;0.14;0.0;0.01
7973_10.txt;0;0;0;0;152;0.0;0.0;0.0
6883_9.txt;2;0;0;2;229;0.01;0.0;0.0
557_9.txt;13;5;0;18;277;0.05;0.02;0.0
7187_8.txt;2;0;0;2;244;0.01;0.0;0.0
98_10.txt;2;1;0;3;130;0.02;0.01;0.0
11169_7.txt;2;0;0;2;205;0.01;0.0;0.0
52_10.txt;0;0;0;0;150;0.0;0.0;0.0
7017_9.txt;11;0;0;11;249;0.04;0.0;0.0
2271_8.txt;6;0;1;7;150;0.04;0.0;0.01
732_7.txt;20;0;1;21;395;0.05;0.0;0.0
4654_7.txt;42;8;0;50;786;0.05;0.01;0.0
5614_10.txt;3;1;0;4;316;0.01;0.0;0.0
10311_9.txt;35;1;4;40;1401;0.02;0.0;0.0
1579_10.txt;5;7;1;13;312;0.02;0.02;0.0
11340_7.txt;41;1;0;42;583;0.07;0.0;0.0
8062_8.txt;34;4;11;49;664;0.05;0.01;0.02
2297_7.txt;0;0;0;0;77;0.0;0.0;0.0
3167_7.txt;6;13;2;21;373;0.02;0.03;0.01
4328_10.txt;22;0;7;29;188;0.12;0.0;0.04
325_9.txt;0;0;0;0;111;0.0;0.0;0.0
11632_7.txt;13;0;0;13;316;0.04;0.0;0.0
787_9.txt;0;0;0;0;51;0.0;0.0;0.0
3098_10.txt;7;0;2;9;191;0.04;0.0;0.01
12447_8.txt;10;0;1;11;406;0.02;0.0;0.0
7088_10.txt;34;1;0;35;1046;0.03;0.0;0.0
6627_7.txt;12;6;1;19;673;0.02;0.01;0.0
3806_8.txt;2;0;0;2;125;0.02;0.0;0.0
11271_7.txt;13;2;0;15;476;0.03;0.0;0.0
5024_8.txt;10;2;1;13;635;0.02;0.0;0.0
10954_10.txt;9;2;0;11;187;0.05;0.01;0.0
6477_7.txt;2;0;2;4;341;0.01;0.0;0.01
4428_10.txt;1;4;2;7;201;0.0;0.02;0.01
5101_7.txt;7;1;0;8;169;0.04;0.01;0.0
10201_10.txt;1;0;0;1;156;0.01;0.0;0.0
9519_10.txt;39;2;2;43;419;0.09;0.0;0.0
11740_10.txt;14;2;0;16;217;0.06;0.01;0.0
5948_8.txt;12;0;2;14;237;0.05;0.0;0.01
11978_10.txt;22;0;0;22;188;0.12;0.0;0.0
6022_7.txt;13;2;2;17;500;0.03;0.0;0.0
603_10.txt;2;2;0;4;267;0.01;0.01;0.0
10523_9.txt;11;0;0;11;217;0.05;0.0;0.0
10142_8.txt;0;0;0;0;175;0.0;0.0;0.0
1733_7.txt;0;0;1;1;29;0.0;0.0;0.03
7192_8.txt;22;3;3;28;283;0.08;0.01;0.01
9580_7.txt;12;1;0;13;547;0.02;0.0;0.0
4987_10.txt;7;0;2;9;211;0.03;0.0;0.01
10996_8.txt;4;1;0;5;226;0.02;0.0;0.0
217_8.txt;24;0;0;24;264;0.09;0.0;0.0
6018_9.txt;0;0;0;0;131;0.0;0.0;0.0
11952_8.txt;43;1;0;44;357;0.12;0.0;0.0
1669_8.txt;30;1;0;31;360;0.08;0.0;0.0
1233_7.txt;7;0;0;7;69;0.1;0.0;0.0
2564_10.txt;2;0;0;2;69;0.03;0.0;0.0
7062_7.txt;36;2;0;38;467;0.08;0.0;0.0
6562_10.txt;2;2;0;4;139;0.01;0.01;0.0
7692_7.txt;47;4;4;55;544;0.09;0.01;0.01
2503_10.txt;9;2;0;11;314;0.03;0.01;0.0
5388_8.txt;2;0;1;3;156;0.01;0.0;0.01
6482_10.txt;3;0;0;3;170;0.02;0.0;0.0
3219_10.txt;25;0;0;25;445;0.06;0.0;0.0
5617_8.txt;14;0;0;14;549;0.03;0.0;0.0
5595_7.txt;11;0;3;14;387;0.03;0.0;0.01
10416_9.txt;1;0;0;1;209;0.0;0.0;0.0
803_10.txt;8;0;0;8;204;0.04;0.0;0.0
11767_8.txt;4;0;0;4;73;0.05;0.0;0.0
3319_9.txt;2;0;12;14;166;0.01;0.0;0.07
6375_8.txt;1;0;5;6;368;0.0;0.0;0.01
2446_10.txt;4;2;0;6;138;0.03;0.01;0.0
1934_9.txt;1;1;0;2;233;0.0;0.0;0.0
9727_7.txt;12;1;0;13;126;0.1;0.01;0.0
1618_10.txt;3;0;0;3;132;0.02;0.0;0.0
4256_8.txt;1;0;0;1;168;0.01;0.0;0.0
9604_10.txt;2;2;0;4;123;0.02;0.02;0.0
95_10.txt;0;0;0;0;127;0.0;0.0;0.0
9218_10.txt;0;0;2;2;158;0.0;0.0;0.01
1457_10.txt;2;1;0;3;177;0.01;0.01;0.0
10464_7.txt;2;0;0;2;340;0.01;0.0;0.0
3978_10.txt;6;1;0;7;177;0.03;0.01;0.0
10843_7.txt;12;1;0;13;436;0.03;0.0;0.0
1674_8.txt;23;5;1;29;306;0.08;0.02;0.0
10234_10.txt;8;0;0;8;154;0.05;0.0;0.0
3056_8.txt;12;0;1;13;178;0.07;0.0;0.01
10734_10.txt;0;3;0;3;204;0.0;0.01;0.0
1199_10.txt;23;0;0;23;364;0.06;0.0;0.0
3330_7.txt;8;2;12;22;174;0.05;0.01;0.07
1405_7.txt;0;0;0;0;59;0.0;0.0;0.0
7887_7.txt;5;0;0;5;237;0.02;0.0;0.0
1972_10.txt;10;0;0;10;265;0.04;0.0;0.0
1804_10.txt;6;1;1;8;190;0.03;0.01;0.01
10378_8.txt;5;0;0;5;146;0.03;0.0;0.0
8742_10.txt;1;0;2;3;828;0.0;0.0;0.0
8318_10.txt;11;0;0;11;91;0.12;0.0;0.0
2903_9.txt;5;2;0;7;104;0.05;0.02;0.0
8385_10.txt;0;0;0;0;186;0.0;0.0;0.0
11109_9.txt;12;0;0;12;250;0.05;0.0;0.0
5788_8.txt;4;0;0;4;142;0.03;0.0;0.0
11211_8.txt;2;1;0;3;156;0.01;0.01;0.0
7658_10.txt;21;0;3;24;382;0.05;0.0;0.01
12341_7.txt;10;0;0;10;215;0.05;0.0;0.0
8361_8.txt;15;0;0;15;360;0.04;0.0;0.0
4076_10.txt;59;18;6;83;1987;0.03;0.01;0.0
9089_9.txt;90;8;4;102;1132;0.08;0.01;0.0
7496_8.txt;6;0;0;6;169;0.04;0.0;0.0
12077_8.txt;16;4;0;20;197;0.08;0.02;0.0
3913_10.txt;5;0;0;5;75;0.07;0.0;0.0
4683_7.txt;3;1;0;4;207;0.01;0.0;0.0
8073_8.txt;7;1;4;12;132;0.05;0.01;0.03
2714_10.txt;4;0;2;6;167;0.02;0.0;0.01
9252_10.txt;6;0;0;6;49;0.12;0.0;0.0
11323_10.txt;3;2;2;7;415;0.01;0.0;0.0
9985_9.txt;3;1;0;4;136;0.02;0.01;0.0
5891_10.txt;10;2;0;12;143;0.07;0.01;0.0
12278_10.txt;0;0;0;0;145;0.0;0.0;0.0
10330_8.txt;3;0;2;5;218;0.01;0.0;0.01
1257_10.txt;16;0;0;16;379;0.04;0.0;0.0
4184_8.txt;2;0;0;2;166;0.01;0.0;0.0
10260_10.txt;0;0;0;0;162;0.0;0.0;0.0
8531_7.txt;3;0;0;3;136;0.02;0.0;0.0
7974_7.txt;1;5;0;6;186;0.01;0.03;0.0
8909_9.txt;2;0;0;2;156;0.01;0.0;0.0
6546_10.txt;3;0;0;3;168;0.02;0.0;0.0
10369_8.txt;6;0;0;6;159;0.04;0.0;0.0
10483_8.txt;6;1;0;7;236;0.03;0.0;0.0
8872_8.txt;14;1;0;15;167;0.08;0.01;0.0
178_7.txt;2;1;0;3;106;0.02;0.01;0.0
5584_8.txt;20;4;0;24;1059;0.02;0.0;0.0
6040_10.txt;5;1;0;6;131;0.04;0.01;0.0
4500_10.txt;16;1;1;18;197;0.08;0.01;0.01
11526_10.txt;0;0;0;0;176;0.0;0.0;0.0
7535_10.txt;2;0;0;2;145;0.01;0.0;0.0
12046_10.txt;23;0;2;25;313;0.07;0.0;0.01
2536_7.txt;19;3;0;22;417;0.05;0.01;0.0
2445_10.txt;8;2;0;10;224;0.04;0.01;0.0
6061_10.txt;12;2;0;14;365;0.03;0.01;0.0
10643_8.txt;5;10;7;22;554;0.01;0.02;0.01
6739_7.txt;34;0;0;34;790;0.04;0.0;0.0
10963_7.txt;5;0;1;6;129;0.04;0.0;0.01
7352_10.txt;2;1;0;3;111;0.02;0.01;0.0
9853_8.txt;0;0;0;0;65;0.0;0.0;0.0
6893_10.txt;4;0;0;4;69;0.06;0.0;0.0
9624_10.txt;7;0;1;8;133;0.05;0.0;0.01
1574_9.txt;1;3;0;4;64;0.02;0.05;0.0
5682_7.txt;32;4;0;36;320;0.1;0.01;0.0
11531_10.txt;8;0;0;8;144;0.06;0.0;0.0
7540_9.txt;4;0;0;4;128;0.03;0.0;0.0
1015_10.txt;5;0;0;5;147;0.03;0.0;0.0
6139_10.txt;2;1;0;3;145;0.01;0.01;0.0
9767_7.txt;33;7;5;45;634;0.05;0.01;0.01
4537_8.txt;7;0;1;8;145;0.05;0.0;0.01
1842_9.txt;0;0;0;0;138;0.0;0.0;0.0
10660_10.txt;1;0;0;1;137;0.01;0.0;0.0
11635_8.txt;14;3;6;23;461;0.03;0.01;0.01
1969_10.txt;11;3;0;14;277;0.04;0.01;0.0
9860_7.txt;1;0;0;1;131;0.01;0.0;0.0
11568_7.txt;10;0;1;11;325;0.03;0.0;0.0
7441_7.txt;4;0;0;4;75;0.05;0.0;0.0
9057_7.txt;4;0;0;4;110;0.04;0.0;0.0
1284_7.txt;3;0;0;3;260;0.01;0.0;0.0
10384_10.txt;3;0;3;6;208;0.01;0.0;0.01
2935_10.txt;2;3;0;5;178;0.01;0.02;0.0
9792_8.txt;1;0;0;1;160;0.01;0.0;0.0
10446_10.txt;0;1;0;1;209;0.0;0.0;0.0
9208_7.txt;4;0;0;4;138;0.03;0.0;0.0
10502_9.txt;0;0;0;0;175;0.0;0.0;0.0
10544_8.txt;2;0;0;2;355;0.01;0.0;0.0
7505_9.txt;15;0;3;18;356;0.04;0.0;0.01
3926_7.txt;2;0;0;2;86;0.02;0.0;0.0
1088_9.txt;5;0;0;5;147;0.03;0.0;0.0
9606_10.txt;2;0;0;2;183;0.01;0.0;0.0
3346_7.txt;41;1;0;42;361;0.11;0.0;0.0
4183_10.txt;0;3;0;3;377;0.0;0.01;0.0
4840_7.txt;9;2;0;11;167;0.05;0.01;0.0
6133_7.txt;0;0;0;0;232;0.0;0.0;0.0
7115_9.txt;5;0;0;5;98;0.05;0.0;0.0
4577_10.txt;4;0;0;4;53;0.08;0.0;0.0
10239_10.txt;0;0;0;0;136;0.0;0.0;0.0
4503_7.txt;6;0;0;6;127;0.05;0.0;0.0
6124_7.txt;2;0;0;2;80;0.03;0.0;0.0
11280_8.txt;0;0;0;0;66;0.0;0.0;0.0
2642_10.txt;2;0;0;2;158;0.01;0.0;0.0
7052_8.txt;20;3;0;23;450;0.04;0.01;0.0
4824_7.txt;39;3;2;44;776;0.05;0.0;0.0
2771_7.txt;34;4;0;38;431;0.08;0.01;0.0
10467_10.txt;8;0;1;9;201;0.04;0.0;0.0
3996_9.txt;10;2;0;12;543;0.02;0.0;0.0
8165_8.txt;23;1;5;29;362;0.06;0.0;0.01
5492_10.txt;3;4;1;8;129;0.02;0.03;0.01
5098_9.txt;28;0;6;34;408;0.07;0.0;0.01
7337_10.txt;5;0;1;6;166;0.03;0.0;0.01
7391_9.txt;27;5;0;32;781;0.03;0.01;0.0
9656_10.txt;0;0;0;0;59;0.0;0.0;0.0
1789_7.txt;53;6;0;59;418;0.13;0.01;0.0
3084_10.txt;9;1;2;12;275;0.03;0.0;0.01
8065_9.txt;21;2;5;28;520;0.04;0.0;0.01
4849_10.txt;3;0;0;3;207;0.01;0.0;0.0
11998_9.txt;2;0;0;2;147;0.01;0.0;0.0
2315_10.txt;4;0;0;4;80;0.05;0.0;0.0
5277_10.txt;33;12;0;45;570;0.06;0.02;0.0
768_9.txt;0;2;0;2;187;0.0;0.01;0.0
5775_7.txt;0;0;0;0;131;0.0;0.0;0.0
11758_7.txt;3;0;0;3;64;0.05;0.0;0.0
9215_7.txt;20;2;0;22;473;0.04;0.0;0.0
6551_9.txt;12;0;0;12;283;0.04;0.0;0.0
633_8.txt;30;3;0;33;1104;0.03;0.0;0.0
3043_8.txt;23;1;9;33;468;0.05;0.0;0.02
1978_9.txt;14;0;0;14;267;0.05;0.0;0.0
9392_9.txt;6;0;0;6;267;0.02;0.0;0.0
4011_8.txt;72;2;3;77;748;0.1;0.0;0.0
10866_7.txt;3;2;0;5;196;0.02;0.01;0.0
282_9.txt;2;0;0;2;171;0.01;0.0;0.0
5906_8.txt;5;0;0;5;127;0.04;0.0;0.0
2597_8.txt;1;0;0;1;105;0.01;0.0;0.0
798_10.txt;5;0;0;5;140;0.04;0.0;0.0
1941_9.txt;2;0;0;2;233;0.01;0.0;0.0
9198_8.txt;0;0;0;0;141;0.0;0.0;0.0
11994_10.txt;5;1;6;12;722;0.01;0.0;0.01
6058_8.txt;2;2;0;4;84;0.02;0.02;0.0
4709_9.txt;10;0;1;11;359;0.03;0.0;0.0
12392_9.txt;0;0;1;1;281;0.0;0.0;0.0
10857_8.txt;2;2;0;4;171;0.01;0.01;0.0
6505_10.txt;6;6;4;16;400;0.01;0.01;0.01
10381_10.txt;0;0;0;0;161;0.0;0.0;0.0
2270_9.txt;4;0;0;4;68;0.06;0.0;0.0
10873_8.txt;0;0;0;0;208;0.0;0.0;0.0
9368_8.txt;8;0;0;8;183;0.04;0.0;0.0
3114_9.txt;4;0;1;5;250;0.02;0.0;0.0
6252_10.txt;13;1;0;14;594;0.02;0.0;0.0
915_10.txt;9;0;0;9;177;0.05;0.0;0.0
1396_8.txt;11;1;4;16;393;0.03;0.0;0.01
5680_10.txt;10;2;0;12;184;0.05;0.01;0.0
3529_9.txt;18;0;2;20;323;0.06;0.0;0.01
7588_8.txt;22;0;1;23;792;0.03;0.0;0.0
3020_9.txt;32;3;2;37;509;0.06;0.01;0.0
1628_10.txt;0;1;6;7;187;0.0;0.01;0.03
6109_8.txt;3;0;0;3;123;0.02;0.0;0.0
11351_9.txt;1;1;0;2;79;0.01;0.01;0.0
6773_10.txt;2;0;0;2;149;0.01;0.0;0.0
7321_10.txt;3;0;0;3;151;0.02;0.0;0.0
10318_7.txt;26;6;11;43;1152;0.02;0.01;0.01
9816_10.txt;2;0;0;2;88;0.02;0.0;0.0
11474_10.txt;7;0;0;7;264;0.03;0.0;0.0
731_9.txt;0;0;1;1;235;0.0;0.0;0.0
11080_10.txt;5;0;0;5;156;0.03;0.0;0.0
2464_10.txt;6;0;0;6;155;0.04;0.0;0.0
9070_7.txt;14;0;1;15;427;0.03;0.0;0.0
72_7.txt;6;0;2;8;147;0.04;0.0;0.01
1689_10.txt;3;0;0;3;136;0.02;0.0;0.0
6619_9.txt;2;0;0;2;151;0.01;0.0;0.0
8084_7.txt;3;0;1;4;222;0.01;0.0;0.0
1703_8.txt;0;1;0;1;228;0.0;0.0;0.0
6326_10.txt;3;1;0;4;452;0.01;0.0;0.0
2932_10.txt;2;0;0;2;155;0.01;0.0;0.0
8168_7.txt;42;4;1;47;746;0.06;0.01;0.0
1511_8.txt;41;0;2;43;390;0.11;0.0;0.01
11093_10.txt;8;0;0;8;138;0.06;0.0;0.0
925_10.txt;7;1;1;9;496;0.01;0.0;0.0
9186_8.txt;45;0;0;45;302;0.15;0.0;0.0
1951_9.txt;16;0;0;16;259;0.06;0.0;0.0
1837_10.txt;16;0;1;17;160;0.1;0.0;0.01
8471_10.txt;7;0;2;9;131;0.05;0.0;0.02
2175_9.txt;35;3;0;38;611;0.06;0.0;0.0
1161_8.txt;11;0;0;11;229;0.05;0.0;0.0
3140_7.txt;0;0;0;0;55;0.0;0.0;0.0
7283_8.txt;0;0;0;0;132;0.0;0.0;0.0
9487_8.txt;0;0;0;0;51;0.0;0.0;0.0
9065_10.txt;8;0;1;9;702;0.01;0.0;0.0
2182_9.txt;4;2;0;6;137;0.03;0.01;0.0
6220_8.txt;4;0;0;4;49;0.08;0.0;0.0
4530_7.txt;29;1;0;30;447;0.06;0.0;0.0
7492_7.txt;33;0;0;33;318;0.1;0.0;0.0
6063_10.txt;2;0;0;2;110;0.02;0.0;0.0
11371_10.txt;19;2;3;24;223;0.09;0.01;0.01
11942_8.txt;30;5;0;35;306;0.1;0.02;0.0
11699_10.txt;5;0;0;5;157;0.03;0.0;0.0
6071_8.txt;13;0;0;13;231;0.06;0.0;0.0
6294_10.txt;11;0;2;13;244;0.05;0.0;0.01
8930_9.txt;6;7;2;15;674;0.01;0.01;0.0
3739_10.txt;10;1;0;11;234;0.04;0.0;0.0
1464_7.txt;7;1;0;8;234;0.03;0.0;0.0
5044_9.txt;2;0;0;2;139;0.01;0.0;0.0
4109_10.txt;1;0;0;1;51;0.02;0.0;0.0
6768_8.txt;8;1;0;9;131;0.06;0.01;0.0
7869_9.txt;17;0;1;18;412;0.04;0.0;0.0
5224_10.txt;0;0;0;0;148;0.0;0.0;0.0
11247_8.txt;6;3;0;9;243;0.02;0.01;0.0
1095_9.txt;0;0;0;0;48;0.0;0.0;0.0
10575_9.txt;5;0;0;5;157;0.03;0.0;0.0
7450_9.txt;15;0;0;15;186;0.08;0.0;0.0
2138_9.txt;0;2;0;2;157;0.0;0.01;0.0
4359_10.txt;2;0;0;2;67;0.03;0.0;0.0
3163_10.txt;21;4;0;25;497;0.04;0.01;0.0
4390_8.txt;5;1;4;10;137;0.04;0.01;0.03
7270_8.txt;0;0;0;0;60;0.0;0.0;0.0
9629_8.txt;44;0;0;44;531;0.08;0.0;0.0
9165_10.txt;12;6;0;18;227;0.05;0.03;0.0
2358_9.txt;0;0;0;0;223;0.0;0.0;0.0
